entity,domain,pos_count,neg_count,neu_count,total_mentions,bias_score,polarity
Dragnea,www.mediafax.ro,0,6,4,10,-0.6,0.6
Fifor,www.mediafax.ro,0,1,0,1,-1.0,1.0
Ilie Sârbu,www.mediafax.ro,0,0,2,2,0.0,0.0
Ioan Rus,www.mediafax.ro,0,2,0,2,-1.0,1.0
Liviu Dragnea,www.mediafax.ro,0,10,8,18,-0.5555555555555556,0.5555555555555556
Mihai Fifor,www.mediafax.ro,0,1,2,3,-0.3333333333333333,0.3333333333333333
Sârbu,www.mediafax.ro,0,0,2,2,0.0,0.0
candidați,www.mediafax.ro,0,2,6,8,-0.25,0.25
lider,www.mediafax.ro,4,53,85,142,-0.34507042253521125,0.34507042253521125
ministru,www.mediafax.ro,0,31,38,69,-0.4492753623188406,0.4492753623188406
om politic,www.mediafax.ro,0,7,1,8,-0.875,0.875
parlamentar,www.mediafax.ro,0,24,15,39,-0.6153846153846154,0.6153846153846154
președinte,www.mediafax.ro,8,65,150,223,-0.2556053811659193,0.2556053811659193
Klaus Iohannis,www.mediafax.ro,0,19,47,66,-0.2878787878787879,0.2878787878787879
Adrian Bibu,primanews.ro,0,0,1,1,0.0,0.0
Adrian Cozma,primanews.ro,0,0,2,2,0.0,0.0
Adrian Mocanu,primanews.ro,0,0,1,1,0.0,0.0
Alexandria,primanews.ro,0,0,1,1,0.0,0.0
Alexandru Popa,primanews.ro,0,0,1,1,0.0,0.0
Alin Bogdan Drăgulin,primanews.ro,0,0,1,1,0.0,0.0
Andrei Carabelea,primanews.ro,0,0,1,1,0.0,0.0
Arad,primanews.ro,0,0,3,3,0.0,0.0
Bacău,primanews.ro,0,0,2,2,0.0,0.0
Baia Mare,primanews.ro,0,1,1,2,-0.5,0.5
Bistrița Năsăud,primanews.ro,0,0,1,1,0.0,0.0
Brăila,primanews.ro,0,0,3,3,0.0,0.0
Buzău,primanews.ro,0,0,4,4,0.0,0.0
Ciprian Ciucu,primanews.ro,0,0,2,2,0.0,0.0
Costel Alexe,primanews.ro,0,0,1,1,0.0,0.0
Călărași,primanews.ro,0,0,1,1,0.0,0.0
Dan Tică,primanews.ro,0,0,1,1,0.0,0.0
Dragoș Costin Telehuz,primanews.ro,0,0,1,1,0.0,0.0
Dragoș Fănică Ciobotaru,primanews.ro,0,0,1,1,0.0,0.0
Florin Birta,primanews.ro,0,0,1,1,0.0,0.0
Gabriel Ștețco,primanews.ro,0,0,1,1,0.0,0.0
Galați,primanews.ro,0,1,6,7,-0.14285714285714285,0.14285714285714285
George Cristian Tuță,primanews.ro,0,0,1,1,0.0,0.0
George Lazăr,primanews.ro,0,0,1,1,0.0,0.0
George Stângă,primanews.ro,0,0,2,2,0.0,0.0
Haralambie Epure,primanews.ro,0,0,1,1,0.0,0.0
Ialomița,primanews.ro,0,0,1,1,0.0,0.0
Iași,primanews.ro,0,0,1,1,0.0,0.0
Ionel Bogdan,primanews.ro,0,1,3,4,-0.25,0.25
Ionel Emanuel Oproiu,primanews.ro,0,0,1,1,0.0,0.0
Iulian Popescu,primanews.ro,0,0,1,1,0.0,0.0
lider,primanews.ro,15,33,92,140,-0.12857142857142856,0.12857142857142856
Lucian Harșovschi,primanews.ro,0,0,1,1,0.0,0.0
Mara Togănel,primanews.ro,0,0,1,1,0.0,0.0
Maramureș,primanews.ro,0,0,3,3,0.0,0.0
Mircea Fechet,primanews.ro,0,0,2,2,0.0,0.0
Mureș,primanews.ro,0,0,2,2,0.0,0.0
Neamț,primanews.ro,0,0,2,2,0.0,0.0
Nicolae Ciucă,primanews.ro,10,3,29,42,0.16666666666666666,0.16666666666666666
Olt,primanews.ro,0,0,1,1,0.0,0.0
Oradea,primanews.ro,0,0,3,3,0.0,0.0
Piatra Neamț,primanews.ro,0,0,1,1,0.0,0.0
Robert Sighiartău,primanews.ro,0,0,2,2,0.0,0.0
România,primanews.ro,31,19,97,147,0.08163265306122448,0.08163265306122448
Satu Mare,primanews.ro,0,0,2,2,0.0,0.0
Sebastian Burduja,primanews.ro,0,0,5,5,0.0,0.0
Sibiu,primanews.ro,0,0,4,4,0.0,0.0
Slatina,primanews.ro,0,0,1,1,0.0,0.0
Suceava,primanews.ro,0,1,3,4,-0.25,0.25
Târgoviște,primanews.ro,0,0,1,1,0.0,0.0
Târgu Jiu,primanews.ro,0,0,1,1,0.0,0.0
Vrancea,primanews.ro,0,1,2,3,-0.3333333333333333,0.3333333333333333
candidat,primanews.ro,11,30,74,115,-0.16521739130434782,0.16521739130434782
candidați,primanews.ro,1,2,4,7,-0.14285714285714285,0.14285714285714285
ministru,primanews.ro,1,23,33,57,-0.38596491228070173,0.38596491228070173
persoană,primanews.ro,4,6,27,37,-0.05405405405405406,0.05405405405405406
președinte,primanews.ro,20,30,216,266,-0.03759398496240601,0.03759398496240601
primar,primanews.ro,3,16,10,29,-0.4482758620689655,0.4482758620689655
profesionist,primanews.ro,1,0,0,1,1.0,1.0
tânăr,primanews.ro,2,1,4,7,0.14285714285714285,0.14285714285714285
Alexandru Rafila,stirileprotv.ro,0,0,6,6,0.0,0.0
Ciolacu,stirileprotv.ro,1,8,16,25,-0.28,0.28
Cotroceni,stirileprotv.ro,0,0,5,5,0.0,0.0
Cristian Socol,stirileprotv.ro,0,0,1,1,0.0,0.0
Leonard Azamfirei,stirileprotv.ro,0,0,1,1,0.0,0.0
lider,stirileprotv.ro,4,50,93,147,-0.3129251700680272,0.3129251700680272
Maia Teodoroiu,stirileprotv.ro,0,0,1,1,0.0,0.0
Marcel Ciolacu,stirileprotv.ro,0,8,49,57,-0.14035087719298245,0.14035087719298245
Klaus Iohannis,stirileprotv.ro,3,26,59,88,-0.26136363636363635,0.26136363636363635
România,stirileprotv.ro,18,37,114,169,-0.11242603550295859,0.11242603550295859
coleg,stirileprotv.ro,7,10,16,33,-0.09090909090909091,0.09090909090909091
Orban,stirileprotv.ro,0,4,4,8,-0.5,0.5
Rafila,stirileprotv.ro,1,1,2,4,0.0,0.0
Cîțu,stirileprotv.ro,0,7,1,8,-0.875,0.875
miniștri,stirileprotv.ro,0,7,5,12,-0.5833333333333334,0.5833333333333334
om,stirileprotv.ro,14,40,40,94,-0.2765957446808511,0.2765957446808511
premier,stirileprotv.ro,1,25,63,89,-0.2696629213483146,0.2696629213483146
președinte,stirileprotv.ro,4,51,165,220,-0.21363636363636362,0.21363636363636362
soție,stirileprotv.ro,0,1,2,3,-0.3333333333333333,0.3333333333333333
șef de stat,stirileprotv.ro,0,5,17,22,-0.22727272727272727,0.22727272727272727
America,recorder.ro,0,3,2,5,-0.6,0.6
Dan Voiculescu,recorder.ro,0,6,6,12,-0.5,0.5
Ele,recorder.ro,0,0,1,1,0.0,0.0
Eugen Tomac,recorder.ro,0,0,1,1,0.0,0.0
Gabriela Firea,recorder.ro,1,5,9,15,-0.26666666666666666,0.26666666666666666
Germania,recorder.ro,0,5,17,22,-0.22727272727272727,0.22727272727272727
Gorj,recorder.ro,0,1,5,6,-0.16666666666666666,0.16666666666666666
Israel,recorder.ro,0,15,3,18,-0.8333333333333334,0.8333333333333334
New York,recorder.ro,0,0,4,4,0.0,0.0
Paris,recorder.ro,0,0,9,9,0.0,0.0
participanți,recorder.ro,0,3,0,3,-1.0,1.0
Piedone,recorder.ro,0,4,2,6,-0.6666666666666666,0.6666666666666666
Raul Bambu,recorder.ro,0,1,7,8,-0.125,0.125
SUA,recorder.ro,0,10,12,22,-0.45454545454545453,0.45454545454545453
Slănic,recorder.ro,0,1,1,2,-0.5,0.5
Sorina Pintea,recorder.ro,0,1,0,1,-1.0,1.0
Statele Unite,recorder.ro,3,5,24,32,-0.0625,0.0625
Ucraina,recorder.ro,2,14,33,49,-0.24489795918367346,0.24489795918367346
candidat,recorder.ro,9,46,170,225,-0.16444444444444445,0.16444444444444445
copil,recorder.ro,45,29,68,142,0.11267605633802817,0.11267605633802817
fiu,recorder.ro,0,7,9,16,-0.4375,0.4375
manager,recorder.ro,4,17,21,42,-0.30952380952380953,0.30952380952380953
ministru,recorder.ro,1,61,52,114,-0.5263157894736842,0.5263157894736842
om de afaceri,recorder.ro,1,9,6,16,-0.5,0.5
persoană,recorder.ro,10,51,50,111,-0.36936936936936937,0.36936936936936937
politician,recorder.ro,0,102,40,142,-0.7183098591549296,0.7183098591549296
student,recorder.ro,2,2,14,18,0.0,0.0
victima,recorder.ro,0,7,5,12,-0.5833333333333334,0.5833333333333334
George Simion,primanews.ro,0,11,33,44,-0.25,0.25
Nicușor Dan,primanews.ro,15,4,27,46,0.2391304347826087,0.2391304347826087
Simion,primanews.ro,0,12,12,24,-0.5,0.5
popor,primanews.ro,1,1,0,2,0.0,0.0
susținător,primanews.ro,6,1,12,19,0.2631578947368421,0.2631578947368421
Mihail Neamțu,www.cotidianul.ro,0,0,3,3,0.0,0.0
Neamțu,www.cotidianul.ro,0,1,0,1,-1.0,1.0
R,www.cotidianul.ro,0,1,1,2,-0.5,0.5
Radu Gyr,www.cotidianul.ro,0,1,0,1,-1.0,1.0
autor,www.cotidianul.ro,0,4,13,17,-0.23529411764705882,0.23529411764705882
bărbat,www.cotidianul.ro,0,2,1,3,-0.6666666666666666,0.6666666666666666
femeie,www.cotidianul.ro,0,2,1,3,-0.6666666666666666,0.6666666666666666
membru,www.cotidianul.ro,1,22,32,55,-0.38181818181818183,0.38181818181818183
politician,www.cotidianul.ro,0,17,1,18,-0.9444444444444444,0.9444444444444444
președinte,www.cotidianul.ro,9,74,158,241,-0.2697095435684647,0.2697095435684647
tată,www.cotidianul.ro,1,2,0,3,-0.3333333333333333,0.3333333333333333
transgender,www.cotidianul.ro,0,2,0,2,-1.0,1.0
Ioana,www.antena3.ro,2,0,0,2,1.0,1.0
Dâmbovița,www.antena3.ro,0,0,4,4,0.0,0.0
Lavinia Șandru,www.antena3.ro,7,0,20,27,0.25925925925925924,0.25925925925925924
reprezentantă,www.antena3.ro,1,0,1,2,0.5,0.5
România,www.antena3.ro,35,57,121,213,-0.10328638497652583,0.10328638497652583
copil,www.antena3.ro,5,5,5,15,0.0,0.0
femeie,www.antena3.ro,9,5,5,19,0.21052631578947367,0.21052631578947367
om,www.antena3.ro,25,45,54,124,-0.16129032258064516,0.16129032258064516
părinte,www.antena3.ro,3,0,6,9,0.3333333333333333,0.3333333333333333
Anton Pisaroglu,adevarul.ro,0,3,6,9,-0.3333333333333333,0.3333333333333333
consultant,adevarul.ro,0,9,9,18,-0.5,0.5
George Simion,adevarul.ro,5,23,124,152,-0.11842105263157894,0.11842105263157894
lider,adevarul.ro,16,135,169,320,-0.371875,0.371875
Capitale,www.antena3.ro,0,2,14,16,-0.125,0.125
Firea,www.antena3.ro,0,0,1,1,0.0,0.0
Gabriela Firea,www.antena3.ro,2,1,2,5,0.2,0.2
Klaus Iohannis,www.antena3.ro,0,14,28,42,-0.3333333333333333,0.3333333333333333
Orban,www.antena3.ro,0,1,0,1,-1.0,1.0
primar,www.antena3.ro,2,11,19,32,-0.28125,0.28125
mort,www.antena3.ro,0,1,0,1,-1.0,1.0
reprezentant,www.antena3.ro,0,7,15,22,-0.3181818181818182,0.3181818181818182
candidat,www.antena3.ro,9,61,147,217,-0.23963133640552994,0.23963133640552994
Crin Antonescu,www.antena3.ro,5,14,74,93,-0.0967741935483871,0.0967741935483871
Sebastian Burduja,www.realitatea.net,0,0,2,2,0.0,0.0
consumator,www.realitatea.net,0,0,1,1,0.0,0.0
premier,www.realitatea.net,1,7,7,15,-0.4,0.4
Adrian Roșu,www.mediafax.ro,0,1,0,1,-1.0,1.0
Bogdan Huțucă,www.mediafax.ro,0,0,1,1,0.0,0.0
Constanța,www.mediafax.ro,0,0,6,6,0.0,0.0
Ermil Chelariu,www.mediafax.ro,0,1,0,1,-1.0,1.0
Mihai Lupu,www.mediafax.ro,0,1,2,3,-0.3333333333333333,0.3333333333333333
Adrian Constantin Petrică,www.mediafax.ro,0,1,0,1,-1.0,1.0
persoană,www.mediafax.ro,0,17,33,50,-0.34,0.34
Daniel Suciu,www.luju.ro,0,0,1,1,0.0,0.0
deputat,www.luju.ro,0,19,10,29,-0.6551724137931034,0.6551724137931034
Laura Vicol,www.luju.ro,0,2,2,4,-0.5,0.5
Laurei Vicol,www.luju.ro,0,0,2,2,0.0,0.0
Vicol,www.luju.ro,0,2,1,3,-0.6666666666666666,0.6666666666666666
Vladimir Ciorba,www.luju.ro,0,5,2,7,-0.7142857142857143,0.7142857142857143
asociat,www.luju.ro,0,1,1,2,-0.5,0.5
președinte,www.luju.ro,5,78,108,191,-0.38219895287958117,0.38219895287958117
seful,www.luju.ro,0,5,1,6,-0.8333333333333334,0.8333333333333334
soț,www.luju.ro,0,1,4,5,-0.2,0.2
București,a1.ro,1,6,28,35,-0.14285714285714285,0.14285714285714285
Cristian Diaconescu,a1.ro,0,1,11,12,-0.08333333333333333,0.08333333333333333
Miron Mitrea,a1.ro,0,1,2,3,-0.3333333333333333,0.3333333333333333
Mitrea,a1.ro,0,2,0,2,-1.0,1.0
Oana Mizil,a1.ro,0,0,2,2,0.0,0.0
Ponta,a1.ro,0,17,2,19,-0.8947368421052632,0.8947368421052632
Traian Băsescu,a1.ro,0,29,31,60,-0.48333333333333334,0.48333333333333334
Victor Ponta,a1.ro,0,17,13,30,-0.5666666666666667,0.5666666666666667
lider,a1.ro,11,27,40,78,-0.20512820512820512,0.20512820512820512
mamă,a1.ro,4,4,5,13,0.0,0.0
om,a1.ro,9,15,25,49,-0.12244897959183673,0.12244897959183673
șef,a1.ro,0,22,18,40,-0.55,0.55
Bapti,www.cotidianul.ro,0,0,1,1,0.0,0.0
Cotroceni,www.cotidianul.ro,0,0,1,1,0.0,0.0
Cristian Terheș,www.cotidianul.ro,0,2,5,7,-0.2857142857142857,0.2857142857142857
George Simion,www.cotidianul.ro,2,29,59,90,-0.3,0.3
Petru Costea,www.cotidianul.ro,0,1,0,1,-1.0,1.0
cetățean,www.cotidianul.ro,9,2,8,19,0.3684210526315789,0.3684210526315789
europarlamentar,www.cotidianul.ro,2,3,6,11,-0.09090909090909091,0.09090909090909091
lider,www.cotidianul.ro,7,48,74,129,-0.3178294573643411,0.3178294573643411
Claudiu Târziu,www.antena3.ro,0,2,6,8,-0.25,0.25
George Simion,www.antena3.ro,1,7,38,46,-0.13043478260869565,0.13043478260869565
Târziu,www.antena3.ro,0,5,0,5,-1.0,1.0
candidați,www.antena3.ro,1,2,11,14,-0.07142857142857142,0.07142857142857142
Cornel Nistorescu,www.realitatea.net,0,0,1,1,0.0,0.0
Florian Coldea,www.realitatea.net,0,1,1,2,-0.5,0.5
George Maior,www.realitatea.net,0,0,1,1,0.0,0.0
Ion Oprișor,www.realitatea.net,0,0,1,1,0.0,0.0
patron,www.realitatea.net,0,1,0,1,-1.0,1.0
Traian Băsescu,www.realitatea.net,0,6,5,11,-0.5454545454545454,0.5454545454545454
diplomat,www.realitatea.net,0,1,1,2,-0.5,0.5
magistrat,www.realitatea.net,1,8,1,10,-0.7,0.7
membru,www.realitatea.net,0,7,7,14,-0.5,0.5
mogul,www.realitatea.net,0,1,0,1,-1.0,1.0
om,www.realitatea.net,22,35,36,93,-0.13978494623655913,0.13978494623655913
om de afaceri,www.realitatea.net,0,2,3,5,-0.4,0.4
ofițer,www.realitatea.net,0,1,1,2,-0.5,0.5
politician,www.realitatea.net,0,24,2,26,-0.9230769230769231,0.9230769230769231
procuror,www.realitatea.net,0,10,5,15,-0.6666666666666666,0.6666666666666666
turișt,www.realitatea.net,0,0,1,1,0.0,0.0
ziarist,www.realitatea.net,0,3,0,3,-1.0,1.0
Elena Lasconi,www.aktual24.ro,4,9,33,46,-0.10869565217391304,0.10869565217391304
Lasconi,www.aktual24.ro,2,7,17,26,-0.19230769230769232,0.19230769230769232
Marcel Ciolacu,www.aktual24.ro,3,39,83,125,-0.288,0.288
Marian Neacșu,www.aktual24.ro,0,3,6,9,-0.3333333333333333,0.3333333333333333
președinte,www.aktual24.ro,17,100,257,374,-0.22192513368983957,0.22192513368983957
lider,www.aktual24.ro,13,71,151,235,-0.24680851063829787,0.24680851063829787
ministru,www.aktual24.ro,1,33,50,84,-0.38095238095238093,0.38095238095238093
parlamentar,www.aktual24.ro,0,30,21,51,-0.5882352941176471,0.5882352941176471
premier,www.aktual24.ro,6,24,64,94,-0.19148936170212766,0.19148936170212766
Călin Georgescu,www.digi24.ro,0,26,21,47,-0.5531914893617021,0.5531914893617021
Georgescu,www.digi24.ro,0,19,1,20,-0.95,0.95
Klaus Iohannis,www.digi24.ro,3,36,77,116,-0.28448275862068967,0.28448275862068967
Nicolas Sarkozy,www.digi24.ro,0,1,0,1,-1.0,1.0
magistrat,www.digi24.ro,0,4,2,6,-0.6666666666666666,0.6666666666666666
președinte,www.digi24.ro,7,84,228,319,-0.2413793103448276,0.2413793103448276
Băsescu,www.digi24.ro,0,14,5,19,-0.7368421052631579,0.7368421052631579
Ciolacu,www.digi24.ro,2,19,23,44,-0.38636363636363635,0.38636363636363635
Emil Boc,www.digi24.ro,0,0,7,7,0.0,0.0
Marcel Ciolacu,www.digi24.ro,5,28,68,101,-0.22772277227722773,0.22772277227722773
România,www.digi24.ro,45,67,129,241,-0.0912863070539419,0.0912863070539419
Statele Unite,www.digi24.ro,6,1,22,29,0.1724137931034483,0.1724137931034483
Traian Băsescu,www.digi24.ro,0,26,27,53,-0.49056603773584906,0.49056603773584906
Donald Trump,www.digi24.ro,0,14,16,30,-0.4666666666666667,0.4666666666666667
lider,www.digi24.ro,7,64,92,163,-0.3496932515337423,0.3496932515337423
premier,www.digi24.ro,4,29,39,72,-0.3472222222222222,0.3472222222222222
șef,www.digi24.ro,1,30,50,81,-0.35802469135802467,0.35802469135802467
Ilie Bolojan,www.comisarul.ro,1,5,29,35,-0.11428571428571428,0.11428571428571428
președinte,www.comisarul.ro,5,54,179,238,-0.20588235294117646,0.20588235294117646
România,www.comisarul.ro,27,48,110,185,-0.11351351351351352,0.11351351351351352
Marcel Ciolacu,www.comisarul.ro,0,32,65,97,-0.32989690721649484,0.32989690721649484
București,observatornews.ro,1,6,21,28,-0.17857142857142858,0.17857142857142858
Capitale,observatornews.ro,0,2,13,15,-0.13333333333333333,0.13333333333333333
Nicușor Dan,observatornews.ro,2,7,40,49,-0.10204081632653061,0.10204081632653061
primar,observatornews.ro,3,19,24,46,-0.34782608695652173,0.34782608695652173
edil,observatornews.ro,0,2,4,6,-0.3333333333333333,0.3333333333333333
Dumnezeu,www.romaniatv.net,9,2,2,13,0.5384615384615384,0.5384615384615384
Nicușor Dan,www.romaniatv.net,14,29,112,155,-0.0967741935483871,0.0967741935483871
Pescobar,www.romaniatv.net,1,0,0,1,1.0,1.0
afacerist,www.romaniatv.net,0,8,0,8,-1.0,1.0
Damaschin,www.romaniatv.net,0,0,1,1,0.0,0.0
Adrian Cioroianu,recorder.ro,0,3,2,5,-0.6,0.6
angajat,recorder.ro,4,31,28,63,-0.42857142857142855,0.42857142857142855
Ankara,recorder.ro,0,0,1,1,0.0,0.0
Arad,recorder.ro,1,2,6,9,-0.1111111111111111,0.1111111111111111
Bacău,recorder.ro,0,0,7,7,0.0,0.0
București,recorder.ro,1,19,98,118,-0.15254237288135594,0.15254237288135594
Emilia Șercan,recorder.ro,0,5,2,7,-0.7142857142857143,0.7142857142857143
fiică,recorder.ro,1,3,4,8,-0.25,0.25
Franța,recorder.ro,2,1,21,24,0.041666666666666664,0.041666666666666664
George Becali,recorder.ro,0,5,1,6,-0.8333333333333334,0.8333333333333334
George Simion,recorder.ro,0,8,48,56,-0.14285714285714285,0.14285714285714285
Ioan Crișan,recorder.ro,0,1,0,1,-1.0,1.0
Marcel Ciolacu,recorder.ro,0,16,39,55,-0.2909090909090909,0.2909090909090909
milionar,recorder.ro,0,1,0,1,-1.0,1.0
Mircea Geoană,recorder.ro,0,3,10,13,-0.23076923076923078,0.23076923076923078
Nicolae Ciucă,recorder.ro,0,8,21,29,-0.27586206896551724,0.27586206896551724
președinte,recorder.ro,1,67,156,224,-0.29464285714285715,0.29464285714285715
Turcia,recorder.ro,0,1,3,4,-0.25,0.25
Viorel Hrebenciuc,recorder.ro,0,0,2,2,0.0,0.0
Văcăroiu,recorder.ro,0,1,1,2,-0.5,0.5
ziarist,recorder.ro,0,10,8,18,-0.5555555555555556,0.5555555555555556
atacator,recorder.ro,0,1,0,1,-1.0,1.0
baron,recorder.ro,0,10,2,12,-0.8333333333333334,0.8333333333333334
contracandidat,recorder.ro,0,9,2,11,-0.8181818181818182,0.8181818181818182
director,recorder.ro,0,33,52,85,-0.38823529411764707,0.38823529411764707
jurnalistă,recorder.ro,0,0,1,1,0.0,0.0
ostatic,recorder.ro,0,4,0,4,-1.0,1.0
parlamentar,recorder.ro,1,107,39,147,-0.7210884353741497,0.7210884353741497
pene,recorder.ro,0,1,0,1,-1.0,1.0
prefect,recorder.ro,1,8,21,30,-0.23333333333333334,0.23333333333333334
primar,recorder.ro,7,81,85,173,-0.4277456647398844,0.4277456647398844
procuror,recorder.ro,0,57,1,58,-0.9827586206896551,0.9827586206896551
secretar general,recorder.ro,0,1,3,4,-0.25,0.25
suspect,recorder.ro,0,11,2,13,-0.8461538461538461,0.8461538461538461
terorist,recorder.ro,0,2,0,2,-1.0,1.0
șef,recorder.ro,1,52,43,96,-0.53125,0.53125
Cristian Andrei,www.cotidianul.ro,0,0,1,1,0.0,0.0
cititor,www.cotidianul.ro,38,0,17,55,0.6909090909090909,0.6909090909090909
comentator,www.cotidianul.ro,0,53,0,53,-1.0,1.0
jurnalist,www.cotidianul.ro,0,9,6,15,-0.6,0.6
persoană,www.cotidianul.ro,1,9,67,77,-0.1038961038961039,0.1038961038961039
rival,www.cotidianul.ro,0,1,0,1,-1.0,1.0
,www.g4media.ro,0,2,3,5,-0.4,0.4
acționar,www.g4media.ro,0,4,2,6,-0.6666666666666666,0.6666666666666666
America,www.g4media.ro,1,3,0,4,-0.5,0.5
Bode,www.g4media.ro,0,0,1,1,0.0,0.0
Bolojan,www.g4media.ro,0,2,11,13,-0.15384615384615385,0.15384615384615385
Ciprian Ciucu,www.g4media.ro,0,0,4,4,0.0,0.0
Ciucu,www.g4media.ro,0,0,2,2,0.0,0.0
Ciucă,www.g4media.ro,0,3,1,4,-0.75,0.75
Călin Georgescu,www.g4media.ro,0,15,21,36,-0.4166666666666667,0.4166666666666667
Cătălin,www.g4media.ro,0,0,1,1,0.0,0.0
Cătălin Dumitru,www.g4media.ro,0,0,1,1,0.0,0.0
Cătălin Predoiu,www.g4media.ro,0,0,8,8,0.0,0.0
Dan,www.g4media.ro,1,1,10,12,0.0,0.0
Dan Motreanu,www.g4media.ro,0,0,4,4,0.0,0.0
Diana Meseșan,www.g4media.ro,0,0,1,1,0.0,0.0
Dineș,www.g4media.ro,0,0,1,1,0.0,0.0
Georgescu,www.g4media.ro,0,8,9,17,-0.47058823529411764,0.47058823529411764
Ilie Bolojan,www.g4media.ro,2,1,43,46,0.021739130434782608,0.021739130434782608
Ionuț Pătrășcoiu,www.g4media.ro,0,0,1,1,0.0,0.0
Lucian,www.g4media.ro,0,0,1,1,0.0,0.0
Motreanu,www.g4media.ro,0,0,1,1,0.0,0.0
Predoiu,www.g4media.ro,0,0,1,1,0.0,0.0
Pătrășcoiu,www.g4media.ro,0,0,1,1,0.0,0.0
Rareș,www.g4media.ro,0,0,1,1,0.0,0.0
Rareș Bogdan,www.g4media.ro,0,1,5,6,-0.16666666666666666,0.16666666666666666
Roberta,www.g4media.ro,0,1,0,1,-1.0,1.0
Roberta Metsola,www.g4media.ro,0,0,1,1,0.0,0.0
România,www.g4media.ro,32,38,96,166,-0.03614457831325301,0.03614457831325301
Simion,www.g4media.ro,0,26,19,45,-0.5777777777777777,0.5777777777777777
Snoop,www.g4media.ro,0,0,2,2,0.0,0.0
Strasbourg,www.g4media.ro,0,0,2,2,0.0,0.0
băiat,www.g4media.ro,1,0,0,1,1.0,1.0
candidat,www.g4media.ro,9,89,118,216,-0.37037037037037035,0.37037037037037035
Nicolae Ciucă,www.g4media.ro,0,4,11,15,-0.26666666666666666,0.26666666666666666
director,www.g4media.ro,0,4,6,10,-0.4,0.4
europarlamentar,www.g4media.ro,1,4,23,28,-0.10714285714285714,0.10714285714285714
influencer,www.g4media.ro,1,5,1,7,-0.5714285714285714,0.5714285714285714
liberal,www.g4media.ro,0,3,5,8,-0.375,0.375
lider,www.g4media.ro,8,102,96,206,-0.4563106796116505,0.4563106796116505
mentor,www.g4media.ro,0,0,1,1,0.0,0.0
ministru,www.g4media.ro,1,22,42,65,-0.3230769230769231,0.3230769230769231
om,www.g4media.ro,19,20,29,68,-0.014705882352941176,0.014705882352941176
premier,www.g4media.ro,0,15,55,70,-0.21428571428571427,0.21428571428571427
profesionist,www.g4media.ro,2,0,1,3,0.6666666666666666,0.6666666666666666
reprezentant,www.g4media.ro,1,32,23,56,-0.5535714285714286,0.5535714285714286
secretar general,www.g4media.ro,0,0,7,7,0.0,0.0
tip,www.g4media.ro,0,0,1,1,0.0,0.0
trol,www.g4media.ro,0,2,0,2,-1.0,1.0
șef,www.g4media.ro,1,34,27,62,-0.532258064516129,0.532258064516129
Anda Badea,agerpres.ro,0,0,24,24,0.0,0.0
Cătălin Predoiu,agerpres.ro,0,0,15,15,0.0,0.0
Daniel Florea,agerpres.ro,0,0,13,13,0.0,0.0
Mihai Simionescu,agerpres.ro,0,0,25,25,0.0,0.0
ministru,agerpres.ro,0,27,37,64,-0.421875,0.421875
AS,agerpres.ro,0,0,3,3,0.0,0.0
Claudia Stănescu,agerpres.ro,0,0,28,28,0.0,0.0
Crin Antonescu,agerpres.ro,2,5,21,28,-0.10714285714285714,0.10714285714285714
Gabriela Badea,agerpres.ro,0,0,28,28,0.0,0.0
George Simion,agerpres.ro,1,8,31,40,-0.175,0.175
Ilie Bolojan,agerpres.ro,1,1,22,24,0.0,0.0
Nicușor Dan,agerpres.ro,19,5,52,76,0.18421052631578946,0.18421052631578946
președinte,agerpres.ro,31,29,185,245,0.00816326530612245,0.00816326530612245
România,agerpres.ro,55,21,100,176,0.19318181818181818,0.19318181818181818
Simion,agerpres.ro,0,5,5,10,-0.5,0.5
Sorin Peneș,agerpres.ro,0,0,1,1,0.0,0.0
candidat,agerpres.ro,6,15,50,71,-0.1267605633802817,0.1267605633802817
lider,agerpres.ro,10,19,63,92,-0.09782608695652174,0.09782608695652174
om,agerpres.ro,16,6,15,37,0.2702702702702703,0.2702702702702703
Dan Tudorache,pressone.ro,0,0,2,2,0.0,0.0
Floarea Nicolae,pressone.ro,0,0,1,1,0.0,0.0
Florian Lixandru,pressone.ro,0,0,1,1,0.0,0.0
Ionel Florian Lixandru,pressone.ro,0,0,1,1,0.0,0.0
Marius Nistor,pressone.ro,0,1,0,1,-1.0,1.0
istoric,pressone.ro,0,1,11,12,-0.08333333333333333,0.08333333333333333
Victor Ponta,pressone.ro,0,24,27,51,-0.47058823529411764,0.47058823529411764
agent,pressone.ro,0,5,1,6,-0.8333333333333334,0.8333333333333334
al,pressone.ro,0,1,0,1,-1.0,1.0
candidat,pressone.ro,4,80,117,201,-0.3781094527363184,0.3781094527363184
director,pressone.ro,0,32,49,81,-0.3950617283950617,0.3950617283950617
funcționar,pressone.ro,0,15,9,24,-0.625,0.625
inspector,pressone.ro,0,6,1,7,-0.8571428571428571,0.8571428571428571
lider,pressone.ro,4,132,85,221,-0.579185520361991,0.579185520361991
participant,pressone.ro,1,4,5,10,-0.3,0.3
personalitate,pressone.ro,1,2,6,9,-0.1111111111111111,0.1111111111111111
președinte,pressone.ro,4,110,213,327,-0.3241590214067278,0.3241590214067278
profesoară,pressone.ro,1,0,3,4,0.25,0.25
profesor,pressone.ro,5,29,27,61,-0.39344262295081966,0.39344262295081966
Sorin Cucerai,pressone.ro,0,0,1,1,0.0,0.0
reprezentant,pressone.ro,0,42,26,68,-0.6176470588235294,0.6176470588235294
senatorul Ecaterina Andronescu,pressone.ro,0,0,1,1,0.0,0.0
șef,pressone.ro,3,77,54,134,-0.5522388059701493,0.5522388059701493
candidat,www.romaniatv.net,13,84,130,227,-0.31277533039647576,0.31277533039647576
George Simion,www.romaniatv.net,7,70,122,199,-0.3165829145728643,0.3165829145728643
Simion,www.romaniatv.net,2,44,34,80,-0.525,0.525
contracandidat,www.romaniatv.net,0,13,4,17,-0.7647058823529411,0.7647058823529411
premier,www.romaniatv.net,2,17,87,106,-0.14150943396226415,0.14150943396226415
Arhiepiscop,recorder.ro,0,1,0,1,-1.0,1.0
Teodosie,recorder.ro,1,2,3,6,-0.16666666666666666,0.16666666666666666
Chișinău,recorder.ro,0,1,3,4,-0.25,0.25
Constanța,recorder.ro,0,3,7,10,-0.3,0.3
Constantin,recorder.ro,0,1,1,2,-0.5,0.5
Cotroceni,recorder.ro,0,2,8,10,-0.2,0.2
Călin Georgescu,recorder.ro,0,12,16,28,-0.42857142857142855,0.42857142857142855
Cătălin Drulă,recorder.ro,0,1,5,6,-0.16666666666666666,0.16666666666666666
Elena Lasconi,recorder.ro,1,5,22,28,-0.14285714285714285,0.14285714285714285
Federația Rusă,recorder.ro,0,1,0,1,-1.0,1.0
Gabriel Vlase,recorder.ro,0,3,1,4,-0.75,0.75
Ilie Petre,recorder.ro,0,1,0,1,-1.0,1.0
Kiev,recorder.ro,0,8,11,19,-0.42105263157894735,0.42105263157894735
lider,recorder.ro,4,74,84,162,-0.43209876543209874,0.43209876543209874
Marine,recorder.ro,0,1,0,1,-1.0,1.0
Moldova,recorder.ro,3,8,13,24,-0.20833333333333334,0.20833333333333334
prim-ministru,recorder.ro,0,6,3,9,-0.6666666666666666,0.6666666666666666
Republica Moldova,recorder.ro,0,3,5,8,-0.375,0.375
România,recorder.ro,9,80,149,238,-0.29831932773109243,0.29831932773109243
agent,recorder.ro,0,5,2,7,-0.7142857142857143,0.7142857142857143
cetățean,recorder.ro,38,46,90,174,-0.04597701149425287,0.04597701149425287
consilier,recorder.ro,2,19,69,90,-0.18888888888888888,0.18888888888888888
funcționar,recorder.ro,1,19,9,29,-0.6206896551724138,0.6206896551724138
judecător,recorder.ro,0,13,8,21,-0.6190476190476191,0.6190476190476191
pacient,recorder.ro,5,19,14,38,-0.3684210526315789,0.3684210526315789
prelat,recorder.ro,0,0,1,1,0.0,0.0
premier,recorder.ro,1,17,36,54,-0.2962962962962963,0.2962962962962963
prezentatoare,recorder.ro,0,1,0,1,-1.0,1.0
Klaus Iohannis,recorder.ro,1,25,47,73,-0.3287671232876712,0.3287671232876712
protagonistă,recorder.ro,0,1,0,1,-1.0,1.0
Iosif Buble,a1.ro,0,0,1,1,0.0,0.0
Ovidiu Lipan,a1.ro,0,0,45,45,0.0,0.0
Roxana Blenche,a1.ro,0,0,49,49,0.0,0.0
ales,a1.ro,0,2,0,2,-1.0,1.0
Samuel,a1.ro,0,13,36,49,-0.2653061224489796,0.2653061224489796
parlamentar,a1.ro,1,18,2,21,-0.8095238095238095,0.8095238095238095
premier,a1.ro,2,13,27,42,-0.2619047619047619,0.2619047619047619
Elena Lasconi,stirileprotv.ro,0,2,27,29,-0.06896551724137931,0.06896551724137931
Ilie Bolojan,stirileprotv.ro,0,0,24,24,0.0,0.0
cetățean,stirileprotv.ro,20,7,16,43,0.3023255813953488,0.3023255813953488
investitor,stirileprotv.ro,1,1,0,2,0.0,0.0
persoană,stirileprotv.ro,1,11,19,31,-0.3225806451612903,0.3225806451612903
urmăritor,stirileprotv.ro,0,1,0,1,-1.0,1.0
Anamaria Gavrilă,www.romaniatv.net,0,10,13,23,-0.43478260869565216,0.43478260869565216
Antonescu,www.romaniatv.net,2,5,10,17,-0.17647058823529413,0.17647058823529413
Claudiu Târziu,www.romaniatv.net,0,7,22,29,-0.2413793103448276,0.2413793103448276
Cotroceni,www.romaniatv.net,0,0,12,12,0.0,0.0
Călin Georgescu,www.romaniatv.net,2,42,69,113,-0.35398230088495575,0.35398230088495575
Diana Șoșoacă,www.romaniatv.net,0,9,8,17,-0.5294117647058824,0.5294117647058824
eurodeputat,www.romaniatv.net,0,0,5,5,0.0,0.0
Gavrilă,www.romaniatv.net,0,1,1,2,-0.5,0.5
președinte,www.romaniatv.net,13,81,233,327,-0.20795107033639143,0.20795107033639143
România,www.romaniatv.net,25,57,169,251,-0.12749003984063745,0.12749003984063745
Rusia,www.romaniatv.net,0,15,3,18,-0.8333333333333334,0.8333333333333334
Târziu,www.romaniatv.net,0,5,5,10,-0.5,0.5
coleg,www.romaniatv.net,9,8,18,35,0.02857142857142857,0.02857142857142857
deputat,www.romaniatv.net,0,30,27,57,-0.5263157894736842,0.5263157894736842
Georgescu,www.romaniatv.net,2,17,12,31,-0.4838709677419355,0.4838709677419355
electorat,www.romaniatv.net,0,7,17,24,-0.2916666666666667,0.2916666666666667
judecător,www.romaniatv.net,0,7,9,16,-0.4375,0.4375
lider,www.romaniatv.net,12,107,131,250,-0.38,0.38
senator,www.romaniatv.net,0,9,27,36,-0.25,0.25
Șoșoacă,www.romaniatv.net,0,3,1,4,-0.75,0.75
Ciolacu,www.euronews.ro,1,18,28,47,-0.3617021276595745,0.3617021276595745
Daniel Băluță,www.euronews.ro,0,0,4,4,0.0,0.0
Marcel Ciolacu,www.euronews.ro,3,23,119,145,-0.13793103448275862,0.13793103448275862
Negrescu,www.euronews.ro,0,0,1,1,0.0,0.0
Victor Negrescu,www.euronews.ro,0,0,6,6,0.0,0.0
lider,www.euronews.ro,4,54,125,183,-0.273224043715847,0.273224043715847
București,www.gandul.ro,2,5,44,51,-0.058823529411764705,0.058823529411764705
Nicolae Ciucă,www.gandul.ro,2,7,31,40,-0.125,0.125
Remus Borza,www.gandul.ro,0,0,2,2,0.0,0.0
Dan Ostahie,www.gandul.ro,0,0,2,2,0.0,0.0
candidat,www.gandul.ro,11,49,166,226,-0.168141592920354,0.168141592920354
lider,www.gandul.ro,11,42,86,139,-0.22302158273381295,0.22302158273381295
Cătălin Cîrstoiu,www.gandul.ro,1,0,6,7,0.14285714285714285,0.14285714285714285
om,www.gandul.ro,33,25,38,96,0.08333333333333333,0.08333333333333333
patron,www.gandul.ro,0,1,2,3,-0.3333333333333333,0.3333333333333333
șef,www.gandul.ro,4,27,44,75,-0.30666666666666664,0.30666666666666664
Antonescu,www.gandul.ro,0,2,17,19,-0.10526315789473684,0.10526315789473684
Craiova,www.gandul.ro,0,0,6,6,0.0,0.0
Crin Antonescu,www.gandul.ro,2,4,44,50,-0.04,0.04
Donald Trump,www.gandul.ro,0,18,15,33,-0.5454545454545454,0.5454545454545454
România,www.gandul.ro,45,45,140,230,0.0,0.0
europarlamentar,www.gandul.ro,3,5,19,27,-0.07407407407407407,0.07407407407407407
membru,www.gandul.ro,3,18,43,64,-0.234375,0.234375
președinte,www.gandul.ro,13,58,190,261,-0.1724137931034483,0.1724137931034483
candidat,adevarul.ro,19,148,412,579,-0.22279792746113988,0.22279792746113988
Crin Antonescu,adevarul.ro,0,18,105,123,-0.14634146341463414,0.14634146341463414
Călin Georgescu,adevarul.ro,4,68,113,185,-0.34594594594594597,0.34594594594594597
România,adevarul.ro,61,117,304,482,-0.11618257261410789,0.11618257261410789
echipaj,adevarul.ro,0,0,1,1,0.0,0.0
pasager,adevarul.ro,0,1,1,2,-0.5,0.5
piloți,adevarul.ro,0,1,0,1,-1.0,1.0
simpatizant,adevarul.ro,0,9,2,11,-0.8181818181818182,0.8181818181818182
Bruxelles,adevarul.ro,0,4,22,26,-0.15384615384615385,0.15384615384615385
Iohannis,adevarul.ro,0,0,1,1,0.0,0.0
Klaus Iohannis,adevarul.ro,9,30,49,88,-0.23863636363636365,0.23863636363636365
președinte,adevarul.ro,15,133,397,545,-0.21651376146788992,0.21651376146788992
Republica Moldova,adevarul.ro,11,5,27,43,0.13953488372093023,0.13953488372093023
Ucraina,adevarul.ro,6,16,35,57,-0.17543859649122806,0.17543859649122806
șef de stat,adevarul.ro,1,4,6,11,-0.2727272727272727,0.2727272727272727
Marcel Ciolacu,observatornews.ro,1,17,100,118,-0.13559322033898305,0.13559322033898305
Mircea Geoană,observatornews.ro,0,2,4,6,-0.3333333333333333,0.3333333333333333
Paul Stănescu,observatornews.ro,0,0,7,7,0.0,0.0
Stănescu,observatornews.ro,0,0,2,2,0.0,0.0
Sâmbăta de Sus,observatornews.ro,0,0,2,2,0.0,0.0
candidat,observatornews.ro,2,28,78,108,-0.24074074074074073,0.24074074074074073
membru,observatornews.ro,0,4,38,42,-0.09523809523809523,0.09523809523809523
Belarus,adevarul.ro,0,3,4,7,-0.42857142857142855,0.42857142857142855
Brașov,adevarul.ro,2,0,9,11,0.18181818181818182,0.18181818181818182
București,adevarul.ro,2,17,51,70,-0.21428571428571427,0.21428571428571427
Capitale,adevarul.ro,2,8,38,48,-0.125,0.125
edil,adevarul.ro,0,16,10,26,-0.6153846153846154,0.6153846153846154
Elena Lasconi,adevarul.ro,9,28,188,225,-0.08444444444444445,0.08444444444444445
Făgăraș,adevarul.ro,0,0,1,1,0.0,0.0
Gabriela Firea,adevarul.ro,1,4,5,10,-0.3,0.3
Matei Păun,adevarul.ro,0,3,5,8,-0.375,0.375
Nicușor Dan,adevarul.ro,8,32,100,140,-0.17142857142857143,0.17142857142857143
Paris,adevarul.ro,0,0,9,9,0.0,0.0
Predeal,adevarul.ro,0,0,1,1,0.0,0.0
primar,adevarul.ro,3,44,86,133,-0.3082706766917293,0.3082706766917293
coleg,adevarul.ro,11,11,21,43,0.0,0.0
contracandidat,adevarul.ro,0,24,6,30,-0.8,0.8
copil,adevarul.ro,9,7,9,25,0.08,0.08
director,adevarul.ro,0,14,33,47,-0.2978723404255319,0.2978723404255319
fondator,adevarul.ro,1,1,9,11,0.0,0.0
partener,adevarul.ro,3,5,14,22,-0.09090909090909091,0.09090909090909091
persoană,adevarul.ro,6,38,85,129,-0.24806201550387597,0.24806201550387597
Călin Georgescu,stirileprotv.ro,0,4,10,14,-0.2857142857142857,0.2857142857142857
Vasile Bănescu,stirileprotv.ro,0,0,1,1,0.0,0.0
sfânt,stirileprotv.ro,0,0,1,1,0.0,0.0
Antonescu,www.realitatea.net,0,1,5,6,-0.16666666666666666,0.16666666666666666
București,www.realitatea.net,1,10,13,24,-0.375,0.375
Cluj,www.realitatea.net,0,0,1,1,0.0,0.0
Crin Antonescu,www.realitatea.net,0,4,16,20,-0.2,0.2
Dumnezeu,www.realitatea.net,7,2,2,11,0.45454545454545453,0.45454545454545453
Funar,www.realitatea.net,0,0,1,1,0.0,0.0
Gheorghe Funar,www.realitatea.net,0,1,0,1,-1.0,1.0
președinte,www.realitatea.net,6,42,66,114,-0.3157894736842105,0.3157894736842105
Președintele,www.realitatea.net,0,0,8,8,0.0,0.0
România,www.realitatea.net,9,49,64,122,-0.32786885245901637,0.32786885245901637
Funar Gheorghe,www.realitatea.net,0,0,1,1,0.0,0.0
Teleorman,www.realitatea.net,0,0,1,1,0.0,0.0
Tulcea,www.realitatea.net,0,0,2,2,0.0,0.0
urenițiu,www.realitatea.net,0,1,0,1,-1.0,1.0
alegător,www.realitatea.net,0,2,2,4,-0.5,0.5
candidați,www.realitatea.net,1,2,7,10,-0.1,0.1
cetățean,www.realitatea.net,3,5,13,21,-0.09523809523809523,0.09523809523809523
deputat,www.realitatea.net,0,9,3,12,-0.75,0.75
judecător,www.realitatea.net,0,7,11,18,-0.3888888888888889,0.3888888888888889
ministru,www.realitatea.net,1,9,6,16,-0.5,0.5
persoană,www.realitatea.net,1,14,11,26,-0.5,0.5
popor,www.realitatea.net,26,13,5,44,0.29545454545454547,0.29545454545454547
primar,www.realitatea.net,1,12,6,19,-0.5789473684210527,0.5789473684210527
senator,www.realitatea.net,0,0,8,8,0.0,0.0
București,www.cotidianul.ro,1,6,19,26,-0.19230769230769232,0.19230769230769232
Mario Nawfal,www.cotidianul.ro,0,1,1,2,-0.5,0.5
Kathleen Kavalec,www.cotidianul.ro,0,1,0,1,-1.0,1.0
SUA,www.cotidianul.ro,1,8,1,10,-0.7,0.7
ambasadoare,www.cotidianul.ro,0,1,0,1,-1.0,1.0
Arad,snoop.ro,0,1,2,3,-0.3333333333333333,0.3333333333333333
Baia Mare,snoop.ro,0,0,2,2,0.0,0.0
București,snoop.ro,0,5,48,53,-0.09433962264150944,0.09433962264150944
bărbat,snoop.ro,0,6,25,31,-0.1935483870967742,0.1935483870967742
Ceaușescu,snoop.ro,0,4,1,5,-0.8,0.8
Crescuse,snoop.ro,0,1,0,1,-1.0,1.0
Edward Shorter,snoop.ro,0,0,1,1,0.0,0.0
Elveția,snoop.ro,0,0,4,4,0.0,0.0
Franța,snoop.ro,0,0,9,9,0.0,0.0
Galați,snoop.ro,0,0,3,3,0.0,0.0
Germania,snoop.ro,0,1,8,9,-0.1111111111111111,0.1111111111111111
Gheorghe Marinescu,snoop.ro,0,0,1,1,0.0,0.0
Ion Vianu,snoop.ro,0,0,1,1,0.0,0.0
Joseph Caillat,snoop.ro,0,0,1,1,0.0,0.0
La Mărcuța,snoop.ro,0,0,1,1,0.0,0.0
Londra,snoop.ro,0,0,5,5,0.0,0.0
Lăzărescu,snoop.ro,0,1,0,1,-1.0,1.0
Marinescu,snoop.ro,0,0,1,1,0.0,0.0
medic,snoop.ro,1,9,38,48,-0.16666666666666666,0.16666666666666666
Mugur Ciumăgeanu,snoop.ro,0,0,7,7,0.0,0.0
măr,snoop.ro,0,0,1,1,0.0,0.0
Mărcuță,snoop.ro,0,0,1,1,0.0,0.0
Mărășoiu,snoop.ro,0,0,1,1,0.0,0.0
Nicolae Gănescu,snoop.ro,0,0,1,1,0.0,0.0
Obregia,snoop.ro,0,0,1,1,0.0,0.0
Ospiciul,snoop.ro,0,0,1,1,0.0,0.0
Paraschiv,snoop.ro,0,1,0,1,-1.0,1.0
Paris,snoop.ro,0,0,2,2,0.0,0.0
Petre Protici,snoop.ro,0,1,0,1,-1.0,1.0
Petroșani,snoop.ro,0,1,0,1,-1.0,1.0
Piatra Neamț,snoop.ro,0,0,1,1,0.0,0.0
Pitești,snoop.ro,0,0,3,3,0.0,0.0
Ploiești,snoop.ro,0,0,6,6,0.0,0.0
Reșița,snoop.ro,0,1,1,2,-0.5,0.5
România,snoop.ro,3,19,51,73,-0.2191780821917808,0.2191780821917808
Satu Mare,snoop.ro,0,0,5,5,0.0,0.0
Sibiu,snoop.ro,0,0,7,7,0.0,0.0
Suțu,snoop.ro,0,0,1,1,0.0,0.0
Timișoara,snoop.ro,0,0,5,5,0.0,0.0
Târgu Mureș,snoop.ro,0,1,2,3,-0.3333333333333333,0.3333333333333333
URSS,snoop.ro,0,0,2,2,0.0,0.0
urlător,snoop.ro,0,1,0,1,-1.0,1.0
Vasile Paraschiv,snoop.ro,0,1,0,1,-1.0,1.0
Vasile Predescu,snoop.ro,0,0,1,1,0.0,0.0
Vianu,snoop.ro,1,0,0,1,1.0,1.0
ajutoare,snoop.ro,0,0,1,1,0.0,0.0
asistent,snoop.ro,0,3,6,9,-0.3333333333333333,0.3333333333333333
asistent medical,snoop.ro,0,0,4,4,0.0,0.0
bolnav,snoop.ro,0,10,3,13,-0.7692307692307693,0.7692307692307693
bărbier,snoop.ro,0,0,1,1,0.0,0.0
Alexandra Mărășoiu,snoop.ro,0,0,1,1,0.0,0.0
Jack Friedman,snoop.ro,0,0,1,1,0.0,0.0
cetățean,snoop.ro,0,3,15,18,-0.16666666666666666,0.16666666666666666
director,snoop.ro,0,7,21,28,-0.25,0.25
disident,snoop.ro,0,1,0,1,-1.0,1.0
familie,snoop.ro,1,6,39,46,-0.10869565217391304,0.10869565217391304
femeie,snoop.ro,1,8,20,29,-0.2413793103448276,0.2413793103448276
instructor,snoop.ro,0,0,1,1,0.0,0.0
istoric,snoop.ro,0,2,2,4,-0.5,0.5
logoped,snoop.ro,0,0,1,1,0.0,0.0
lucrător,snoop.ro,0,2,3,5,-0.4,0.4
membru,snoop.ro,2,8,39,49,-0.12244897959183673,0.12244897959183673
muncitor,snoop.ro,1,1,3,5,0.0,0.0
om,snoop.ro,15,41,74,130,-0.2,0.2
opozant,snoop.ro,0,1,0,1,-1.0,1.0
pacient,snoop.ro,5,15,37,57,-0.17543859649122806,0.17543859649122806
persoană,snoop.ro,5,22,55,82,-0.2073170731707317,0.2073170731707317
popor,snoop.ro,1,3,0,4,-0.5,0.5
populație,snoop.ro,0,8,9,17,-0.47058823529411764,0.47058823529411764
psihiatru,snoop.ro,0,3,9,12,-0.25,0.25
psiholog,snoop.ro,0,2,6,8,-0.25,0.25
psihotic,snoop.ro,0,1,0,1,-1.0,1.0
public,snoop.ro,0,10,6,16,-0.625,0.625
părinte,snoop.ro,1,3,20,24,-0.08333333333333333,0.08333333333333333
ri,snoop.ro,0,0,1,1,0.0,0.0
sociolog,snoop.ro,0,2,3,5,-0.4,0.4
student,snoop.ro,1,7,11,19,-0.3157894736842105,0.3157894736842105
sărac,snoop.ro,0,0,1,1,0.0,0.0
îngrijitor,snoop.ro,0,1,1,2,-0.5,0.5
țară,snoop.ro,0,0,1,1,0.0,0.0
țărănim,snoop.ro,0,1,0,1,-1.0,1.0
București,www.euronews.ro,1,1,29,31,0.0,0.0
Ilie Bolojan,www.euronews.ro,4,0,40,44,0.09090909090909091,0.09090909090909091
Nicușor Dan,www.euronews.ro,11,4,76,91,0.07692307692307693,0.07692307692307693
Sâmbăta de Sus,www.euronews.ro,0,0,1,1,0.0,0.0
elector,www.euronews.ro,0,1,1,2,-0.5,0.5
membru,www.euronews.ro,1,5,41,47,-0.0851063829787234,0.0851063829787234
politician,www.euronews.ro,0,27,3,30,-0.9,0.9
reprezentant,www.euronews.ro,0,20,15,35,-0.5714285714285714,0.5714285714285714
Diana Șoșoacă,www.digi24.ro,0,3,8,11,-0.2727272727272727,0.2727272727272727
Dragoș Sprînceană,www.digi24.ro,0,7,8,15,-0.4666666666666667,0.4666666666666667
Florida,www.digi24.ro,0,0,1,1,0.0,0.0
Mar,www.digi24.ro,0,0,2,2,0.0,0.0
prim-ministru,www.digi24.ro,0,4,8,12,-0.3333333333333333,0.3333333333333333
Clement Sava,www.digi24.ro,0,0,1,1,0.0,0.0
Statele Unite ale Americii,www.digi24.ro,1,2,3,6,-0.16666666666666666,0.16666666666666666
administrație,www.digi24.ro,0,1,0,1,-1.0,1.0
candidat,www.digi24.ro,7,47,101,155,-0.25806451612903225,0.25806451612903225
coleg,www.digi24.ro,7,10,15,32,-0.09375,0.09375
emisar,www.digi24.ro,0,15,6,21,-0.7142857142857143,0.7142857142857143
Șoșoacă,www.digi24.ro,0,4,2,6,-0.6666666666666666,0.6666666666666666
George Simion,www.comisarul.ro,5,42,129,176,-0.21022727272727273,0.21022727272727273
Jack Posobiec,www.comisarul.ro,0,0,2,2,0.0,0.0
Orban,www.comisarul.ro,0,2,2,4,-0.5,0.5
parlamentar,www.comisarul.ro,0,21,10,31,-0.6774193548387096,0.6774193548387096
prim-ministru,www.comisarul.ro,0,1,1,2,-0.5,0.5
SUA,www.comisarul.ro,1,7,16,24,-0.25,0.25
Ungaria,www.comisarul.ro,0,0,7,7,0.0,0.0
Ungarie,www.comisarul.ro,0,2,3,5,-0.4,0.4
Victor Orbán,www.comisarul.ro,1,0,0,1,1.0,1.0
Viktor Orban,www.comisarul.ro,0,4,1,5,-0.8,0.8
Vlad Voiculescu,www.comisarul.ro,0,0,1,1,0.0,0.0
candidat,www.comisarul.ro,6,76,173,255,-0.27450980392156865,0.27450980392156865
cetățean,www.comisarul.ro,10,4,19,33,0.18181818181818182,0.18181818181818182
comentator,www.comisarul.ro,0,0,2,2,0.0,0.0
etnic,www.comisarul.ro,0,2,1,3,-0.6666666666666666,0.6666666666666666
premier,www.comisarul.ro,1,15,34,50,-0.28,0.28
Donald Trump,www.comisarul.ro,0,23,16,39,-0.5897435897435898,0.5897435897435898
Ciolacu,primanews.ro,0,14,19,33,-0.42424242424242425,0.42424242424242425
prim-ministru,primanews.ro,0,5,10,15,-0.3333333333333333,0.3333333333333333
Sâmbăta de Sus,primanews.ro,0,0,1,1,0.0,0.0
știlor,primanews.ro,0,1,0,1,-1.0,1.0
Anamaria Gavrilă,www.comisarul.ro,0,5,13,18,-0.2777777777777778,0.2777777777777778
Gavrilă,www.comisarul.ro,0,3,4,7,-0.42857142857142855,0.42857142857142855
lider,www.comisarul.ro,4,92,131,227,-0.3876651982378855,0.3876651982378855
Nicușor Dan,www.comisarul.ro,14,24,111,149,-0.06711409395973154,0.06711409395973154
Simion,www.comisarul.ro,4,36,49,89,-0.3595505617977528,0.3595505617977528
internat,www.comisarul.ro,0,2,0,2,-1.0,1.0
Lucian Mândruță,www.comisarul.ro,0,0,1,1,0.0,0.0
persoană,www.comisarul.ro,0,21,59,80,-0.2625,0.2625
utilizator,www.comisarul.ro,0,1,4,5,-0.2,0.2
șef,www.comisarul.ro,0,37,35,72,-0.5138888888888888,0.5138888888888888
Alba,observatornews.ro,0,0,2,2,0.0,0.0
capitală,observatornews.ro,0,1,6,7,-0.14285714285714285,0.14285714285714285
Cluj,observatornews.ro,0,0,2,2,0.0,0.0
Dolj,observatornews.ro,0,1,0,1,-1.0,1.0
Florin Cîțu,observatornews.ro,0,12,18,30,-0.4,0.4
Gorj,observatornews.ro,0,0,3,3,0.0,0.0
Grindeanu,observatornews.ro,0,2,7,9,-0.2222222222222222,0.2222222222222222
Mehedinți,observatornews.ro,0,0,2,2,0.0,0.0
România,observatornews.ro,24,30,112,166,-0.03614457831325301,0.03614457831325301
Sibiu,observatornews.ro,0,0,5,5,0.0,0.0
Sorin Grindeanu,observatornews.ro,0,2,19,21,-0.09523809523809523,0.09523809523809523
Suceava,observatornews.ro,0,0,2,2,0.0,0.0
Timiș,observatornews.ro,0,0,2,2,0.0,0.0
Vasile Dîncu,observatornews.ro,0,0,4,4,0.0,0.0
copil,observatornews.ro,3,3,4,10,0.0,0.0
liberal,observatornews.ro,0,4,4,8,-0.5,0.5
politruc,observatornews.ro,0,1,0,1,-1.0,1.0
populație,observatornews.ro,1,2,7,10,-0.1,0.1
premier,observatornews.ro,1,24,65,90,-0.25555555555555554,0.25555555555555554
președinte,observatornews.ro,6,36,185,227,-0.13215859030837004,0.13215859030837004
secretar,observatornews.ro,0,3,10,13,-0.23076923076923078,0.23076923076923078
specialist,observatornews.ro,0,1,2,3,-0.3333333333333333,0.3333333333333333
vicepremier,observatornews.ro,0,0,4,4,0.0,0.0
șef,observatornews.ro,2,34,44,80,-0.4,0.4
Bruxelles,www.b1tv.ro,0,1,2,3,-0.3333333333333333,0.3333333333333333
București,www.b1tv.ro,0,3,10,13,-0.23076923076923078,0.23076923076923078
Vlad Vociculescu,www.b1tv.ro,0,0,1,1,0.0,0.0
Vlad Voiculescu,www.b1tv.ro,1,0,4,5,0.2,0.2
Voiculescu,www.b1tv.ro,0,0,1,1,0.0,0.0
asistent,www.b1tv.ro,0,1,1,2,-0.5,0.5
europarlamentar,www.b1tv.ro,2,3,4,9,-0.1111111111111111,0.1111111111111111
lider,www.b1tv.ro,2,13,19,34,-0.3235294117647059,0.3235294117647059
medic,www.b1tv.ro,0,0,3,3,0.0,0.0
ministru,www.b1tv.ro,1,7,10,18,-0.3333333333333333,0.3333333333333333
președinte,www.b1tv.ro,1,25,42,68,-0.35294117647058826,0.35294117647058826
reprezentant,www.b1tv.ro,1,3,5,9,-0.2222222222222222,0.2222222222222222
Capitale,www.digi24.ro,1,3,10,14,-0.14285714285714285,0.14285714285714285
Dan,www.digi24.ro,0,0,4,4,0.0,0.0
Edil general,www.digi24.ro,0,1,0,1,-1.0,1.0
Elena Lasconi,www.digi24.ro,0,4,38,42,-0.09523809523809523,0.09523809523809523
Ludovic Orban,www.digi24.ro,1,7,10,18,-0.3333333333333333,0.3333333333333333
Nicolae Ciucă,www.digi24.ro,2,6,27,35,-0.11428571428571428,0.11428571428571428
Nicușor Dan,www.digi24.ro,3,6,22,31,-0.0967741935483871,0.0967741935483871
edil general,www.digi24.ro,0,1,0,1,-1.0,1.0
lume,www.digi24.ro,0,6,1,7,-0.8571428571428571,0.8571428571428571
persoană,www.digi24.ro,1,6,20,27,-0.18518518518518517,0.18518518518518517
primar,www.digi24.ro,3,15,22,40,-0.3,0.3
Ana Loredana Predescu,www.g4media.ro,0,1,0,1,-1.0,1.0
București,www.g4media.ro,2,7,44,53,-0.09433962264150944,0.09433962264150944
Cornel Folescu,www.g4media.ro,0,1,0,1,-1.0,1.0
Călin Gheorghe Matieș,www.g4media.ro,0,0,1,1,0.0,0.0
Călărași,www.g4media.ro,0,0,1,1,0.0,0.0
Dan Diaconescu,www.g4media.ro,0,0,1,1,0.0,0.0
Daniel Florea,www.g4media.ro,0,0,3,3,0.0,0.0
Dumitru Coarnă,www.g4media.ro,0,3,1,4,-0.75,0.75
Dumitru Viorel Foșca,www.g4media.ro,0,0,1,1,0.0,0.0
Folescu,www.g4media.ro,0,1,0,1,-1.0,1.0
George Simion,www.g4media.ro,3,51,85,139,-0.34532374100719426,0.34532374100719426
Georgiana Teodorescu,www.g4media.ro,0,0,5,5,0.0,0.0
Gheorghe Piperea,www.g4media.ro,0,3,2,5,-0.6,0.6
Ilan Laufer,www.g4media.ro,0,0,2,2,0.0,0.0
Laufer,www.g4media.ro,0,1,0,1,-1.0,1.0
Maria Georgiana Teodorescu,www.g4media.ro,0,1,0,1,-1.0,1.0
Mariana Georgiana Teodorescu,www.g4media.ro,0,0,1,1,0.0,0.0
Marius Lulea,www.g4media.ro,0,3,10,13,-0.23076923076923078,0.23076923076923078
Mihai Tudose,www.g4media.ro,0,0,9,9,0.0,0.0
Nicolae Bălcescu,www.g4media.ro,0,0,1,1,0.0,0.0
Petreanu,www.g4media.ro,0,0,1,1,0.0,0.0
Sorin,www.g4media.ro,0,1,0,1,-1.0,1.0
Sorin Constantinescu,www.g4media.ro,0,1,0,1,-1.0,1.0
Sorin Ilieșiu,www.g4media.ro,0,0,1,1,0.0,0.0
Tudor Ciuhodaru,www.g4media.ro,0,1,2,3,-0.3333333333333333,0.3333333333333333
Vlad Petreanu,www.g4media.ro,0,2,0,2,-1.0,1.0
ales,www.g4media.ro,0,2,1,3,-0.6666666666666666,0.6666666666666666
ambasador,www.g4media.ro,0,6,4,10,-0.6,0.6
avocatul Piperea,www.g4media.ro,0,1,0,1,-1.0,1.0
cetățean,www.g4media.ro,18,6,22,46,0.2608695652173913,0.2608695652173913
cititor,www.g4media.ro,1,0,3,4,0.25,0.25
consilier,www.g4media.ro,6,9,28,43,-0.06976744186046512,0.06976744186046512
coordonator,www.g4media.ro,0,4,6,10,-0.4,0.4
deputat,www.g4media.ro,1,33,39,73,-0.4383561643835616,0.4383561643835616
jurnalist,www.g4media.ro,0,12,9,21,-0.5714285714285714,0.5714285714285714
membru,www.g4media.ro,6,24,58,88,-0.20454545454545456,0.20454545454545456
parlamentar,www.g4media.ro,1,21,14,36,-0.5555555555555556,0.5555555555555556
persoană,www.g4media.ro,5,15,37,57,-0.17543859649122806,0.17543859649122806
Marcel Ciolacu,www.g4media.ro,2,17,62,81,-0.18518518518518517,0.18518518518518517
președinte,www.g4media.ro,7,46,191,244,-0.1598360655737705,0.1598360655737705
prim-ministru,www.g4media.ro,0,1,7,8,-0.125,0.125
primar,www.g4media.ro,3,24,66,93,-0.22580645161290322,0.22580645161290322
rege,www.g4media.ro,0,1,0,1,-1.0,1.0
senator,www.g4media.ro,0,12,31,43,-0.27906976744186046,0.27906976744186046
traseiști,www.g4media.ro,0,1,1,2,-0.5,0.5
traseist politic,www.g4media.ro,0,1,0,1,-1.0,1.0
ziarist,www.g4media.ro,0,1,1,2,-0.5,0.5
Anca Suciu,www.digi24.ro,0,0,3,3,0.0,0.0
Liviu Dragnea,www.digi24.ro,0,10,10,20,-0.5,0.5
Florin Cîțu,www.digi24.ro,0,1,3,4,-0.25,0.25
Orban,www.digi24.ro,0,3,2,5,-0.6,0.6
senator,www.digi24.ro,0,12,23,35,-0.34285714285714286,0.34285714285714286
eurodeputat,adevarul.ro,3,3,12,18,0.0,0.0
Ilie Bolojan,adevarul.ro,2,5,50,57,-0.05263157894736842,0.05263157894736842
Nicu Ștefănuță,adevarul.ro,1,0,5,6,0.16666666666666666,0.16666666666666666
Victor Negrescu,adevarul.ro,1,0,9,10,0.1,0.1
europarlamentar,adevarul.ro,4,9,32,45,-0.1111111111111111,0.1111111111111111
membru,adevarul.ro,6,40,94,140,-0.24285714285714285,0.24285714285714285
președinte interimar,adevarul.ro,0,0,12,12,0.0,0.0
reprezentant,adevarul.ro,2,39,56,97,-0.38144329896907214,0.38144329896907214
vicepreședinte,adevarul.ro,1,11,38,50,-0.2,0.2
Dinescu,www.realitatea.net,0,2,1,3,-0.6666666666666666,0.6666666666666666
lider,www.realitatea.net,3,22,33,58,-0.3275862068965517,0.3275862068965517
Nicolae Ciucă,www.realitatea.net,3,0,5,8,0.375,0.375
soție,www.realitatea.net,0,1,3,4,-0.25,0.25
deputat,www.cotidianul.ro,1,34,19,54,-0.6111111111111112,0.6111111111111112
Marcel Ciolacu,www.cotidianul.ro,5,24,32,61,-0.3114754098360656,0.3114754098360656
Nicușor Dan,www.cotidianul.ro,9,25,38,72,-0.2222222222222222,0.2222222222222222
România,www.cotidianul.ro,19,69,94,182,-0.27472527472527475,0.27472527472527475
Simion,www.cotidianul.ro,1,23,23,47,-0.46808510638297873,0.46808510638297873
Volodimir Zelenski,www.cotidianul.ro,0,0,34,34,0.0,0.0
SUA,primanews.ro,1,4,9,14,-0.21428571428571427,0.21428571428571427
expert,www.comisarul.ro,6,5,14,25,0.04,0.04
Titi Aur,www.comisarul.ro,3,1,1,5,0.4,0.4
conducător auto,www.comisarul.ro,0,1,0,1,-1.0,1.0
șofer,www.comisarul.ro,0,7,7,14,-0.5,0.5
Franța,observatornews.ro,3,1,5,9,0.2222222222222222,0.2222222222222222
femeie,observatornews.ro,2,1,11,14,0.07142857142857142,0.07142857142857142
om,observatornews.ro,11,20,31,62,-0.14516129032258066,0.14516129032258066
Buzău,www.g4media.ro,0,3,15,18,-0.16666666666666666,0.16666666666666666
Constantin Toma,www.g4media.ro,0,0,9,9,0.0,0.0
Crin Antonescu,www.g4media.ro,1,11,32,44,-0.22727272727272727,0.22727272727272727
Nicușor Dan,www.g4media.ro,12,11,70,93,0.010752688172043012,0.010752688172043012
Brașov,www.aktual24.ro,0,1,6,7,-0.14285714285714285,0.14285714285714285
Dumnezeu,www.aktual24.ro,3,4,3,10,-0.1,0.1
preot,www.aktual24.ro,0,2,2,4,-0.5,0.5
Radu Hossu,www.aktual24.ro,0,0,1,1,0.0,0.0
Ucraina,www.aktual24.ro,4,10,29,43,-0.13953488372093023,0.13953488372093023
Vasile Bănescu,www.aktual24.ro,0,0,2,2,0.0,0.0
activist,www.aktual24.ro,0,6,3,9,-0.6666666666666666,0.6666666666666666
purtător de cuvânt,www.aktual24.ro,0,3,20,23,-0.13043478260869565,0.13043478260869565
Ciolacu,www.gandul.ro,1,12,33,46,-0.2391304347826087,0.2391304347826087
Dragoș Sprînceană,www.gandul.ro,0,4,1,5,-0.8,0.8
Florida,www.gandul.ro,0,0,4,4,0.0,0.0
Palm Beach,www.gandul.ro,0,0,1,1,0.0,0.0
Sprînceană,www.gandul.ro,0,3,0,3,-1.0,1.0
aliat,www.gandul.ro,1,3,2,6,-0.3333333333333333,0.3333333333333333
antreprenor,www.gandul.ro,4,2,0,6,0.3333333333333333,0.3333333333333333
oficial,www.gandul.ro,0,14,7,21,-0.6666666666666666,0.6666666666666666
fiu,www.antena3.ro,0,2,5,7,-0.2857142857142857,0.2857142857142857
Mihai Gâdea,www.antena3.ro,0,1,18,19,-0.05263157894736842,0.05263157894736842
Nicolae Ciucă,www.antena3.ro,1,1,9,11,0.0,0.0
tânăr,www.antena3.ro,3,2,4,9,0.1111111111111111,0.1111111111111111
comentator,www.antena3.ro,0,1,0,1,-1.0,1.0
familie,www.antena3.ro,4,3,12,19,0.05263157894736842,0.05263157894736842
nepot,www.antena3.ro,1,0,4,5,0.2,0.2
tată,www.antena3.ro,0,3,4,7,-0.42857142857142855,0.42857142857142855
Ștefan Ciucă,www.antena3.ro,0,0,2,2,0.0,0.0
Becali,www.comisarul.ro,0,3,3,6,-0.5,0.5
Daniel Cătălin Ciornei,www.comisarul.ro,0,0,3,3,0.0,0.0
George Becali,www.comisarul.ro,0,2,3,5,-0.4,0.4
Mihai Bogdan Negoescu,www.comisarul.ro,0,0,1,1,0.0,0.0
Răzvan Biro,www.comisarul.ro,0,0,1,1,0.0,0.0
Tiberiu Claudiu Bârsan,www.comisarul.ro,0,0,1,1,0.0,0.0
deputat,www.comisarul.ro,1,38,21,60,-0.6166666666666667,0.6166666666666667
jandarm,www.comisarul.ro,0,13,1,14,-0.9285714285714286,0.9285714285714286
București,pressone.ro,3,31,105,139,-0.2014388489208633,0.2014388489208633
capitală,pressone.ro,0,1,11,12,-0.08333333333333333,0.08333333333333333
Daniel Băluță,pressone.ro,0,1,3,4,-0.25,0.25
domn,pressone.ro,0,15,12,27,-0.5555555555555556,0.5555555555555556
Elena,pressone.ro,0,2,0,2,-1.0,1.0
Enache,pressone.ro,0,0,1,1,0.0,0.0
George Simion,pressone.ro,0,24,40,64,-0.375,0.375
Liviu Vasilică,pressone.ro,0,1,0,1,-1.0,1.0
Mihai Enache,pressone.ro,0,1,2,3,-0.3333333333333333,0.3333333333333333
Miron Cozma,pressone.ro,0,0,2,2,0.0,0.0
Negoiță,pressone.ro,0,1,0,1,-1.0,1.0
Nicușor Dan,pressone.ro,4,19,21,44,-0.3409090909090909,0.3409090909090909
Robert Negoiță,pressone.ro,0,4,1,5,-0.8,0.8
România,pressone.ro,33,119,188,340,-0.2529411764705882,0.2529411764705882
Rusia,pressone.ro,0,46,9,55,-0.8363636363636363,0.8363636363636363
Răzvan Filip,pressone.ro,0,1,5,6,-0.16666666666666666,0.16666666666666666
Sergiu Mihalcea,pressone.ro,0,0,1,1,0.0,0.0
Ursula von der Leyen,pressone.ro,0,2,2,4,-0.5,0.5
Vlad Țepeș,pressone.ro,0,1,2,3,-0.3333333333333333,0.3333333333333333
alegător,pressone.ro,1,28,18,47,-0.574468085106383,0.574468085106383
birocrat,pressone.ro,0,2,0,2,-1.0,1.0
candidați,pressone.ro,1,14,11,26,-0.5,0.5
colegă,pressone.ro,2,3,1,6,-0.16666666666666666,0.16666666666666666
consilier,pressone.ro,2,45,57,104,-0.41346153846153844,0.41346153846153844
contracandidat,pressone.ro,0,14,3,17,-0.8235294117647058,0.8235294117647058
doamnă,pressone.ro,4,4,21,29,0.0,0.0
domnitor,pressone.ro,1,8,6,15,-0.4666666666666667,0.4666666666666667
escroc,pressone.ro,0,1,0,1,-1.0,1.0
europarlamentar,pressone.ro,0,22,31,53,-0.41509433962264153,0.41509433962264153
mason,pressone.ro,0,1,0,1,-1.0,1.0
membru,pressone.ro,6,76,151,233,-0.30042918454935624,0.30042918454935624
om,pressone.ro,58,144,185,387,-0.2222222222222222,0.2222222222222222
organizator,pressone.ro,2,5,6,13,-0.23076923076923078,0.23076923076923078
politician,pressone.ro,0,184,6,190,-0.968421052631579,0.968421052631579
prieten,pressone.ro,10,3,12,25,0.28,0.28
primar,pressone.ro,1,70,68,139,-0.49640287769784175,0.49640287769784175
ristos,pressone.ro,0,1,0,1,-1.0,1.0
soț,pressone.ro,3,2,23,28,0.03571428571428571,0.03571428571428571
soție,pressone.ro,1,3,42,46,-0.043478260869565216,0.043478260869565216
vârstnic,pressone.ro,0,7,2,9,-0.7777777777777778,0.7777777777777778
Ștefan cel Mare,pressone.ro,0,2,1,3,-0.6666666666666666,0.6666666666666666
Andreea Preda,agerpres.ro,0,0,9,9,0.0,0.0
Gina Ștefan,agerpres.ro,0,0,2,2,0.0,0.0
Harghita,agerpres.ro,0,0,1,1,0.0,0.0
Marius Frățilă,agerpres.ro,0,0,12,12,0.0,0.0
Tánczos,agerpres.ro,0,0,1,1,0.0,0.0
Tánczos Barna,agerpres.ro,0,0,2,2,0.0,0.0
Ponta,adevarul.ro,0,38,14,52,-0.7307692307692307,0.7307692307692307
Serbia,adevarul.ro,0,1,8,9,-0.1111111111111111,0.1111111111111111
Victor Ponta,adevarul.ro,0,45,87,132,-0.3409090909090909,0.3409090909090909
premier,adevarul.ro,4,36,92,132,-0.24242424242424243,0.24242424242424243
candidat,www.cotidianul.ro,7,44,77,128,-0.2890625,0.2890625
Crin Antonescu,www.cotidianul.ro,2,8,24,34,-0.17647058823529413,0.17647058823529413
Lulea,www.comisarul.ro,0,2,3,5,-0.4,0.4
Marius Lulea,www.comisarul.ro,0,1,7,8,-0.125,0.125
Ponta,www.comisarul.ro,0,11,7,18,-0.6111111111111112,0.6111111111111112
Victor Ponta,www.comisarul.ro,0,8,36,44,-0.18181818181818182,0.18181818181818182
oportunist,www.comisarul.ro,0,1,0,1,-1.0,1.0
Adrian Vigheciu,www.aktual24.ro,0,0,1,1,0.0,0.0
Cătălin Teniță,www.aktual24.ro,0,0,1,1,0.0,0.0
consilier,www.aktual24.ro,1,22,29,52,-0.40384615384615385,0.40384615384615385
Cristian Popescu Piedone,www.aktual24.ro,0,4,2,6,-0.6666666666666666,0.6666666666666666
Dan Voiculescu,www.aktual24.ro,0,2,1,3,-0.6666666666666666,0.6666666666666666
Lucian Judele,www.aktual24.ro,0,0,1,1,0.0,0.0
Stelian Bujduveanu,www.aktual24.ro,0,0,1,1,0.0,0.0
candidat,www.aktual24.ro,10,70,163,243,-0.24691358024691357,0.24691358024691357
Ita,www.aktual24.ro,0,1,0,1,-1.0,1.0
viceprimar,www.aktual24.ro,0,3,5,8,-0.375,0.375
Adrian Câciu,www.g4media.ro,0,0,1,1,0.0,0.0
Alina Elena Tănăsescu,www.g4media.ro,0,0,1,1,0.0,0.0
Dolj,www.g4media.ro,0,0,6,6,0.0,0.0
Daniela Barbu,www.g4media.ro,0,0,1,1,0.0,0.0
Lia Olguța Vasilescu,www.g4media.ro,0,0,4,4,0.0,0.0
Marin Marian Viorel,www.g4media.ro,0,0,1,1,0.0,0.0
Mihaela Bărbieru,www.g4media.ro,0,0,1,1,0.0,0.0
Olguța Vasilescu,www.g4media.ro,0,1,2,3,-0.3333333333333333,0.3333333333333333
Radu Marin Traian,www.g4media.ro,0,0,1,1,0.0,0.0
cercetător,www.g4media.ro,1,0,2,3,0.3333333333333333,0.3333333333333333
Alexandra Presură,www.g4media.ro,0,0,1,1,0.0,0.0
prefect,www.g4media.ro,0,1,4,5,-0.2,0.2
profesor universitar,www.g4media.ro,0,0,3,3,0.0,0.0
Becali,a1.ro,0,0,1,1,0.0,0.0
Capitale,a1.ro,1,1,14,16,0.0,0.0
Corneliu Tudor,a1.ro,0,6,1,7,-0.8571428571428571,0.8571428571428571
George Becali,a1.ro,0,0,2,2,0.0,0.0
Gigi Becali,a1.ro,0,1,2,3,-0.3333333333333333,0.3333333333333333
Olanda,a1.ro,0,1,1,2,-0.5,0.5
Pipera,a1.ro,0,1,0,1,-1.0,1.0
ambasador,a1.ro,0,1,5,6,-0.16666666666666666,0.16666666666666666
latifundiar,a1.ro,0,1,0,1,-1.0,1.0
locuitor,a1.ro,0,1,1,2,-0.5,0.5
președinte,a1.ro,1,39,128,168,-0.2261904761904762,0.2261904761904762
primar,a1.ro,0,24,40,64,-0.375,0.375
Cluj,www.mediafax.ro,0,1,1,2,-0.5,0.5
Dâncu,www.mediafax.ro,0,1,0,1,-1.0,1.0
Emil Boc,www.mediafax.ro,0,3,9,12,-0.25,0.25
Iliescu,www.mediafax.ro,0,1,4,5,-0.2,0.2
Ion Iliescu,www.mediafax.ro,0,2,7,9,-0.2222222222222222,0.2222222222222222
Rus,www.mediafax.ro,0,1,0,1,-1.0,1.0
Vasile Dâncu,www.mediafax.ro,0,1,0,1,-1.0,1.0
vicepreședinte,www.mediafax.ro,0,1,23,24,-0.041666666666666664,0.041666666666666664
Peiu,adevarul.ro,0,0,1,1,0.0,0.0
Petrișor Peiu,adevarul.ro,0,0,4,4,0.0,0.0
Petrișor Gabriel Peiu,adevarul.ro,0,0,1,1,0.0,0.0
administrator,adevarul.ro,0,1,3,4,-0.25,0.25
analist,adevarul.ro,1,12,49,62,-0.1774193548387097,0.1774193548387097
asistent,adevarul.ro,1,0,5,6,0.16666666666666666,0.16666666666666666
comentator,adevarul.ro,0,1,1,2,-0.5,0.5
consilier,adevarul.ro,4,19,45,68,-0.22058823529411764,0.22058823529411764
coordonator,adevarul.ro,0,2,7,9,-0.2222222222222222,0.2222222222222222
doctor,adevarul.ro,1,1,7,9,0.0,0.0
inginer,adevarul.ro,2,0,4,6,0.3333333333333333,0.3333333333333333
economist,adevarul.ro,0,0,5,5,0.0,0.0
preparator,adevarul.ro,0,0,1,1,0.0,0.0
Adrian Năstase,adevarul.ro,1,2,9,12,-0.08333333333333333,0.08333333333333333
Radu Vasile,adevarul.ro,0,1,1,2,-0.5,0.5
subsecretar,adevarul.ro,0,0,3,3,0.0,0.0
șef,adevarul.ro,3,55,103,161,-0.32298136645962733,0.32298136645962733
populație,www.g4media.ro,0,3,4,7,-0.42857142857142855,0.42857142857142855
avocat,www.luju.ro,0,7,20,27,-0.25925925925925924,0.25925925925925924
George Simion,www.luju.ro,9,8,18,35,0.02857142857142857,0.02857142857142857
România,www.luju.ro,14,63,68,145,-0.33793103448275863,0.33793103448275863
Rusia,www.luju.ro,0,12,2,14,-0.8571428571428571,0.8571428571428571
influencer,www.luju.ro,0,3,0,3,-1.0,1.0
lider,www.luju.ro,6,26,21,53,-0.37735849056603776,0.37735849056603776
parerolog,www.luju.ro,0,1,0,1,-1.0,1.0
Viorica Stoica,www.luju.ro,0,1,0,1,-1.0,1.0
Alexandru Ivănușcă,agerpres.ro,0,0,1,1,0.0,0.0
Avrămeni,agerpres.ro,0,0,1,1,0.0,0.0
Cosmin Cârnu,agerpres.ro,0,0,1,1,0.0,0.0
Coșula,agerpres.ro,0,0,1,1,0.0,0.0
Cristian Lupașcu,agerpres.ro,0,0,4,4,0.0,0.0
George Telișcă,agerpres.ro,0,0,1,1,0.0,0.0
Irina Giurgiu,agerpres.ro,0,0,31,31,0.0,0.0
Irina Poenaru,agerpres.ro,0,0,27,27,0.0,0.0
Laurențiu Cojocaru,agerpres.ro,0,0,1,1,0.0,0.0
Laurențiu Halaghiuc,agerpres.ro,0,0,1,1,0.0,0.0
Mihai Gabriel Chelariu,agerpres.ro,0,0,1,1,0.0,0.0
Neculai Șchiopu,agerpres.ro,0,1,0,1,-1.0,1.0
Nicolae Bucatariu,agerpres.ro,0,1,0,1,-1.0,1.0
primar,agerpres.ro,1,8,30,39,-0.1794871794871795,0.1794871794871795
Ispas,adevarul.ro,0,0,1,1,0.0,0.0
Paul Ispas,adevarul.ro,0,0,5,5,0.0,0.0
Polonia,adevarul.ro,2,0,6,8,0.25,0.25
Turcia,adevarul.ro,1,1,5,7,0.0,0.0
militar,adevarul.ro,2,1,8,11,0.09090909090909091,0.09090909090909091
Adrian Zăbavă,www.euronews.ro,0,0,1,1,0.0,0.0
Alina Manolache,www.euronews.ro,0,0,1,1,0.0,0.0
Bulgaria,www.euronews.ro,0,2,5,7,-0.2857142857142857,0.2857142857142857
Crin Antonescu,www.euronews.ro,1,12,50,63,-0.1746031746031746,0.1746031746031746
Călin Popescu-Tăriceanu,www.euronews.ro,0,0,1,1,0.0,0.0
Cătălin Drulă,www.euronews.ro,0,1,4,5,-0.2,0.2
Elena Lasconi,www.euronews.ro,0,4,40,44,-0.09090909090909091,0.09090909090909091
România,www.euronews.ro,27,30,165,222,-0.013513513513513514,0.013513513513513514
Szabo Odon,www.euronews.ro,0,1,0,1,-1.0,1.0
candidat,www.euronews.ro,7,47,184,238,-0.16806722689075632,0.16806722689075632
deputat,www.euronews.ro,2,15,32,49,-0.2653061224489796,0.2653061224489796
om,www.euronews.ro,11,22,31,64,-0.171875,0.171875
parlamentar,www.euronews.ro,0,22,16,38,-0.5789473684210527,0.5789473684210527
politolog,www.euronews.ro,0,2,3,5,-0.4,0.4
senator,www.euronews.ro,0,5,25,30,-0.16666666666666666,0.16666666666666666
E,www.digi24.ro,0,1,0,1,-1.0,1.0
George Simion,www.digi24.ro,0,6,20,26,-0.23076923076923078,0.23076923076923078
Simonis,www.digi24.ro,0,1,2,3,-0.3333333333333333,0.3333333333333333
apropiat,www.digi24.ro,0,4,3,7,-0.5714285714285714,0.5714285714285714
atacator,www.digi24.ro,0,1,0,1,-1.0,1.0
jandarm,www.digi24.ro,0,3,0,3,-1.0,1.0
membru,www.digi24.ro,3,8,39,50,-0.1,0.1
organizator,www.digi24.ro,0,1,2,3,-0.3333333333333333,0.3333333333333333
participant,www.digi24.ro,0,1,1,2,-0.5,0.5
simpatizant,www.digi24.ro,0,4,0,4,-1.0,1.0
tânăr,www.digi24.ro,4,4,6,14,0.0,0.0
șefă,www.digi24.ro,0,2,3,5,-0.4,0.4
suspect,www.digi24.ro,0,2,0,2,-1.0,1.0
Cosmin Prelipceanu,www.digi24.ro,0,0,5,5,0.0,0.0
Cristian Diaconescu,www.digi24.ro,0,0,12,12,0.0,0.0
Daniel David,www.digi24.ro,0,0,6,6,0.0,0.0
Kelemen Hunor,www.digi24.ro,0,0,15,15,0.0,0.0
Liliana Ruse,www.digi24.ro,0,0,3,3,0.0,0.0
Mircea Geoană,www.digi24.ro,1,3,16,20,-0.1,0.1
Victor Ponta,www.digi24.ro,0,24,27,51,-0.47058823529411764,0.47058823529411764
cetățean,www.digi24.ro,21,8,24,53,0.24528301886792453,0.24528301886792453
jurnalist,www.digi24.ro,0,6,18,24,-0.25,0.25
profesor,www.digi24.ro,6,3,7,16,0.1875,0.1875
student,www.digi24.ro,0,0,5,5,0.0,0.0
acționar,snoop.ro,0,5,10,15,-0.3333333333333333,0.3333333333333333
Adrian Năstase,snoop.ro,0,1,3,4,-0.25,0.25
Alexandr Dugin,snoop.ro,0,1,0,1,-1.0,1.0
Alexandra Măceșanu,snoop.ro,0,0,1,1,0.0,0.0
ambasador,snoop.ro,0,0,6,6,0.0,0.0
Andrei Gheorghe Pădureț,snoop.ro,0,0,1,1,0.0,0.0
Anglia,snoop.ro,0,0,4,4,0.0,0.0
Atudorei,snoop.ro,0,1,0,1,-1.0,1.0
Boris Golovin,snoop.ro,0,1,0,1,-1.0,1.0
Bruno Mihăilescu,snoop.ro,0,1,2,3,-0.3333333333333333,0.3333333333333333
Bucha,snoop.ro,0,1,0,1,-1.0,1.0
Bulgacov,snoop.ro,0,1,0,1,-1.0,1.0
Bunelu,snoop.ro,0,2,0,2,-1.0,1.0
Calistrat Mugurel Atudorei,snoop.ro,0,0,1,1,0.0,0.0
candidat,snoop.ro,1,27,61,89,-0.29213483146067415,0.29213483146067415
Caracal,snoop.ro,0,2,0,2,-1.0,1.0
Chișinău,snoop.ro,0,2,2,4,-0.5,0.5
Colceag,snoop.ro,0,1,0,1,-1.0,1.0
coleg,snoop.ro,1,8,23,32,-0.21875,0.21875
Craiova,snoop.ro,0,0,5,5,0.0,0.0
Croația,snoop.ro,0,1,1,2,-0.5,0.5
Călin Georgescu,snoop.ro,1,14,20,35,-0.37142857142857144,0.37142857142857144
Deveselu,snoop.ro,0,1,1,2,-0.5,0.5
Diana Iovanovici,snoop.ro,0,1,0,1,-1.0,1.0
Diana Șoșoacă,snoop.ro,0,2,2,4,-0.5,0.5
Doru Vlaicu,snoop.ro,0,1,0,1,-1.0,1.0
Stephanie Alice Baker,snoop.ro,0,1,0,1,-1.0,1.0
Ecuador,snoop.ro,0,0,1,1,0.0,0.0
Elie Wiesel,snoop.ro,0,0,2,2,0.0,0.0
Federația Rusă,snoop.ro,0,1,3,4,-0.25,0.25
Georgescu,snoop.ro,0,10,6,16,-0.625,0.625
Grecia,snoop.ro,0,1,4,5,-0.2,0.2
Igor Beidek,snoop.ro,0,0,1,1,0.0,0.0
Ileana Romanița Popescu,snoop.ro,0,0,1,1,0.0,0.0
Ion Bulgacov,snoop.ro,0,2,0,2,-1.0,1.0
Ion Talpeș,snoop.ro,0,0,1,1,0.0,0.0
jurnalist,snoop.ro,2,12,47,61,-0.16393442622950818,0.16393442622950818
Kuzmin,snoop.ro,0,0,2,2,0.0,0.0
Luis Lazarus,snoop.ro,0,2,0,2,-1.0,1.0
Marea Britanie,snoop.ro,0,2,9,11,-0.18181818181818182,0.18181818181818182
Marius Tucă,snoop.ro,0,0,1,1,0.0,0.0
Marvin Atudorei,snoop.ro,0,1,1,2,-0.5,0.5
Mihai Rotariu,snoop.ro,0,1,3,4,-0.25,0.25
Mihăilescu,snoop.ro,0,2,1,3,-0.6666666666666666,0.6666666666666666
Moldova,snoop.ro,0,0,4,4,0.0,0.0
Moscova,snoop.ro,0,3,3,6,-0.5,0.5
Mugurel Atudorei,snoop.ro,0,1,2,3,-0.3333333333333333,0.3333333333333333
Natalia Niță,snoop.ro,0,1,0,1,-1.0,1.0
Niță,snoop.ro,0,1,0,1,-1.0,1.0
Partenera,snoop.ro,0,2,1,3,-0.6666666666666666,0.6666666666666666
Popescu,snoop.ro,0,0,3,3,0.0,0.0
Vladimir Putin,snoop.ro,0,6,1,7,-0.8571428571428571,0.8571428571428571
Putinvizi,snoop.ro,0,0,1,1,0.0,0.0
Remus Rădoi,snoop.ro,0,1,0,1,-1.0,1.0
reprezentant,snoop.ro,0,20,25,45,-0.4444444444444444,0.4444444444444444
Republica Moldova,snoop.ro,0,3,7,10,-0.3,0.3
Romanița Popescu,snoop.ro,0,0,1,1,0.0,0.0
Rotariu,snoop.ro,0,1,1,2,-0.5,0.5
Rusia,snoop.ro,0,9,2,11,-0.8181818181818182,0.8181818181818182
Rybchenko,snoop.ro,0,1,0,1,-1.0,1.0
Râmnicu Sărat,snoop.ro,0,1,0,1,-1.0,1.0
Rădoi,snoop.ro,0,1,0,1,-1.0,1.0
SUA,snoop.ro,0,4,8,12,-0.3333333333333333,0.3333333333333333
Sac,snoop.ro,0,1,0,1,-1.0,1.0
Sacha Stone,snoop.ro,0,1,0,1,-1.0,1.0
Snoop,snoop.ro,2,2,63,67,0.0,0.0
soție,snoop.ro,1,3,31,35,-0.05714285714285714,0.05714285714285714
Stone,snoop.ro,0,1,0,1,-1.0,1.0
tra,snoop.ro,0,1,0,1,-1.0,1.0
Donald Trump,snoop.ro,0,5,0,5,-1.0,1.0
Târgoviște,snoop.ro,0,0,1,1,0.0,0.0
Ucraina,snoop.ro,0,3,8,11,-0.2727272727272727,0.2727272727272727
Valeri Kuzmin,snoop.ro,0,0,2,2,0.0,0.0
actor,snoop.ro,0,3,4,7,-0.42857142857142855,0.42857142857142855
angajat,snoop.ro,1,9,43,53,-0.1509433962264151,0.1509433962264151
antisemit,snoop.ro,0,1,0,1,-1.0,1.0
anturaj,snoop.ro,0,1,0,1,-1.0,1.0
bancher,snoop.ro,0,1,0,1,-1.0,1.0
blogger,snoop.ro,0,2,1,3,-0.6666666666666666,0.6666666666666666
cadru medical,snoop.ro,0,1,2,3,-0.3333333333333333,0.3333333333333333
colaborator,snoop.ro,1,1,1,3,0.0,0.0
colegiu,snoop.ro,0,2,0,2,-1.0,1.0
conspiraționist,snoop.ro,0,2,0,2,-1.0,1.0
copil,snoop.ro,9,9,26,44,0.0,0.0
creator,snoop.ro,2,0,0,2,1.0,1.0
deputat,snoop.ro,0,10,9,19,-0.5263157894736842,0.5263157894736842
dictator,snoop.ro,0,1,0,1,-1.0,1.0
diplomat,snoop.ro,0,0,4,4,0.0,0.0
director executiv,snoop.ro,0,0,3,3,0.0,0.0
doctor,snoop.ro,2,2,7,11,0.0,0.0
encer,snoop.ro,0,1,0,1,-1.0,1.0
escroc,snoop.ro,0,1,0,1,-1.0,1.0
europarlamentar,snoop.ro,0,4,10,14,-0.2857142857142857,0.2857142857142857
Pantazescu,snoop.ro,0,1,0,1,-1.0,1.0
ființă umană,snoop.ro,1,0,0,1,1.0,1.0
fiu,snoop.ro,0,7,15,22,-0.3181818181818182,0.3181818181818182
fondator,snoop.ro,0,1,9,10,-0.1,0.1
formator,snoop.ro,0,2,0,2,-1.0,1.0
fostă,snoop.ro,0,1,0,1,-1.0,1.0
frate,snoop.ro,0,5,6,11,-0.45454545454545453,0.45454545454545453
ideolog,snoop.ro,0,1,0,1,-1.0,1.0
ie,snoop.ro,0,0,1,1,0.0,0.0
influencer,snoop.ro,1,13,3,17,-0.7058823529411765,0.7058823529411765
iubitor,snoop.ro,1,0,0,1,1.0,1.0
lider,snoop.ro,0,19,36,55,-0.34545454545454546,0.34545454545454546
martor,snoop.ro,0,0,2,2,0.0,0.0
Florian Colceag,snoop.ro,0,1,0,1,-1.0,1.0
moderator,snoop.ro,0,3,4,7,-0.42857142857142855,0.42857142857142855
ofițer,snoop.ro,0,3,5,8,-0.375,0.375
partener,snoop.ro,0,5,15,20,-0.25,0.25
personaj,snoop.ro,0,2,11,13,-0.15384615384615385,0.15384615384615385
politician,snoop.ro,0,29,2,31,-0.9354838709677419,0.9354838709677419
polițist,snoop.ro,0,9,14,23,-0.391304347826087,0.391304347826087
premier,snoop.ro,0,3,9,12,-0.25,0.25
președinte,snoop.ro,1,11,58,70,-0.14285714285714285,0.14285714285714285
prieteni,snoop.ro,1,1,4,6,0.0,0.0
proprietar,snoop.ro,0,8,8,16,-0.5,0.5
raționalist,snoop.ro,0,1,0,1,-1.0,1.0
securist,snoop.ro,0,2,0,2,-1.0,1.0
susținător,snoop.ro,1,12,3,16,-0.6875,0.6875
urmăritor,snoop.ro,0,4,0,4,-1.0,1.0
wo,snoop.ro,0,0,1,1,0.0,0.0
Șoșoacă,snoop.ro,0,2,0,2,-1.0,1.0
șef,snoop.ro,0,16,31,47,-0.3404255319148936,0.3404255319148936
avocat,www.euronews.ro,0,1,6,7,-0.14285714285714285,0.14285714285714285
Constanța,www.euronews.ro,0,1,7,8,-0.125,0.125
Costinești,www.euronews.ro,0,0,1,1,0.0,0.0
organizator,www.euronews.ro,0,4,1,5,-0.8,0.8
artist,www.euronews.ro,0,0,3,3,0.0,0.0
elev,www.euronews.ro,0,6,5,11,-0.5454545454545454,0.5454545454545454
operator,www.euronews.ro,0,1,0,1,-1.0,1.0
pacient,www.euronews.ro,1,1,2,4,0.0,0.0
turișt,www.euronews.ro,0,1,0,1,-1.0,1.0
Alfred Simonis,agerpres.ro,0,0,2,2,0.0,0.0
Antonescu,agerpres.ro,0,2,8,10,-0.2,0.2
Buzău,agerpres.ro,0,0,3,3,0.0,0.0
Constantin Toma,agerpres.ro,0,3,2,5,-0.6,0.6
Florin Zafiu,agerpres.ro,0,0,6,6,0.0,0.0
Karina Olteanu,agerpres.ro,0,0,25,25,0.0,0.0
Marcel,agerpres.ro,0,1,0,1,-1.0,1.0
Marcel Ciolacu,agerpres.ro,1,17,34,52,-0.3076923076923077,0.3076923076923077
Ponta,agerpres.ro,0,4,5,9,-0.4444444444444444,0.4444444444444444
Simona Aruștei,agerpres.ro,0,0,16,16,0.0,0.0
Victor Ponta,agerpres.ro,0,6,15,21,-0.2857142857142857,0.2857142857142857
Paul Stănescu,agerpres.ro,0,0,3,3,0.0,0.0
independent,agerpres.ro,0,0,3,3,0.0,0.0
lume,agerpres.ro,0,1,3,4,-0.25,0.25
prieten,agerpres.ro,1,1,1,3,0.0,0.0
șef,agerpres.ro,1,8,13,22,-0.3181818181818182,0.3181818181818182
Klaus Iohannis,www.realitatea.net,0,13,12,25,-0.52,0.52
Marcel Ciolacu,www.realitatea.net,0,8,14,22,-0.36363636363636365,0.36363636363636365
șef,www.realitatea.net,0,9,6,15,-0.6,0.6
tot,www.realitatea.net,0,1,0,1,-1.0,1.0
Franța,www.comisarul.ro,0,2,20,22,-0.09090909090909091,0.09090909090909091
Gabriel Landsberg,www.comisarul.ro,0,0,1,1,0.0,0.0
Adolf Hitler,www.comisarul.ro,0,1,2,3,-0.3333333333333333,0.3333333333333333
Imperiul Rus,www.comisarul.ro,0,1,0,1,-1.0,1.0
Landsbergis,www.comisarul.ro,0,1,0,1,-1.0,1.0
Lituania,www.comisarul.ro,0,0,1,1,0.0,0.0
Lituaniei,www.comisarul.ro,0,0,1,1,0.0,0.0
Polonia,www.comisarul.ro,0,1,16,17,-0.058823529411764705,0.058823529411764705
Vladimir Putin,www.comisarul.ro,0,15,2,17,-0.8823529411764706,0.8823529411764706
Riad,www.comisarul.ro,0,0,1,1,0.0,0.0
Rusia,www.comisarul.ro,0,26,8,34,-0.7647058823529411,0.7647058823529411
Ucraina,www.comisarul.ro,2,6,25,33,-0.12121212121212122,0.12121212121212122
ministru,www.comisarul.ro,3,27,26,56,-0.42857142857142855,0.42857142857142855
om,www.comisarul.ro,23,27,48,98,-0.04081632653061224,0.04081632653061224
oficial,www.comisarul.ro,0,6,5,11,-0.5454545454545454,0.5454545454545454
reprezentant,www.comisarul.ro,0,17,15,32,-0.53125,0.53125
Antonescu,www.aktual24.ro,0,7,20,27,-0.25925925925925924,0.25925925925925924
Crin Antonescu,www.aktual24.ro,2,16,39,57,-0.24561403508771928,0.24561403508771928
Nicușor Dan,www.aktual24.ro,16,17,51,84,-0.011904761904761904,0.011904761904761904
Lucian Romașcanu,primanews.ro,0,0,8,8,0.0,0.0
purtător de cuvânt,primanews.ro,0,2,24,26,-0.07692307692307693,0.07692307692307693
Romașcanu,primanews.ro,0,0,6,6,0.0,0.0
senator,primanews.ro,0,4,13,17,-0.23529411764705882,0.23529411764705882
Klaus Iohannis,primanews.ro,0,11,29,40,-0.275,0.275
Călin Georgescu,a1.ro,1,7,33,41,-0.14634146341463414,0.14634146341463414
George Simion,a1.ro,0,0,19,19,0.0,0.0
Georgescu,a1.ro,0,1,1,2,-0.5,0.5
Ilie Bolojan,a1.ro,0,1,18,19,-0.05263157894736842,0.05263157894736842
Nicușor Dan,a1.ro,0,0,28,28,0.0,0.0
România,a1.ro,4,21,82,107,-0.1588785046728972,0.1588785046728972
politician,a1.ro,0,25,3,28,-0.8928571428571429,0.8928571428571429
Author Zelenski,www.cotidianul.ro,0,0,3,3,0.0,0.0
Terheș,www.cotidianul.ro,0,1,2,3,-0.3333333333333333,0.3333333333333333
coleg,www.cotidianul.ro,5,8,4,17,-0.17647058823529413,0.17647058823529413
contracandidat,www.cotidianul.ro,0,3,1,4,-0.75,0.75
om,www.cotidianul.ro,14,43,29,86,-0.3372093023255814,0.3372093023255814
Dana Piciu,agerpres.ro,0,0,18,18,0.0,0.0
Niculina Stelea,agerpres.ro,0,0,1,1,0.0,0.0
Petrișor Peiu,agerpres.ro,0,2,9,11,-0.18181818181818182,0.18181818181818182
acționar,agerpres.ro,0,0,1,1,0.0,0.0
administrator,agerpres.ro,0,1,2,3,-0.3333333333333333,0.3333333333333333
membru,agerpres.ro,5,7,27,39,-0.05128205128205128,0.05128205128205128
senator,agerpres.ro,2,12,51,65,-0.15384615384615385,0.15384615384615385
Codrin Ștefănescu,www.digi24.ro,0,0,2,2,0.0,0.0
Dumnezeu,www.digi24.ro,2,1,4,7,0.14285714285714285,0.14285714285714285
femeie,www.digi24.ro,7,3,9,19,0.21052631578947367,0.21052631578947367
Anamaria Prodan,www.digi24.ro,0,0,1,1,0.0,0.0
Laurențiu Reghecampf,www.digi24.ro,0,0,1,1,0.0,0.0
a,www.digi24.ro,0,0,1,1,0.0,0.0
bărbat,www.digi24.ro,0,5,5,10,-0.5,0.5
partener,www.digi24.ro,2,8,6,16,-0.375,0.375
soț,www.digi24.ro,0,2,2,4,-0.5,0.5
Belgrad,stirileprotv.ro,0,1,7,8,-0.125,0.125
Dragnea,stirileprotv.ro,0,7,6,13,-0.5384615384615384,0.5384615384615384
Liviu Dragnea,stirileprotv.ro,0,15,10,25,-0.6,0.6
Ponta,stirileprotv.ro,0,20,9,29,-0.6896551724137931,0.6896551724137931
Porțile de Fier,stirileprotv.ro,0,0,1,1,0.0,0.0
Victor Ponta,stirileprotv.ro,1,19,39,59,-0.3050847457627119,0.3050847457627119
reprezentant,stirileprotv.ro,1,7,27,35,-0.17142857142857143,0.17142857142857143
Laura Vicol,www.gandul.ro,0,0,1,1,0.0,0.0
Laurei Vicol,www.gandul.ro,0,0,1,1,0.0,0.0
Marcel Ciolacu,www.gandul.ro,11,11,116,138,0.0,0.0
Răzvan Ciorbă,www.gandul.ro,0,0,1,1,0.0,0.0
Vladimir Ciorbă,www.gandul.ro,0,0,1,1,0.0,0.0
acționar,www.gandul.ro,0,0,1,1,0.0,0.0
jurnalist,www.gandul.ro,0,9,22,31,-0.2903225806451613,0.2903225806451613
soție,www.gandul.ro,1,0,9,10,0.1,0.1
soț,www.gandul.ro,0,2,1,3,-0.6666666666666666,0.6666666666666666
Ana Birchall,adevarul.ro,0,0,7,7,0.0,0.0
Cristian Diaconescu,adevarul.ro,1,2,16,19,-0.05263157894736842,0.05263157894736842
Dan Geoană,adevarul.ro,0,1,1,2,-0.5,0.5
George,adevarul.ro,0,2,1,3,-0.6666666666666666,0.6666666666666666
Hunor Kelemen,adevarul.ro,0,0,4,4,0.0,0.0
Ionel Ciucă,adevarul.ro,0,1,1,2,-0.5,0.5
Ludovic Orban,adevarul.ro,1,7,21,29,-0.20689655172413793,0.20689655172413793
Mircea,adevarul.ro,0,0,2,2,0.0,0.0
Marcel Ciolacu,adevarul.ro,7,50,138,195,-0.2205128205128205,0.2205128205128205
Nicolae,adevarul.ro,0,0,2,2,0.0,0.0
Nicolae Simion,adevarul.ro,0,0,1,1,0.0,0.0
Olt,adevarul.ro,0,0,6,6,0.0,0.0
prefect,adevarul.ro,0,0,8,8,0.0,0.0
Silviu Predoiu,adevarul.ro,0,1,15,16,-0.0625,0.0625
alegător,adevarul.ro,2,34,49,85,-0.3764705882352941,0.3764705882352941
jandarm,adevarul.ro,0,9,3,12,-0.75,0.75
Daniel Argeșeanu,adevarul.ro,0,0,1,1,0.0,0.0
jurnalist,adevarul.ro,4,20,43,67,-0.23880597014925373,0.23880597014925373
personal,adevarul.ro,0,4,11,15,-0.26666666666666666,0.26666666666666666
purtător de cuvânt,adevarul.ro,0,1,14,15,-0.06666666666666667,0.06666666666666667
Ștefan Nicolae,adevarul.ro,0,0,1,1,0.0,0.0
Anamaria Gavrilă,recorder.ro,0,4,22,26,-0.15384615384615385,0.15384615384615385
Ciolacu,recorder.ro,0,13,20,33,-0.3939393939393939,0.3939393939393939
Elena Calistru,recorder.ro,0,0,18,18,0.0,0.0
Mihai Radu,recorder.ro,0,16,0,16,-1.0,1.0
Răzvan Petri,recorder.ro,1,0,17,18,0.05555555555555555,0.05555555555555555
Simion,recorder.ro,0,28,4,32,-0.875,0.875
Traian Băsescu,recorder.ro,0,9,20,29,-0.3103448275862069,0.3103448275862069
Vlad Adamescu,recorder.ro,0,0,18,18,0.0,0.0
tânăr,recorder.ro,26,12,46,84,0.16666666666666666,0.16666666666666666
Crin Antonescu,a1.ro,0,4,30,34,-0.11764705882352941,0.11764705882352941
Emil Boc,a1.ro,1,9,22,32,-0.25,0.25
Sorin Frunzaverde,a1.ro,0,2,0,2,-1.0,1.0
vicepreședinte,a1.ro,0,3,18,21,-0.14285714285714285,0.14285714285714285
Dan Barna,stirileprotv.ro,0,1,9,10,-0.1,0.1
candidat,stirileprotv.ro,3,21,76,100,-0.18,0.18
parlamentar,stirileprotv.ro,0,31,14,45,-0.6888888888888889,0.6888888888888889
Borbely Laszlo,www.mediafax.ro,0,0,3,3,0.0,0.0
Kelemen,www.mediafax.ro,0,0,4,4,0.0,0.0
Kelemen Hunor,www.mediafax.ro,0,0,7,7,0.0,0.0
Laszlo Borbely,www.mediafax.ro,0,0,2,2,0.0,0.0
deputat,www.mediafax.ro,1,22,20,43,-0.4883720930232558,0.4883720930232558
partener,www.mediafax.ro,3,1,3,7,0.2857142857142857,0.2857142857142857
Carmen Cristiana Flutur,a1.ro,0,0,1,1,0.0,0.0
Domnia Sa,a1.ro,0,1,1,2,-0.5,0.5
fiică,a1.ro,0,2,20,22,-0.09090909090909091,0.09090909090909091
Flutur,a1.ro,0,2,0,2,-1.0,1.0
Gheorghe Flutur,a1.ro,0,1,2,3,-0.3333333333333333,0.3333333333333333
Lucian Banu,a1.ro,0,0,1,1,0.0,0.0
Mihai Banu,a1.ro,0,0,1,1,0.0,0.0
Sorin Iorguș,a1.ro,0,0,1,1,0.0,0.0
eroină,a1.ro,1,0,0,1,1.0,1.0
Zamfir Iorguș,a1.ro,0,0,1,1,0.0,0.0
angajat,a1.ro,0,2,7,9,-0.2222222222222222,0.2222222222222222
consilier,a1.ro,0,6,25,31,-0.1935483870967742,0.1935483870967742
consilieră,a1.ro,0,2,0,2,-1.0,1.0
deputat,a1.ro,0,18,17,35,-0.5142857142857142,0.5142857142857142
fetită,a1.ro,0,1,0,1,-1.0,1.0
fiu,a1.ro,2,6,29,37,-0.10810810810810811,0.10810810810810811
funcționar,a1.ro,0,3,1,4,-0.75,0.75
manager,a1.ro,0,4,1,5,-0.8,0.8
ministru,a1.ro,0,25,30,55,-0.45454545454545453,0.45454545454545453
Bacalbașa,pressone.ro,0,1,2,3,-0.3333333333333333,0.3333333333333333
Călin Popescu Tăriceanu,pressone.ro,0,1,3,4,-0.25,0.25
Varujan Vosganian,pressone.ro,0,2,1,3,-0.6666666666666666,0.6666666666666666
Familia Regală,pressone.ro,0,0,1,1,0.0,0.0
Liviu Dragnea,pressone.ro,0,27,22,49,-0.5510204081632653,0.5510204081632653
Nicolae Bacalbașa,pressone.ro,0,0,3,3,0.0,0.0
Octav Ganea,pressone.ro,0,3,14,17,-0.17647058823529413,0.17647058823529413
Radu,pressone.ro,0,0,2,2,0.0,0.0
Margareta,pressone.ro,0,0,1,1,0.0,0.0
Mihai,pressone.ro,0,0,3,3,0.0,0.0
Sorin Bota,pressone.ro,0,2,3,5,-0.4,0.4
Sorin Chelmu,pressone.ro,0,0,1,1,0.0,0.0
Vasile Dîncu,pressone.ro,0,5,5,10,-0.5,0.5
deputat,pressone.ro,1,107,92,200,-0.53,0.53
inițiator,pressone.ro,0,18,19,37,-0.4864864864864865,0.4864864864864865
parlamentar,pressone.ro,0,122,34,156,-0.782051282051282,0.782051282051282
secretar general,pressone.ro,0,1,11,12,-0.08333333333333333,0.08333333333333333
semnatar,pressone.ro,1,5,12,18,-0.2222222222222222,0.2222222222222222
urmaș,pressone.ro,0,6,3,9,-0.6666666666666666,0.6666666666666666
vicepremier,pressone.ro,0,1,6,7,-0.14285714285714285,0.14285714285714285
Mihai Constantin,stirileprotv.ro,0,0,1,1,0.0,0.0
Mihai Dodu,stirileprotv.ro,0,0,1,1,0.0,0.0
prim-ministru,stirileprotv.ro,1,2,13,16,-0.0625,0.0625
luptător,stirileprotv.ro,3,0,2,5,0.6,0.6
purtător de cuvânt,stirileprotv.ro,0,2,8,10,-0.2,0.2
revoluționar,stirileprotv.ro,0,0,2,2,0.0,0.0
secretar,stirileprotv.ro,0,1,9,10,-0.1,0.1
Eduard Hellvig,www.digi24.ro,0,0,1,1,0.0,0.0
Ilie Bolojan,www.digi24.ro,1,1,39,41,0.0,0.0
adversar,www.digi24.ro,0,1,0,1,-1.0,1.0
alii,www.digi24.ro,0,0,1,1,0.0,0.0
aventurier,www.digi24.ro,0,1,0,1,-1.0,1.0
director,www.digi24.ro,0,1,4,5,-0.2,0.2
mamașă,www.digi24.ro,0,1,0,1,-1.0,1.0
om,www.digi24.ro,25,47,32,104,-0.21153846153846154,0.21153846153846154
Assen,www.activenews.ro,0,0,2,2,0.0,0.0
Ernest Oberlander,www.activenews.ro,0,0,1,1,0.0,0.0
Narcisa Iorga,www.activenews.ro,0,0,1,1,0.0,0.0
Narcisei Iorga,www.activenews.ro,0,0,1,1,0.0,0.0
Olanda,www.activenews.ro,0,0,3,3,0.0,0.0
Raluca Turcan,www.activenews.ro,0,6,2,8,-0.75,0.75
Ralucăi Turcan,www.activenews.ro,0,1,1,2,-0.5,0.5
trădător,www.activenews.ro,0,2,0,2,-1.0,1.0
comentatoare,www.activenews.ro,0,1,0,1,-1.0,1.0
ministru,www.activenews.ro,0,32,8,40,-0.8,0.8
observatoare,www.activenews.ro,0,1,0,1,-1.0,1.0
președinte,www.activenews.ro,0,48,38,86,-0.5581395348837209,0.5581395348837209
responsabil,www.activenews.ro,0,2,1,3,-0.6666666666666666,0.6666666666666666
Dan Cașcaval,www.cotidianul.ro,0,0,2,2,0.0,0.0
Rector,www.cotidianul.ro,0,1,1,2,-0.5,0.5
dascăl,www.cotidianul.ro,1,0,0,1,1.0,1.0
student,www.cotidianul.ro,1,3,2,6,-0.3333333333333333,0.3333333333333333
Cristian Pîrvulescu,www.news.ro,0,1,6,7,-0.14285714285714285,0.14285714285714285
politolog,www.news.ro,0,0,1,1,0.0,0.0
Pîrvulescu,www.news.ro,0,1,4,5,-0.2,0.2
România,www.news.ro,37,32,179,248,0.020161290322580645,0.020161290322580645
Rusia,www.news.ro,0,15,3,18,-0.8333333333333334,0.8333333333333334
Ucraina,www.news.ro,4,1,19,24,0.125,0.125
analist,www.news.ro,0,2,6,8,-0.25,0.25
analist politic,www.news.ro,0,0,3,3,0.0,0.0
președinte,www.news.ro,11,59,224,294,-0.16326530612244897,0.16326530612244897
Cristian Pârvulescu,www.news.ro,0,0,1,1,0.0,0.0
Adam Marian Doru,www.activenews.ro,0,0,1,1,0.0,0.0
anchetator,www.activenews.ro,0,3,0,3,-1.0,1.0
București,www.activenews.ro,0,9,19,28,-0.32142857142857145,0.32142857142857145
Capitale,www.activenews.ro,0,0,2,2,0.0,0.0
Chițac,www.activenews.ro,0,1,0,1,-1.0,1.0
Cozma Miron,www.activenews.ro,0,1,0,1,-1.0,1.0
Damian Constantin,www.activenews.ro,0,0,1,1,0.0,0.0
Diamandescu,www.activenews.ro,0,4,0,4,-1.0,1.0
Emil Hurezeanu,www.activenews.ro,0,1,1,2,-0.5,0.5
Ion Iliescu,www.activenews.ro,0,5,0,5,-1.0,1.0
Ionel Olteanu,www.activenews.ro,0,0,1,1,0.0,0.0
Constantinescu Adrian Radu,www.activenews.ro,0,0,1,1,0.0,0.0
miner,www.activenews.ro,0,2,0,2,-1.0,1.0
Virgil Măgureanu,www.activenews.ro,0,2,0,2,-1.0,1.0
Neculai Constantin Muntenu,www.activenews.ro,0,1,0,1,-1.0,1.0
ofițer,www.activenews.ro,2,3,1,6,-0.16666666666666666,0.16666666666666666
persoană,www.activenews.ro,1,12,25,38,-0.2894736842105263,0.2894736842105263
Daniela Dediu,www.activenews.ro,0,1,0,1,-1.0,1.0
procuror,www.activenews.ro,1,7,1,9,-0.6666666666666666,0.6666666666666666
Roman Petre,www.activenews.ro,0,1,0,1,-1.0,1.0
România,www.activenews.ro,15,52,39,106,-0.3490566037735849,0.3490566037735849
Sârbu Adrian,www.activenews.ro,0,2,0,2,-1.0,1.0
Adrian Sârbu,www.activenews.ro,0,1,0,1,-1.0,1.0
Tănasă Nicolae,www.activenews.ro,0,0,1,1,0.0,0.0
activist,www.activenews.ro,0,5,2,7,-0.7142857142857143,0.7142857142857143
adjunct,www.activenews.ro,0,1,1,2,-0.5,0.5
ajutoare,www.activenews.ro,0,0,1,1,0.0,0.0
bărbat,www.activenews.ro,1,4,4,9,-0.3333333333333333,0.3333333333333333
bătrân,www.activenews.ro,0,1,2,3,-0.3333333333333333,0.3333333333333333
cadru,www.activenews.ro,0,3,0,3,-1.0,1.0
cetățean,www.activenews.ro,4,9,10,23,-0.21739130434782608,0.21739130434782608
civil,www.activenews.ro,0,3,0,3,-1.0,1.0
coleg,www.activenews.ro,0,6,6,12,-0.5,0.5
comandant,www.activenews.ro,0,1,1,2,-0.5,0.5
conducător,www.activenews.ro,0,3,0,3,-1.0,1.0
consilier,www.activenews.ro,0,8,2,10,-0.8,0.8
director,www.activenews.ro,0,17,8,25,-0.68,0.68
factor,www.activenews.ro,0,1,0,1,-1.0,1.0
femeie,www.activenews.ro,3,4,9,16,-0.0625,0.0625
generalul Chițac,www.activenews.ro,0,1,0,1,-1.0,1.0
general,www.activenews.ro,0,9,0,9,-1.0,1.0
Corneliu Diamandescu,www.activenews.ro,0,1,0,1,-1.0,1.0
Mihai Chițac,www.activenews.ro,0,1,0,1,-1.0,1.0
incendiator,www.activenews.ro,0,1,0,1,-1.0,1.0
inculpat,www.activenews.ro,0,3,0,3,-1.0,1.0
individ,www.activenews.ro,0,2,0,2,-1.0,1.0
infractor,www.activenews.ro,0,2,0,2,-1.0,1.0
intelectual,www.activenews.ro,0,2,0,2,-1.0,1.0
jurnalist,www.activenews.ro,3,11,6,20,-0.4,0.4
lider,www.activenews.ro,4,33,21,58,-0.5,0.5
locuitor,www.activenews.ro,1,1,1,3,0.0,0.0
manifestant,www.activenews.ro,0,5,1,6,-0.8333333333333334,0.8333333333333334
manifestanț,www.activenews.ro,0,3,0,3,-1.0,1.0
martor,www.activenews.ro,0,0,1,1,0.0,0.0
mort,www.activenews.ro,0,4,1,5,-0.8,0.8
militar,www.activenews.ro,0,0,2,2,0.0,0.0
minier,www.activenews.ro,0,1,0,1,-1.0,1.0
minor,www.activenews.ro,0,1,2,3,-0.3333333333333333,0.3333333333333333
muncitor,www.activenews.ro,0,2,1,3,-0.6666666666666666,0.6666666666666666
om,www.activenews.ro,12,31,21,64,-0.296875,0.296875
opozant,www.activenews.ro,0,2,0,2,-1.0,1.0
planificator,www.activenews.ro,0,1,0,1,-1.0,1.0
populație,www.activenews.ro,0,7,1,8,-0.875,0.875
premier,www.activenews.ro,1,13,10,24,-0.5,0.5
Petre Roman,www.activenews.ro,0,1,0,1,-1.0,1.0
Nicolae Cochinescu,www.activenews.ro,0,1,0,1,-1.0,1.0
proprietar,www.activenews.ro,0,1,1,2,-0.5,0.5
protestatar,www.activenews.ro,0,3,2,5,-0.6,0.6
purtător de cuvânt,www.activenews.ro,0,3,2,5,-0.6,0.6
redactor,www.activenews.ro,0,0,1,1,0.0,0.0
reprezentant,www.activenews.ro,0,12,11,23,-0.5217391304347826,0.5217391304347826
rude,www.activenews.ro,1,2,0,3,-0.3333333333333333,0.3333333333333333
student,www.activenews.ro,0,3,1,4,-0.75,0.75
subiect,www.activenews.ro,0,1,1,2,-0.5,0.5
taximetrist,www.activenews.ro,0,1,0,1,-1.0,1.0
șef,www.activenews.ro,1,22,4,27,-0.7777777777777778,0.7777777777777778
,a1.ro,0,1,1,2,-0.5,0.5
Bogdan Ionescu,a1.ro,0,0,3,3,0.0,0.0
Catalin Voicu,a1.ro,0,3,5,8,-0.375,0.375
Elena Băsescu,a1.ro,0,0,3,3,0.0,0.0
Maria,a1.ro,0,0,1,1,0.0,0.0
Miercurea Ciuc,a1.ro,0,0,2,2,0.0,0.0
Paris,a1.ro,0,0,6,6,0.0,0.0
senator,a1.ro,1,12,16,29,-0.3793103448275862,0.3793103448275862
iubit,a1.ro,0,1,1,2,-0.5,0.5
soție,a1.ro,3,4,38,45,-0.022222222222222223,0.022222222222222223
Ciucă,www.gandul.ro,2,12,6,20,-0.5,0.5
Oprea,www.gandul.ro,0,0,2,2,0.0,0.0
Prahova,www.gandul.ro,0,0,6,6,0.0,0.0
Radu Oprea,www.gandul.ro,0,0,3,3,0.0,0.0
Radu Ștefan Oprea,www.gandul.ro,0,0,1,1,0.0,0.0
Sebastian Burduja,www.gandul.ro,0,2,14,16,-0.125,0.125
Virgil,www.gandul.ro,0,0,1,1,0.0,0.0
Popescu,www.gandul.ro,0,0,3,3,0.0,0.0
ministru,www.gandul.ro,1,36,69,106,-0.330188679245283,0.330188679245283
miniștri,www.gandul.ro,0,7,7,14,-0.5,0.5
Călin Georgescu,www.euronews.ro,1,7,26,34,-0.17647058823529413,0.17647058823529413
George Simion,www.euronews.ro,1,6,83,90,-0.05555555555555555,0.05555555555555555
Simion,www.euronews.ro,0,12,24,36,-0.3333333333333333,0.3333333333333333
președinte,www.euronews.ro,11,50,200,261,-0.14942528735632185,0.14942528735632185
soție,www.euronews.ro,0,0,5,5,0.0,0.0
Băsescu,www.b1tv.ro,0,4,1,5,-0.8,0.8
Donald Trump,www.b1tv.ro,0,6,0,6,-1.0,1.0
Ioana Constantin,www.b1tv.ro,0,0,39,39,0.0,0.0
Polonia,www.b1tv.ro,0,0,1,1,0.0,0.0
Portugalia,www.b1tv.ro,0,0,1,1,0.0,0.0
România,www.b1tv.ro,19,27,43,89,-0.0898876404494382,0.0898876404494382
SUA,www.b1tv.ro,0,2,5,7,-0.2857142857142857,0.2857142857142857
Traian Băsescu,www.b1tv.ro,1,4,9,14,-0.21428571428571427,0.21428571428571427
Turcia,www.b1tv.ro,0,0,1,1,0.0,0.0
moderatoare,www.b1tv.ro,0,0,1,1,0.0,0.0
șef de stat,www.b1tv.ro,0,2,1,3,-0.6666666666666666,0.6666666666666666
Adrian Bucă,pressone.ro,0,0,1,1,0.0,0.0
Adrian Deoancă,pressone.ro,0,0,1,1,0.0,0.0
Arsenie,pressone.ro,0,1,0,1,-1.0,1.0
Denisa Arsenie,pressone.ro,0,0,1,1,0.0,0.0
Deoancă,pressone.ro,0,0,1,1,0.0,0.0
Düsseldorf,pressone.ro,0,0,1,1,0.0,0.0
Elena Lasconi,pressone.ro,1,9,12,22,-0.36363636363636365,0.36363636363636365
Germania,pressone.ro,0,2,26,28,-0.07142857142857142,0.07142857142857142
Gorj,pressone.ro,0,1,7,8,-0.125,0.125
hoț,pressone.ro,0,3,0,3,-1.0,1.0
Hunedoara,pressone.ro,0,0,9,9,0.0,0.0
Ioana-Maria Pop,pressone.ro,0,0,1,1,0.0,0.0
Jiu,pressone.ro,0,0,1,1,0.0,0.0
Köln,pressone.ro,0,0,1,1,0.0,0.0
Lupeni,pressone.ro,0,0,1,1,0.0,0.0
miner,pressone.ro,0,2,1,3,-0.6666666666666666,0.6666666666666666
Paroșeni,pressone.ro,0,0,1,1,0.0,0.0
Parâng,pressone.ro,0,1,0,1,-1.0,1.0
Petroșani,pressone.ro,0,0,1,1,0.0,0.0
Radu Moraru,pressone.ro,0,0,2,2,0.0,0.0
Republica Moldova,pressone.ro,1,10,15,26,-0.34615384615384615,0.34615384615384615
rezist,pressone.ro,0,1,0,1,-1.0,1.0
Silviu Tănase,pressone.ro,0,0,1,1,0.0,0.0
Tănase,pressone.ro,0,1,0,1,-1.0,1.0
Valea Jiului,pressone.ro,0,0,1,1,0.0,0.0
activist,pressone.ro,0,12,5,17,-0.7058823529411765,0.7058823529411765
administrator,pressone.ro,1,15,16,32,-0.4375,0.4375
Jack Friedman,pressone.ro,0,0,1,1,0.0,0.0
bișnițar,pressone.ro,0,1,0,1,-1.0,1.0
cameră,pressone.ro,0,1,0,1,-1.0,1.0
cercetător,pressone.ro,2,3,8,13,-0.07692307692307693,0.07692307692307693
electorat,pressone.ro,2,27,18,47,-0.5319148936170213,0.5319148936170213
femeie,pressone.ro,11,32,58,101,-0.2079207920792079,0.2079207920792079
fiică,pressone.ro,2,8,8,18,-0.3333333333333333,0.3333333333333333
intelectual,pressone.ro,1,13,3,17,-0.7058823529411765,0.7058823529411765
minier,pressone.ro,0,2,1,3,-0.6666666666666666,0.6666666666666666
momârlan,pressone.ro,0,1,0,1,-1.0,1.0
muncitor,pressone.ro,1,2,7,10,-0.1,0.1
oficial,pressone.ro,0,9,1,10,-0.9,0.9
pensionar,pressone.ro,0,7,3,10,-0.7,0.7
persoană,pressone.ro,4,60,89,153,-0.3660130718954248,0.3660130718954248
prezentatoare,pressone.ro,0,1,3,4,-0.25,0.25
realizator,pressone.ro,0,1,7,8,-0.125,0.125
rom,pressone.ro,0,0,1,1,0.0,0.0
tuturor,pressone.ro,0,1,1,2,-0.5,0.5
tânăr,pressone.ro,14,35,58,107,-0.19626168224299065,0.19626168224299065
urmăritor,pressone.ro,0,8,0,8,-1.0,1.0
ziarist,pressone.ro,0,8,9,17,-0.47058823529411764,0.47058823529411764
șacal,pressone.ro,0,1,0,1,-1.0,1.0
țăran,pressone.ro,0,2,1,3,-0.6666666666666666,0.6666666666666666
Ada Vîlceanu,agerpres.ro,0,0,50,50,0.0,0.0
Arina Moș,agerpres.ro,0,0,1,1,0.0,0.0
Aurel Mohan,agerpres.ro,0,0,1,1,0.0,0.0
Bihor,agerpres.ro,0,0,1,1,0.0,0.0
Biro Rozalia,agerpres.ro,1,0,2,3,0.3333333333333333,0.3333333333333333
Corina Ene,agerpres.ro,0,2,1,3,-0.6666666666666666,0.6666666666666666
Cristian Emanuel Cîmpan,agerpres.ro,0,0,1,1,0.0,0.0
Attila Cseke,agerpres.ro,0,0,3,3,0.0,0.0
Călin Gal,agerpres.ro,0,0,1,1,0.0,0.0
Dumitru Țiplea,agerpres.ro,0,0,2,2,0.0,0.0
Eugenia Pașca,agerpres.ro,0,0,6,6,0.0,0.0
Gheorghe Bota,agerpres.ro,0,0,1,1,0.0,0.0
Mihai Neamțu,agerpres.ro,0,0,1,1,0.0,0.0
Radu Harja,agerpres.ro,0,0,2,2,0.0,0.0
Szabo Odon,agerpres.ro,0,0,19,19,0.0,0.0
Vlad Andrei Vidra,agerpres.ro,0,0,1,1,0.0,0.0
beneficiar,agerpres.ro,0,0,1,1,0.0,0.0
deputat,agerpres.ro,2,27,53,82,-0.3048780487804878,0.3048780487804878
parlamentar,agerpres.ro,2,27,19,48,-0.5208333333333334,0.5208333333333334
George Simion,www.activenews.ro,10,15,21,46,-0.10869565217391304,0.10869565217391304
Ilie Bolojan,www.activenews.ro,0,4,3,7,-0.5714285714285714,0.5714285714285714
Nicușor Dan,www.activenews.ro,2,23,11,36,-0.5833333333333334,0.5833333333333334
Radu Marinescu,www.digi24.ro,0,0,3,3,0.0,0.0
Craiova,www.digi24.ro,0,0,2,2,0.0,0.0
Crin Antonescu,www.digi24.ro,4,5,31,40,-0.025,0.025
deputat,www.digi24.ro,1,23,24,48,-0.4583333333333333,0.4583333333333333
Dolj,www.digi24.ro,0,0,2,2,0.0,0.0
Sorin Grindeanu,www.digi24.ro,0,2,4,6,-0.3333333333333333,0.3333333333333333
avocat,www.digi24.ro,0,3,2,5,-0.6,0.6
decan,www.digi24.ro,0,0,2,2,0.0,0.0
om de afaceri,www.digi24.ro,0,6,11,17,-0.35294117647058826,0.35294117647058826
Anamaria Gavrilă,www.antena3.ro,0,1,6,7,-0.14285714285714285,0.14285714285714285
Călin Georgescu,www.antena3.ro,1,24,39,64,-0.359375,0.359375
Georgescu,www.antena3.ro,1,19,12,32,-0.5625,0.5625
lider,www.antena3.ro,8,49,77,134,-0.30597014925373134,0.30597014925373134
simpatizant,www.antena3.ro,0,1,1,2,-0.5,0.5
susținător,www.antena3.ro,1,9,7,17,-0.47058823529411764,0.47058823529411764
Cristian Pîrvulescu,www.euronews.ro,0,0,7,7,0.0,0.0
Bruxelles,www.digi24.ro,2,1,17,20,0.05,0.05
Madrid,www.digi24.ro,0,0,1,1,0.0,0.0
Moldova,www.digi24.ro,0,0,5,5,0.0,0.0
Ucraina,www.digi24.ro,6,5,20,31,0.03225806451612903,0.03225806451612903
șef de stat,www.digi24.ro,1,7,20,28,-0.21428571428571427,0.21428571428571427
Assen,www.news.ro,0,0,1,1,0.0,0.0
Coțofenești,www.news.ro,0,0,1,1,0.0,0.0
Natalia Intotero,www.news.ro,0,0,1,1,0.0,0.0
Olanda,www.news.ro,0,0,1,1,0.0,0.0
Marcel Ciolacu,www.news.ro,4,35,82,121,-0.256198347107438,0.256198347107438
hoț,www.news.ro,0,1,0,1,-1.0,1.0
ministru,www.news.ro,0,24,38,62,-0.3870967741935484,0.3870967741935484
premier,www.news.ro,3,12,38,53,-0.16981132075471697,0.16981132075471697
Țările de Jos,www.news.ro,0,0,1,1,0.0,0.0
Ligia Deca,www.antena3.ro,1,0,0,1,1.0,1.0
Luminița Odobescu,www.antena3.ro,1,0,0,1,1.0,1.0
Raluca Turcan,www.antena3.ro,1,1,0,2,0.0,0.0
bărbat,www.antena3.ro,0,3,1,4,-0.75,0.75
Alina Gorghiu,www.antena3.ro,1,0,2,3,0.3333333333333333,0.3333333333333333
electorat,www.antena3.ro,1,4,10,15,-0.2,0.2
membre,www.antena3.ro,1,0,0,1,1.0,1.0
Anamaria Gavrilă,www.realitatea.net,0,0,14,14,0.0,0.0
Gavrilă,www.realitatea.net,0,1,2,3,-0.3333333333333333,0.3333333333333333
George Simion,www.realitatea.net,1,4,35,40,-0.075,0.075
Simion,www.realitatea.net,0,3,6,9,-0.3333333333333333,0.3333333333333333
Alina Gorghiu,observatornews.ro,0,0,8,8,0.0,0.0
Andrei Țăranu,observatornews.ro,0,1,4,5,-0.2,0.2
Gabriel Zetea,observatornews.ro,0,0,2,2,0.0,0.0
Klaus Iohannis,observatornews.ro,1,25,96,122,-0.19672131147540983,0.19672131147540983
analist,observatornews.ro,0,2,9,11,-0.18181818181818182,0.18181818181818182
profesor,observatornews.ro,0,1,2,3,-0.3333333333333333,0.3333333333333333
Sever Voinescu,www.mediafax.ro,0,0,7,7,0.0,0.0
Traian Băsescu,www.mediafax.ro,1,23,26,50,-0.44,0.44
Voinescu,www.mediafax.ro,0,0,4,4,0.0,0.0
adversar,www.mediafax.ro,0,8,0,8,-1.0,1.0
mulți,www.mediafax.ro,0,1,1,2,-0.5,0.5
reprezentant,www.mediafax.ro,0,18,23,41,-0.43902439024390244,0.43902439024390244
Andrușceac,www.comisarul.ro,0,1,0,1,-1.0,1.0
Antonio Andrușceac,www.comisarul.ro,0,1,0,1,-1.0,1.0
Claudiu Târziu,www.comisarul.ro,0,5,8,13,-0.38461538461538464,0.38461538461538464
Cosmin Bărbălău,www.comisarul.ro,0,0,1,1,0.0,0.0
membru,www.comisarul.ro,0,23,44,67,-0.34328358208955223,0.34328358208955223
rude,www.comisarul.ro,0,1,0,1,-1.0,1.0
Codruț Marta,a1.ro,0,1,0,1,-1.0,1.0
Dan Nica,a1.ro,0,1,0,1,-1.0,1.0
Roberta Anastase,a1.ro,0,1,8,9,-0.1111111111111111,0.1111111111111111
Robert Anastase,a1.ro,0,1,1,2,-0.5,0.5
părinte,a1.ro,1,1,3,5,0.0,0.0
Adver,recorder.ro,0,1,0,1,-1.0,1.0
Bogdan Balanișcu,recorder.ro,0,0,1,1,0.0,0.0
Bogdan Cojocaru,recorder.ro,0,1,0,1,-1.0,1.0
Chirica,recorder.ro,0,2,0,2,-1.0,1.0
Cosette Chichirău,recorder.ro,0,2,2,4,-0.5,0.5
Costel Alexe,recorder.ro,0,1,2,3,-0.3333333333333333,0.3333333333333333
Dan Diaconescu,recorder.ro,0,1,1,2,-0.5,0.5
Gabriel Oprea,recorder.ro,0,2,6,8,-0.25,0.25
Gheorghe Nichita,recorder.ro,0,0,1,1,0.0,0.0
Iași,recorder.ro,0,3,22,25,-0.12,0.12
Liviu Dragnea,recorder.ro,0,19,11,30,-0.6333333333333333,0.6333333333333333
Marius Bodea,recorder.ro,0,0,2,2,0.0,0.0
Mihai Chirica,recorder.ro,0,4,1,5,-0.8,0.8
Nero,recorder.ro,0,1,0,1,-1.0,1.0
Tudor Ciuhodaru,recorder.ro,0,1,2,3,-0.3333333333333333,0.3333333333333333
deputat,recorder.ro,1,56,67,124,-0.4435483870967742,0.4435483870967742
edil,recorder.ro,0,16,2,18,-0.8888888888888888,0.8888888888888888
familie,recorder.ro,14,14,6,34,0.0,0.0
inginer,recorder.ro,1,4,55,60,-0.05,0.05
liberal,recorder.ro,0,5,5,10,-0.5,0.5
locuitor,recorder.ro,2,5,19,26,-0.11538461538461539,0.11538461538461539
medic,recorder.ro,12,10,51,73,0.0273972602739726,0.0273972602739726
membru,recorder.ro,6,40,61,107,-0.3177570093457944,0.3177570093457944
om,recorder.ro,35,114,150,299,-0.26421404682274247,0.26421404682274247
partener,recorder.ro,1,7,9,17,-0.35294117647058826,0.35294117647058826
protestatar,recorder.ro,0,4,1,5,-0.8,0.8
secretar de stat,recorder.ro,0,7,21,28,-0.25,0.25
susținător,recorder.ro,2,4,9,15,-0.13333333333333333,0.13333333333333333
viceprimar,recorder.ro,0,7,24,31,-0.22580645161290322,0.22580645161290322
împărat,recorder.ro,0,3,1,4,-0.75,0.75
Simona Bucura Oprescu,www.gandul.ro,0,0,1,1,0.0,0.0
ambasador,www.gandul.ro,0,1,8,9,-0.1111111111111111,0.1111111111111111
reprezentant,www.gandul.ro,1,14,32,47,-0.2765957446808511,0.2765957446808511
Alba,agerpres.ro,0,0,3,3,0.0,0.0
autor,agerpres.ro,0,0,2,2,0.0,0.0
Emil Boc,agerpres.ro,0,0,3,3,0.0,0.0
Roxana Losneanu,agerpres.ro,0,0,1,1,0.0,0.0
Sălciua,agerpres.ro,0,0,1,1,0.0,0.0
Timiș,agerpres.ro,0,0,1,1,0.0,0.0
Valeriu Tabără,agerpres.ro,0,0,1,1,0.0,0.0
asistent,agerpres.ro,0,0,2,2,0.0,0.0
cercetător,agerpres.ro,1,0,3,4,0.25,0.25
cetățean,agerpres.ro,15,1,17,33,0.42424242424242425,0.42424242424242425
conferențiar,agerpres.ro,0,0,1,1,0.0,0.0
coordonator,agerpres.ro,0,0,1,1,0.0,0.0
doctor,agerpres.ro,0,0,2,2,0.0,0.0
profesor,agerpres.ro,0,1,2,3,-0.3333333333333333,0.3333333333333333
reprezentant,agerpres.ro,0,9,23,32,-0.28125,0.28125
vicepreședinte,agerpres.ro,0,1,7,8,-0.125,0.125
Călin Georgescu,www.aktual24.ro,0,19,25,44,-0.4318181818181818,0.4318181818181818
George Simion,www.aktual24.ro,4,32,49,85,-0.32941176470588235,0.32941176470588235
Georgescu,www.aktual24.ro,2,9,7,18,-0.3888888888888889,0.3888888888888889
Simion,www.aktual24.ro,0,39,16,55,-0.7090909090909091,0.7090909090909091
Bolojan,www.aktual24.ro,5,10,33,48,-0.10416666666666667,0.10416666666666667
populație,www.aktual24.ro,0,4,4,8,-0.5,0.5
George Jiglău,adevarul.ro,0,0,18,18,0.0,0.0
George Rîpă,adevarul.ro,0,1,1,2,-0.5,0.5
Jiglău,adevarul.ro,0,0,3,3,0.0,0.0
Marine Le Pen,adevarul.ro,0,1,0,1,-1.0,1.0
Moscova,adevarul.ro,0,15,5,20,-0.75,0.75
politolog,adevarul.ro,0,2,17,19,-0.10526315789473684,0.10526315789473684
Rusia,adevarul.ro,0,45,15,60,-0.75,0.75
Statele Unite,adevarul.ro,3,11,18,32,-0.25,0.25
Viktor Orban,adevarul.ro,0,3,4,7,-0.42857142857142855,0.42857142857142855
electorat,adevarul.ro,2,26,44,72,-0.3333333333333333,0.3333333333333333
om,adevarul.ro,43,63,102,208,-0.09615384615384616,0.09615384615384616
personaj,adevarul.ro,2,16,10,28,-0.5,0.5
politician,adevarul.ro,0,99,11,110,-0.9,0.9
Diana Șoșoacă,adevarul.ro,0,18,28,46,-0.391304347826087,0.391304347826087
specialist,adevarul.ro,1,12,31,44,-0.25,0.25
Stoica,www.antena3.ro,0,0,1,1,0.0,0.0
Valeriu Stoica,www.antena3.ro,0,0,2,2,0.0,0.0
vicepreședinte,www.antena3.ro,0,1,15,16,-0.0625,0.0625
București,www.aktual24.ro,2,4,34,40,-0.05,0.05
bărbat,www.aktual24.ro,0,2,8,10,-0.2,0.2
condamnat,www.aktual24.ro,0,2,0,2,-1.0,1.0
eu,www.aktual24.ro,0,4,0,4,-1.0,1.0
procuror,www.aktual24.ro,0,17,2,19,-0.8947368421052632,0.8947368421052632
rezervist,www.aktual24.ro,0,3,0,3,-1.0,1.0
sustinator,www.aktual24.ro,2,7,15,24,-0.20833333333333334,0.20833333333333334
Bihor,www.g4media.ro,1,0,4,5,0.2,0.2
Oradea,www.g4media.ro,0,0,2,2,0.0,0.0
bihorean,www.g4media.ro,0,1,1,2,-0.5,0.5
nenorocit,www.g4media.ro,0,1,0,1,-1.0,1.0
Diana Șoșoacă,www.antena3.ro,0,4,10,14,-0.2857142857142857,0.2857142857142857
Elena Lasconi,www.antena3.ro,2,14,60,76,-0.15789473684210525,0.15789473684210525
Germania,www.antena3.ro,0,5,9,14,-0.35714285714285715,0.35714285714285715
Rob Bauer,www.antena3.ro,0,0,2,2,0.0,0.0
Ucraina,www.antena3.ro,4,6,21,31,-0.06451612903225806,0.06451612903225806
comandant,www.antena3.ro,0,1,0,1,-1.0,1.0
doamna Lasconi,www.antena3.ro,0,3,0,3,-1.0,1.0
domana Lasconi,www.antena3.ro,0,0,1,1,0.0,0.0
jurnalist,www.antena3.ro,3,8,15,26,-0.19230769230769232,0.19230769230769232
popor,www.antena3.ro,7,5,3,15,0.13333333333333333,0.13333333333333333
președinte,www.antena3.ro,6,52,166,224,-0.20535714285714285,0.20535714285714285
Ionaș,www.antena3.ro,0,1,0,1,-1.0,1.0
Lasconi,www.antena3.ro,0,7,22,29,-0.2413793103448276,0.2413793103448276
Nicușor Dan,www.antena3.ro,1,21,38,60,-0.3333333333333333,0.3333333333333333
Vlad Voiculescu,www.antena3.ro,0,0,1,1,0.0,0.0
elector,www.antena3.ro,0,0,1,1,0.0,0.0
prezidențiabil,www.antena3.ro,0,3,1,4,-0.75,0.75
sociolog,www.antena3.ro,0,0,4,4,0.0,0.0
Vladimir Ionaș,www.antena3.ro,0,0,1,1,0.0,0.0
Cristian Leonte,stirileprotv.ro,0,0,1,1,0.0,0.0
Cristian Pîrvulescu,stirileprotv.ro,0,0,25,25,0.0,0.0
Diana Șoșoacă,stirileprotv.ro,0,7,5,12,-0.5833333333333334,0.5833333333333334
George Simion,stirileprotv.ro,1,3,11,15,-0.13333333333333333,0.13333333333333333
Georgescu,stirileprotv.ro,0,5,4,9,-0.5555555555555556,0.5555555555555556
Pîrvulescu,stirileprotv.ro,0,1,3,4,-0.25,0.25
alegător,stirileprotv.ro,0,6,2,8,-0.75,0.75
independent,adevarul.ro,1,2,14,17,-0.058823529411764705,0.058823529411764705
Laura Vicol,recorder.ro,0,2,3,5,-0.4,0.4
Mamaia,recorder.ro,0,1,1,2,-0.5,0.5
Monaco,recorder.ro,0,0,2,2,0.0,0.0
Vicol,recorder.ro,0,1,0,1,-1.0,1.0
Vladimir Ciorbă,recorder.ro,0,1,2,3,-0.3333333333333333,0.3333333333333333
arbitru,recorder.ro,0,0,1,1,0.0,0.0
client,recorder.ro,2,4,7,13,-0.15384615384615385,0.15384615384615385
sportiv,recorder.ro,1,2,3,6,-0.16666666666666666,0.16666666666666666
ul,recorder.ro,0,5,2,7,-0.7142857142857143,0.7142857142857143
vedet,recorder.ro,0,4,0,4,-1.0,1.0
Antonescu,adevarul.ro,0,9,29,38,-0.23684210526315788,0.23684210526315788
Lavinia Șandru,adevarul.ro,0,0,14,14,0.0,0.0
Simion,adevarul.ro,1,23,26,50,-0.44,0.44
candidați,adevarul.ro,3,14,42,59,-0.1864406779661017,0.1864406779661017
respondent,adevarul.ro,0,0,19,19,0.0,0.0
Dincu,www.aktual24.ro,0,3,0,3,-1.0,1.0
România,www.aktual24.ro,35,45,117,197,-0.050761421319796954,0.050761421319796954
Vasile Dincu,www.aktual24.ro,1,2,0,3,-0.3333333333333333,0.3333333333333333
electorat,www.aktual24.ro,1,18,16,35,-0.4857142857142857,0.4857142857142857
multi,www.aktual24.ro,1,5,4,10,-0.4,0.4
om,www.aktual24.ro,25,54,64,143,-0.20279720279720279,0.20279720279720279
Bragadiru,www.romaniatv.net,0,0,2,2,0.0,0.0
colonel,www.romaniatv.net,0,4,0,4,-1.0,1.0
Voroneanu,www.romaniatv.net,0,0,2,2,0.0,0.0
Cătălin Zisu,www.romaniatv.net,0,2,0,2,-1.0,1.0
Dan Filimon,www.romaniatv.net,0,1,0,1,-1.0,1.0
Dicu,www.romaniatv.net,0,0,1,1,0.0,0.0
domnului,www.romaniatv.net,0,0,1,1,0.0,0.0
Felix Dicu,www.romaniatv.net,0,0,1,1,0.0,0.0
Filimon,www.romaniatv.net,0,1,0,1,-1.0,1.0
fiu,www.romaniatv.net,0,1,2,3,-0.3333333333333333,0.3333333333333333
general,www.romaniatv.net,0,7,2,9,-0.7777777777777778,0.7777777777777778
George Simon,www.romaniatv.net,0,1,1,2,-0.5,0.5
Hapău,www.romaniatv.net,0,0,1,1,0.0,0.0
Hăpău,www.romaniatv.net,0,1,0,1,-1.0,1.0
Ilfov,www.romaniatv.net,0,0,6,6,0.0,0.0
Iulian Gherghe,www.romaniatv.net,0,1,0,1,-1.0,1.0
Marian Munteanu,www.romaniatv.net,0,0,2,2,0.0,0.0
Munchen,www.romaniatv.net,0,0,2,2,0.0,0.0
primar general,www.romaniatv.net,0,4,3,7,-0.5714285714285714,0.5714285714285714
Republica Moldova,www.romaniatv.net,0,10,12,22,-0.45454545454545453,0.45454545454545453
Ucraina,www.romaniatv.net,2,3,12,17,-0.058823529411764705,0.058823529411764705
Virgil Măgureanu,www.romaniatv.net,0,1,0,1,-1.0,1.0
Zisu,www.romaniatv.net,0,1,0,1,-1.0,1.0
activist,www.romaniatv.net,0,3,0,3,-1.0,1.0
apropiat,www.romaniatv.net,0,6,1,7,-0.8571428571428571,0.8571428571428571
Dumitru Voroneanu,www.romaniatv.net,0,0,1,1,0.0,0.0
comandat,www.romaniatv.net,0,1,0,1,-1.0,1.0
consilier,www.romaniatv.net,0,11,15,26,-0.4230769230769231,0.4230769230769231
demnitar,www.romaniatv.net,0,2,2,4,-0.5,0.5
fondator,www.romaniatv.net,1,2,1,4,-0.25,0.25
Tate Voroneanu,www.romaniatv.net,0,1,0,1,-1.0,1.0
Marian Hapău,www.romaniatv.net,0,0,1,1,0.0,0.0
membru,www.romaniatv.net,0,24,38,62,-0.3870967741935484,0.3870967741935484
mentor,www.romaniatv.net,0,0,2,2,0.0,0.0
miniștri,www.romaniatv.net,0,5,6,11,-0.45454545454545453,0.45454545454545453
om,www.romaniatv.net,34,43,42,119,-0.07563025210084033,0.07563025210084033
ofiter,www.romaniatv.net,0,1,0,1,-1.0,1.0
ofițer,www.romaniatv.net,0,2,1,3,-0.6666666666666666,0.6666666666666666
om de afaceri,www.romaniatv.net,0,4,2,6,-0.6666666666666666,0.6666666666666666
preot,www.romaniatv.net,0,2,2,4,-0.5,0.5
protestatar,www.romaniatv.net,0,5,3,8,-0.625,0.625
sponsor,www.romaniatv.net,0,2,0,2,-1.0,1.0
șef,www.romaniatv.net,0,23,28,51,-0.45098039215686275,0.45098039215686275
Austria,www.aktual24.ro,0,0,4,4,0.0,0.0
austriac,www.aktual24.ro,0,0,1,1,0.0,0.0
Christian Schaller,www.aktual24.ro,0,0,1,1,0.0,0.0
Claudia Tanner,www.aktual24.ro,0,0,1,1,0.0,0.0
Rusia,www.aktual24.ro,0,45,9,54,-0.8333333333333334,0.8333333333333334
Tanner,www.aktual24.ro,0,0,1,1,0.0,0.0
cancelar,www.aktual24.ro,0,7,3,10,-0.7,0.7
Adrian Câciu,www.gandul.ro,0,1,7,8,-0.125,0.125
Cluj,www.gandul.ro,0,0,4,4,0.0,0.0
Câciu,www.gandul.ro,0,0,2,2,0.0,0.0
Iași,www.gandul.ro,0,0,6,6,0.0,0.0
Tudor,a1.ro,0,1,0,1,-1.0,1.0
Charles de Gaulle,a1.ro,0,0,1,1,0.0,0.0
europarlamentar,a1.ro,0,3,7,10,-0.3,0.3
Eugen Tomac,www.mediafax.ro,0,0,7,7,0.0,0.0
România,www.mediafax.ro,12,43,54,109,-0.28440366972477066,0.28440366972477066
Tomac,www.mediafax.ro,0,0,4,4,0.0,0.0
Ciolacu,adevarul.ro,0,24,36,60,-0.4,0.4
prim-ministru,adevarul.ro,0,8,15,23,-0.34782608695652173,0.34782608695652173
ea,adevarul.ro,0,2,2,4,-0.5,0.5
observator,adevarul.ro,1,8,16,25,-0.28,0.28
America,www.news.ro,0,2,5,7,-0.2857142857142857,0.2857142857142857
Donald Trump,www.news.ro,2,19,14,35,-0.4857142857142857,0.4857142857142857
Elena Lasconi,www.news.ro,1,12,73,86,-0.12790697674418605,0.12790697674418605
Tulsi Gabbard,www.news.ro,0,1,2,3,-0.3333333333333333,0.3333333333333333
Geneva,www.news.ro,0,0,1,1,0.0,0.0
Hawaii,www.news.ro,0,0,1,1,0.0,0.0
Kamala Harris,www.news.ro,0,0,1,1,0.0,0.0
Lasconi,www.news.ro,2,7,23,32,-0.15625,0.15625
Moscova,www.news.ro,0,4,1,5,-0.8,0.8
Vladimir Putin,www.news.ro,0,7,0,7,-1.0,1.0
SUA,www.news.ro,1,2,20,23,-0.043478260869565216,0.043478260869565216
Susie Wiles,www.news.ro,1,0,0,1,1.0,1.0
Wiles,www.news.ro,0,0,1,1,0.0,0.0
ambasador,www.news.ro,2,2,10,14,0.0,0.0
candidat,www.news.ro,17,40,122,179,-0.12849162011173185,0.12849162011173185
congresman,www.news.ro,0,1,0,1,-1.0,1.0
consilier,www.news.ro,0,2,16,18,-0.1111111111111111,0.1111111111111111
director,www.news.ro,0,4,6,10,-0.4,0.4
femeie,www.news.ro,2,3,3,8,-0.125,0.125
om,www.news.ro,23,31,33,87,-0.09195402298850575,0.09195402298850575
strateg,www.news.ro,0,1,0,1,-1.0,1.0
vicepreședinte,www.news.ro,0,3,9,12,-0.25,0.25
șef,www.news.ro,0,9,15,24,-0.375,0.375
șefă,www.news.ro,0,0,1,1,0.0,0.0
Bucura Oprescu,www.cotidianul.ro,0,1,0,1,-1.0,1.0
Ciolacu,www.cotidianul.ro,1,19,12,32,-0.5625,0.5625
ministru,www.cotidianul.ro,0,21,19,40,-0.525,0.525
Petrișor Peiu,www.cotidianul.ro,0,1,5,6,-0.16666666666666666,0.16666666666666666
semnatar,www.cotidianul.ro,0,5,1,6,-0.8333333333333334,0.8333333333333334
parlamentar,www.cotidianul.ro,0,17,8,25,-0.68,0.68
afacerist,a1.ro,0,3,2,5,-0.6,0.6
Băsescu,a1.ro,0,22,3,25,-0.88,0.88
Blaga,a1.ro,0,0,2,2,0.0,0.0
Cristian Popa,a1.ro,0,0,1,1,0.0,0.0
Nicolae Popa,a1.ro,0,1,0,1,-1.0,1.0
Sorin Ovidiu Vintu,a1.ro,0,1,0,1,-1.0,1.0
Vintu,a1.ro,0,1,0,1,-1.0,1.0
avocat,a1.ro,0,4,12,16,-0.25,0.25
Camelia Bogdan,a1.ro,0,1,0,1,-1.0,1.0
magistrat,a1.ro,0,3,3,6,-0.5,0.5
om de afaceri,a1.ro,0,3,2,5,-0.6,0.6
Franța,www.g4media.ro,0,3,10,13,-0.23076923076923078,0.23076923076923078
Oprea,www.g4media.ro,0,1,0,1,-1.0,1.0
Sinaia,www.g4media.ro,0,0,1,1,0.0,0.0
Vlad Oprea,www.g4media.ro,0,0,1,1,0.0,0.0
edil,www.g4media.ro,0,4,1,5,-0.8,0.8
interpuși,www.g4media.ro,0,2,0,2,-1.0,1.0
mamă,www.g4media.ro,2,1,4,7,0.14285714285714285,0.14285714285714285
utilizator,www.g4media.ro,0,3,1,4,-0.75,0.75
Adrian Câciu,observatornews.ro,0,0,1,1,0.0,0.0
Câciu,observatornews.ro,0,0,1,1,0.0,0.0
ministru,observatornews.ro,0,31,41,72,-0.4305555555555556,0.4305555555555556
Nicolae Ciucă,observatornews.ro,1,4,48,53,-0.05660377358490566,0.05660377358490566
lider,observatornews.ro,6,48,109,163,-0.25766871165644173,0.25766871165644173
Dragoș Stancă,adevarul.ro,0,0,1,1,0.0,0.0
Dragoș Stanca,adevarul.ro,0,0,1,1,0.0,0.0
expert,adevarul.ro,3,8,31,42,-0.11904761904761904,0.11904761904761904
anchetator,adevarul.ro,0,3,0,3,-1.0,1.0
București,stirileprotv.ro,0,1,27,28,-0.03571428571428571,0.03571428571428571
consilier,stirileprotv.ro,0,8,13,21,-0.38095238095238093,0.38095238095238093
primar,stirileprotv.ro,1,28,27,56,-0.48214285714285715,0.48214285714285715
secretari,stirileprotv.ro,0,0,1,1,0.0,0.0
acesta,stirileprotv.ro,0,1,1,2,-0.5,0.5
ales,stirileprotv.ro,0,16,6,22,-0.7272727272727273,0.7272727272727273
ant,stirileprotv.ro,0,0,1,1,0.0,0.0
membru,stirileprotv.ro,3,10,57,70,-0.1,0.1
andidați,stirileprotv.ro,0,0,1,1,0.0,0.0
prefect,stirileprotv.ro,0,0,4,4,0.0,0.0
supleant,stirileprotv.ro,0,1,1,2,-0.5,0.5
domnului,adevarul.ro,0,0,2,2,0.0,0.0
Măcar,adevarul.ro,0,1,0,1,-1.0,1.0
reporter,adevarul.ro,0,2,4,6,-0.3333333333333333,0.3333333333333333
Sfinția Sa,adevarul.ro,0,1,0,1,-1.0,1.0
bărbat,adevarul.ro,0,10,15,25,-0.4,0.4
cerșetor,adevarul.ro,0,1,0,1,-1.0,1.0
doamnă,adevarul.ro,2,3,7,12,-0.08333333333333333,0.08333333333333333
femeie,adevarul.ro,8,11,22,41,-0.07317073170731707,0.07317073170731707
noi,adevarul.ro,0,0,1,1,0.0,0.0
prezidențiabil,adevarul.ro,0,5,5,10,-0.5,0.5
traseist,adevarul.ro,0,1,0,1,-1.0,1.0
Geo Morosanu,www.luju.ro,0,0,1,1,0.0,0.0
Nicușor,www.luju.ro,0,2,0,2,-1.0,1.0
Nicușor Dan,www.luju.ro,1,37,7,45,-0.8,0.8
Gheorghe Morosanu,www.luju.ro,0,1,0,1,-1.0,1.0
politician,www.luju.ro,0,19,1,20,-0.95,0.95
prezident,www.luju.ro,0,3,2,5,-0.6,0.6
Corina Crețu,adevarul.ro,1,0,2,3,0.3333333333333333,0.3333333333333333
Crețu,adevarul.ro,0,0,1,1,0.0,0.0
Daciana Sârbu,adevarul.ro,0,0,2,2,0.0,0.0
român,www.antena3.ro,1,0,0,1,1.0,1.0
analișt,www.antena3.ro,0,1,1,2,-0.5,0.5
consultant,www.antena3.ro,0,2,1,3,-0.6666666666666666,0.6666666666666666
public,www.antena3.ro,0,5,4,9,-0.5555555555555556,0.5555555555555556
Șandru,www.antena3.ro,0,0,5,5,0.0,0.0
Canada,www.gandul.ro,0,1,3,4,-0.25,0.25
Costache,www.gandul.ro,0,0,1,1,0.0,0.0
Toronto,www.gandul.ro,0,0,2,2,0.0,0.0
familie,www.gandul.ro,4,2,3,9,0.2222222222222222,0.2222222222222222
informator,www.gandul.ro,0,1,0,1,-1.0,1.0
prieten,www.gandul.ro,1,0,7,8,0.125,0.125
părinte,www.gandul.ro,2,2,10,14,0.0,0.0
Ștefan Costache,www.gandul.ro,0,0,3,3,0.0,0.0
Alina Achim,adevarul.ro,0,0,1,1,0.0,0.0
Andrei,adevarul.ro,1,0,2,3,0.3333333333333333,0.3333333333333333
capitală,adevarul.ro,0,4,6,10,-0.4,0.4
Dumitru Borțun,adevarul.ro,0,0,1,1,0.0,0.0
Geoană,adevarul.ro,1,6,14,21,-0.23809523809523808,0.23809523809523808
Mihai Polițeanu,adevarul.ro,0,1,2,3,-0.3333333333333333,0.3333333333333333
Mircea Geoană,adevarul.ro,5,5,37,47,0.0,0.0
Ploiești,adevarul.ro,0,1,5,6,-0.16666666666666666,0.16666666666666666
Sanda Nicola,adevarul.ro,0,0,3,3,0.0,0.0
prieten,adevarul.ro,6,0,7,13,0.46153846153846156,0.46153846153846156
voluntar,adevarul.ro,2,0,3,5,0.4,0.4
Băsescu,observatornews.ro,0,2,1,3,-0.6666666666666666,0.6666666666666666
Cincu,observatornews.ro,0,0,1,1,0.0,0.0
Kogălniceanu,observatornews.ro,0,0,1,1,0.0,0.0
Rusia,observatornews.ro,0,12,6,18,-0.6666666666666666,0.6666666666666666
SUA,observatornews.ro,3,5,9,17,-0.11764705882352941,0.11764705882352941
Turda,observatornews.ro,0,0,1,1,0.0,0.0
Ucraina,observatornews.ro,7,6,20,33,0.030303030303030304,0.030303030303030304
băiat,observatornews.ro,0,1,0,1,-1.0,1.0
Donald Trump,observatornews.ro,0,13,5,18,-0.7222222222222222,0.7222222222222222
om politic,observatornews.ro,0,6,1,7,-0.8571428571428571,0.8571428571428571
semnatar,observatornews.ro,0,2,1,3,-0.6666666666666666,0.6666666666666666
Cristian Câmpeanu,www.b1tv.ro,0,2,0,2,-1.0,1.0
Kiev,www.b1tv.ro,0,0,1,1,0.0,0.0
Moscova,www.b1tv.ro,0,2,0,2,-1.0,1.0
Klaus Iohannis,www.b1tv.ro,0,6,6,12,-0.5,0.5
ucrainean,www.b1tv.ro,0,1,0,1,-1.0,1.0
Alina Gorghiu,www.digi24.ro,1,1,6,8,0.0,0.0
Gorghiu,www.digi24.ro,0,1,3,4,-0.25,0.25
Vasile Dîncu,www.digi24.ro,0,0,2,2,0.0,0.0
ministru,www.digi24.ro,0,38,49,87,-0.4367816091954023,0.4367816091954023
Biden,pressone.ro,1,2,1,4,-0.25,0.25
Brașov,pressone.ro,1,3,11,15,-0.13333333333333333,0.13333333333333333
bărbat,pressone.ro,0,22,39,61,-0.36065573770491804,0.36065573770491804
Cluj,pressone.ro,3,2,31,36,0.027777777777777776,0.027777777777777776
Daniel Fenechiu,pressone.ro,0,2,1,3,-0.6666666666666666,0.6666666666666666
Ilfov,pressone.ro,0,0,17,17,0.0,0.0
Klaus Iohannis,pressone.ro,1,63,59,123,-0.5040650406504065,0.5040650406504065
Lulea,pressone.ro,0,2,1,3,-0.6666666666666666,0.6666666666666666
Marius Dorin Lulea,pressone.ro,0,1,1,2,-0.5,0.5
Mureș,pressone.ro,1,0,11,12,0.08333333333333333,0.08333333333333333
New Deal,pressone.ro,0,0,1,1,0.0,0.0
Nicu Ștefănuță,pressone.ro,3,0,1,4,0.75,0.75
Piperea,pressone.ro,0,3,0,3,-1.0,1.0
Planul Simion,pressone.ro,0,0,1,1,0.0,0.0
politică,pressone.ro,0,9,0,9,-1.0,1.0
Simion,pressone.ro,1,19,8,28,-0.6428571428571429,0.6428571428571429
Statele Unite,pressone.ro,0,4,14,18,-0.2222222222222222,0.2222222222222222
Statele Unite ale Americii,pressone.ro,0,1,4,5,-0.2,0.2
Suedia,pressone.ro,0,1,6,7,-0.14285714285714285,0.14285714285714285
avocat,pressone.ro,2,7,19,28,-0.17857142857142858,0.17857142857142858
beneficiar,pressone.ro,1,9,3,13,-0.6153846153846154,0.6153846153846154
cetățean,pressone.ro,23,39,68,130,-0.12307692307692308,0.12307692307692308
coleg,pressone.ro,17,37,61,115,-0.17391304347826086,0.17391304347826086
comunicator,pressone.ro,0,2,1,3,-0.6666666666666666,0.6666666666666666
dezvoltator,pressone.ro,0,4,1,5,-0.8,0.8
dușman,pressone.ro,0,18,0,18,-1.0,1.0
eurodeputat,pressone.ro,0,7,7,14,-0.5,0.5
independent,pressone.ro,1,0,2,3,0.3333333333333333,0.3333333333333333
influencer,pressone.ro,1,4,1,6,-0.5,0.5
inginer,pressone.ro,1,0,10,11,0.09090909090909091,0.09090909090909091
iști,pressone.ro,0,3,0,3,-1.0,1.0
populișt,pressone.ro,0,5,0,5,-1.0,1.0
Ciolacu,pressone.ro,1,19,5,25,-0.72,0.72
Daniel Florea,pressone.ro,0,2,1,3,-0.6666666666666666,0.6666666666666666
promotor,pressone.ro,0,6,1,7,-0.8571428571428571,0.8571428571428571
specialist,pressone.ro,4,10,20,34,-0.17647058823529413,0.17647058823529413
speculant,pressone.ro,0,2,0,2,-1.0,1.0
student,pressone.ro,4,13,27,44,-0.20454545454545456,0.20454545454545456
trecător,pressone.ro,0,2,0,2,-1.0,1.0
victimă,pressone.ro,0,7,9,16,-0.4375,0.4375
Ștefănuță,pressone.ro,1,0,0,1,1.0,1.0
eurodeputat,www.b1tv.ro,0,0,2,2,0.0,0.0
suveran,www.b1tv.ro,0,3,1,4,-0.75,0.75
mincinos,www.b1tv.ro,0,2,0,2,-1.0,1.0
Alexandru Andrei,www.digi24.ro,0,0,2,2,0.0,0.0
Niculae Bădălău,www.digi24.ro,0,2,1,3,-0.6666666666666666,0.6666666666666666
parlamentar,www.digi24.ro,0,32,10,42,-0.7619047619047619,0.7619047619047619
Adrian Câciu,www.euronews.ro,0,0,4,4,0.0,0.0
Bârlad,www.euronews.ro,0,0,1,1,0.0,0.0
Sorin Grindeanu,www.euronews.ro,0,2,7,9,-0.2222222222222222,0.2222222222222222
Vaslui,www.euronews.ro,0,1,4,5,-0.2,0.2
Adrian Solomon,www.euronews.ro,0,0,1,1,0.0,0.0
ministru,www.euronews.ro,1,19,55,75,-0.24,0.24
partener,www.euronews.ro,2,5,5,12,-0.25,0.25
Dacian Cioloș,www.antena3.ro,0,0,5,5,0.0,0.0
aleș,www.antena3.ro,0,1,1,2,-0.5,0.5
cetățean,www.antena3.ro,13,9,14,36,0.1111111111111111,0.1111111111111111
colaborator,www.antena3.ro,1,4,1,6,-0.5,0.5
coleg,www.antena3.ro,7,2,6,15,0.3333333333333333,0.3333333333333333
politician,www.antena3.ro,0,26,2,28,-0.9285714285714286,0.9285714285714286
profesionist,www.antena3.ro,3,0,0,3,1.0,1.0
vârstnic,www.antena3.ro,0,0,1,1,0.0,0.0
Bogdan,www.realitatea.net,0,0,1,1,0.0,0.0
Bruxelles,www.realitatea.net,0,6,4,10,-0.6,0.6
eurodeputat,www.realitatea.net,1,3,3,7,-0.2857142857142857,0.2857142857142857
Florin Danciu,www.realitatea.net,0,0,1,1,0.0,0.0
Rareș Bogdan,www.realitatea.net,0,0,1,1,0.0,0.0
SUA,www.realitatea.net,1,3,9,13,-0.15384615384615385,0.15384615384615385
Donald Trump,www.realitatea.net,2,21,14,37,-0.5135135135135135,0.5135135135135135
Georgia Meloni,www.g4media.ro,0,0,1,1,0.0,0.0
Italia,www.g4media.ro,0,0,4,4,0.0,0.0
Matteo Salvini,www.g4media.ro,0,2,1,3,-0.6666666666666666,0.6666666666666666
Adriean Videanu,www.gandul.ro,0,0,1,1,0.0,0.0
Alexandru Nazare,www.gandul.ro,0,0,1,1,0.0,0.0
Andrea Paul,www.gandul.ro,0,0,1,1,0.0,0.0
Andreea Paul,www.gandul.ro,0,0,1,1,0.0,0.0
George Scripcaru,www.gandul.ro,0,1,3,4,-0.25,0.25
Gheorghe Falcă,www.gandul.ro,0,0,2,2,0.0,0.0
Liviu Negoiță,www.gandul.ro,0,0,2,2,0.0,0.0
Paul,www.gandul.ro,0,0,1,1,0.0,0.0
Petru Luhan,www.gandul.ro,0,0,1,1,0.0,0.0
Roberta Anastase,www.gandul.ro,0,1,1,2,-0.5,0.5
Sorin Moldovan,www.gandul.ro,0,0,1,1,0.0,0.0
tânăr,www.gandul.ro,8,1,8,17,0.4117647058823529,0.4117647058823529
ziarist,www.gandul.ro,0,1,0,1,-1.0,1.0
Claudiu Târziu,www.digi24.ro,0,0,9,9,0.0,0.0
IPS Teodosie,www.digi24.ro,0,0,1,1,0.0,0.0
Iași,www.digi24.ro,0,0,2,2,0.0,0.0
Republica Moldova,www.digi24.ro,4,1,9,14,0.21428571428571427,0.21428571428571427
familie,www.digi24.ro,2,2,5,9,0.0,0.0
politician,www.digi24.ro,0,44,0,44,-1.0,1.0
populație,www.digi24.ro,0,4,7,11,-0.36363636363636365,0.36363636363636365
Dacian Cioloș,www.digi24.ro,4,4,7,15,0.0,0.0
reprezentant,www.digi24.ro,0,17,24,41,-0.4146341463414634,0.4146341463414634
Veneția,www.digi24.ro,0,0,1,1,0.0,0.0
infractor,www.digi24.ro,0,3,0,3,-1.0,1.0
marionetă,www.digi24.ro,0,1,0,1,-1.0,1.0
profesionist,www.digi24.ro,2,0,2,4,0.5,0.5
promotor,www.digi24.ro,0,1,0,1,-1.0,1.0
reparat,www.digi24.ro,0,1,0,1,-1.0,1.0
specialist,www.digi24.ro,1,0,6,7,0.14285714285714285,0.14285714285714285
victimă,www.digi24.ro,0,2,0,2,-1.0,1.0
vinovat,www.digi24.ro,0,1,0,1,-1.0,1.0
Florin Cîțu,stirileprotv.ro,0,8,2,10,-0.8,0.8
Sibiu,stirileprotv.ro,0,0,4,4,0.0,0.0
Simion,stirileprotv.ro,0,9,1,10,-0.9,0.9
Bode,stirileprotv.ro,0,1,1,2,-0.5,0.5
Ciucă,stirileprotv.ro,0,2,3,5,-0.4,0.4
personaj,stirileprotv.ro,0,2,0,2,-1.0,1.0
Avram Iancu,www.romaniatv.net,0,0,1,1,0.0,0.0
Becali,www.romaniatv.net,1,6,3,10,-0.5,0.5
Gigi Becali,www.romaniatv.net,2,16,9,27,-0.5185185185185185,0.5185185185185185
latifundiar,www.romaniatv.net,0,3,0,3,-1.0,1.0
Maica Domnului,www.romaniatv.net,1,0,0,1,1.0,1.0
Petrișor Peiu,www.romaniatv.net,1,0,3,4,0.25,0.25
Pipera,www.romaniatv.net,0,5,0,5,-1.0,1.0
candidați,www.romaniatv.net,0,8,11,19,-0.42105263157894735,0.42105263157894735
patron,www.romaniatv.net,0,6,2,8,-0.75,0.75
politician,www.romaniatv.net,0,22,3,25,-0.88,0.88
Arsenie Boca,snoop.ro,0,0,1,1,0.0,0.0
Bacău,snoop.ro,0,0,3,3,0.0,0.0
Budapesta,snoop.ro,0,0,3,3,0.0,0.0
Comănești,snoop.ro,0,0,1,1,0.0,0.0
Constantin Sârbu,snoop.ro,0,0,1,1,0.0,0.0
Covasna,snoop.ro,0,0,6,6,0.0,0.0
Domnul,snoop.ro,0,1,0,1,-1.0,1.0
Ernest Bernea,snoop.ro,0,0,1,1,0.0,0.0
erou,snoop.ro,0,0,1,1,0.0,0.0
Gafencu,snoop.ro,0,1,0,1,-1.0,1.0
George Simion,snoop.ro,0,3,12,15,-0.2,0.2
Gherasim Iscu,snoop.ro,0,0,1,1,0.0,0.0
Harghita,snoop.ro,0,0,5,5,0.0,0.0
Ilie Cleopa,snoop.ro,0,0,1,1,0.0,0.0
Ion Moța,snoop.ro,0,0,1,1,0.0,0.0
Gheorghe Mucenic,snoop.ro,1,0,0,1,1.0,1.0
Mircea Vulcănescu,snoop.ro,0,0,1,1,0.0,0.0
Nichifor Crainic,snoop.ro,0,0,1,1,0.0,0.0
Nicolae Steinhardt,snoop.ro,0,0,1,1,0.0,0.0
preot,snoop.ro,0,2,3,5,-0.4,0.4
purtător de cuvânt,snoop.ro,0,3,7,10,-0.3,0.3
Radu Gyr,snoop.ro,0,0,1,1,0.0,0.0
Tanczos Barna,snoop.ro,0,1,0,1,-1.0,1.0
Valea Uzului,snoop.ro,0,0,1,1,0.0,0.0
Vasile Marin,snoop.ro,0,0,1,1,0.0,0.0
Vulcănescu,snoop.ro,0,0,1,1,0.0,0.0
Zelea Codreanu,snoop.ro,0,0,2,2,0.0,0.0
cuvioș,snoop.ro,0,0,1,1,0.0,0.0
echipă,snoop.ro,0,0,1,1,0.0,0.0
f,snoop.ro,0,0,1,1,0.0,0.0
Împărații Constantin și Elena,snoop.ro,0,0,1,1,0.0,0.0
Adrian Cioflâncă,snoop.ro,0,0,1,1,0.0,0.0
legionar,snoop.ro,0,1,0,1,-1.0,1.0
martir,snoop.ro,0,0,1,1,0.0,0.0
mulțime,snoop.ro,0,0,1,1,0.0,0.0
mărturisitor,snoop.ro,0,1,0,1,-1.0,1.0
ori,snoop.ro,0,0,1,1,0.0,0.0
p,snoop.ro,0,2,3,5,-0.4,0.4
poet,snoop.ro,0,1,0,1,-1.0,1.0
Adrian Agachi,snoop.ro,0,0,1,1,0.0,0.0
Răzvan Popovici,snoop.ro,0,1,0,1,-1.0,1.0
reporter,snoop.ro,0,10,25,35,-0.2857142857142857,0.2857142857142857
senator,snoop.ro,0,2,14,16,-0.125,0.125
sfânt,snoop.ro,0,3,3,6,-0.5,0.5
soldat,snoop.ro,0,1,1,2,-0.5,0.5
țânăr,snoop.ro,0,1,0,1,-1.0,1.0
Antonescu,www.euronews.ro,0,3,14,17,-0.17647058823529413,0.17647058823529413
Capitale,www.euronews.ro,1,2,12,15,-0.06666666666666667,0.06666666666666667
Călărași,www.euronews.ro,0,0,4,4,0.0,0.0
Daniel Suciu,www.euronews.ro,0,0,1,1,0.0,0.0
Dolj,www.euronews.ro,0,2,2,4,-0.5,0.5
Iași,www.euronews.ro,0,0,5,5,0.0,0.0
Ionuț Moșteanu,www.euronews.ro,0,0,6,6,0.0,0.0
Kelemen Hunor,www.euronews.ro,0,1,23,24,-0.041666666666666664,0.041666666666666664
Paul Mursa,www.euronews.ro,0,0,1,1,0.0,0.0
Plugari,www.euronews.ro,0,0,1,1,0.0,0.0
Ponta,www.euronews.ro,0,9,8,17,-0.5294117647058824,0.5294117647058824
primar,www.euronews.ro,5,17,30,52,-0.23076923076923078,0.23076923076923078
Slatina,www.euronews.ro,0,0,1,1,0.0,0.0
Sorin Sandu,www.euronews.ro,0,0,1,1,0.0,0.0
Vasile Blaga,www.euronews.ro,0,1,2,3,-0.3333333333333333,0.3333333333333333
Victor Ponta,www.euronews.ro,0,13,25,38,-0.34210526315789475,0.34210526315789475
de Mezzo,www.euronews.ro,0,1,0,1,-1.0,1.0
electorat,www.euronews.ro,5,4,12,21,0.047619047619047616,0.047619047619047616
independent,www.euronews.ro,0,0,5,5,0.0,0.0
nehotărât,www.euronews.ro,0,2,2,4,-0.5,0.5
simpatizant,www.euronews.ro,0,5,3,8,-0.625,0.625
susținător,www.euronews.ro,0,1,8,9,-0.1111111111111111,0.1111111111111111
vicepreședinte,www.euronews.ro,0,0,20,20,0.0,0.0
votant,www.euronews.ro,0,11,12,23,-0.4782608695652174,0.4782608695652174
Afred Simonis,www.g4media.ro,0,0,1,1,0.0,0.0
Alfred Simonis,www.g4media.ro,0,1,9,10,-0.1,0.1
Ciolacu,www.g4media.ro,1,17,16,34,-0.47058823529411764,0.47058823529411764
Laura Vicol,www.g4media.ro,0,1,2,3,-0.3333333333333333,0.3333333333333333
George Ivan,www.g4media.ro,0,0,1,1,0.0,0.0
Grindeanu,www.g4media.ro,0,3,3,6,-0.5,0.5
Ivan,www.g4media.ro,0,0,1,1,0.0,0.0
Madrid,www.g4media.ro,0,0,2,2,0.0,0.0
Monaco,www.g4media.ro,0,0,1,1,0.0,0.0
Monica Hunyadi,www.g4media.ro,0,0,1,1,0.0,0.0
Nisa,www.g4media.ro,0,0,1,1,0.0,0.0
Paris,www.g4media.ro,1,1,3,5,0.0,0.0
Răzvan-Vladimir Ciorba,www.g4media.ro,0,1,0,1,-1.0,1.0
Simonis,www.g4media.ro,0,1,4,5,-0.2,0.2
Sorin Grindeanu,www.g4media.ro,0,1,12,13,-0.07692307692307693,0.07692307692307693
Sorina Docuz,www.g4media.ro,0,0,1,1,0.0,0.0
Spania,www.g4media.ro,0,0,5,5,0.0,0.0
specialist,www.g4media.ro,2,1,4,7,0.14285714285714285,0.14285714285714285
Timișoara,www.g4media.ro,1,0,4,5,0.2,0.2
Vicol,www.g4media.ro,0,0,1,1,0.0,0.0
Vinicius,www.g4media.ro,0,0,1,1,0.0,0.0
Vladimir Ciorbă,www.g4media.ro,0,1,0,1,-1.0,1.0
administrator,www.g4media.ro,0,1,3,4,-0.25,0.25
asociat,www.g4media.ro,0,0,3,3,0.0,0.0
bă,www.g4media.ro,0,1,0,1,-1.0,1.0
coleg,www.g4media.ro,11,9,10,30,0.06666666666666667,0.06666666666666667
copil,www.g4media.ro,5,3,5,13,0.15384615384615385,0.15384615384615385
cuplu,www.g4media.ro,0,4,0,4,-1.0,1.0
echipaj,www.g4media.ro,0,0,1,1,0.0,0.0
familia Vicol,www.g4media.ro,0,0,1,1,0.0,0.0
familia Vicol-Ciorbă,www.g4media.ro,0,0,1,1,0.0,0.0
Vicol Ciorbă,www.g4media.ro,0,0,1,1,0.0,0.0
fiu,www.g4media.ro,1,4,3,8,-0.375,0.375
pasager,www.g4media.ro,0,0,1,1,0.0,0.0
părinte,www.g4media.ro,2,2,1,5,0.0,0.0
soț,www.g4media.ro,0,6,6,12,-0.5,0.5
Călin Georgescu,www.b1tv.ro,0,10,13,23,-0.43478260869565216,0.43478260869565216
Laura Chiriac,www.b1tv.ro,0,0,9,9,0.0,0.0
Vlad Nistor,www.b1tv.ro,0,0,1,1,0.0,0.0
judecător,www.b1tv.ro,0,5,2,7,-0.7142857142857143,0.7142857142857143
liberal,www.b1tv.ro,0,4,0,4,-1.0,1.0
Ana Maria Gavrilă,www.euronews.ro,0,0,1,1,0.0,0.0
Anamaria Gavrilă,www.euronews.ro,0,1,6,7,-0.14285714285714285,0.14285714285714285
Claudiu Târziu,www.euronews.ro,0,1,3,4,-0.25,0.25
Cristian Terheș,www.euronews.ro,0,0,6,6,0.0,0.0
Diana Șoșoacă,www.euronews.ro,0,9,7,16,-0.5625,0.5625
Hunedoara,www.euronews.ro,0,1,4,5,-0.2,0.2
Luis Lazarus,www.euronews.ro,0,0,1,1,0.0,0.0
SUA,www.euronews.ro,1,11,18,30,-0.3333333333333333,0.3333333333333333
amândoi,www.euronews.ro,0,0,2,2,0.0,0.0
competitor,www.euronews.ro,0,1,2,3,-0.3333333333333333,0.3333333333333333
consilier,www.euronews.ro,2,3,6,11,-0.09090909090909091,0.09090909090909091
individ,www.euronews.ro,1,1,0,2,0.0,0.0
Ciucă,primanews.ro,3,2,17,22,0.045454545454545456,0.045454545454545456
Dolj,primanews.ro,0,0,2,2,0.0,0.0
coleg,primanews.ro,4,0,9,13,0.3076923076923077,0.3076923076923077
Ponta,www.mediafax.ro,1,22,12,35,-0.6,0.6
Victor Ponta,www.mediafax.ro,1,27,26,54,-0.48148148148148145,0.48148148148148145
Ana Maria Boghean,stirileprotv.ro,0,0,1,1,0.0,0.0
Andreea Leonte,stirileprotv.ro,0,0,1,1,0.0,0.0
Camelia Sălcudean,stirileprotv.ro,0,0,3,3,0.0,0.0
Capitale,stirileprotv.ro,0,0,10,10,0.0,0.0
Cătălin Teniță,stirileprotv.ro,0,0,2,2,0.0,0.0
Horațiu Potra,stirileprotv.ro,0,0,1,1,0.0,0.0
Marcel Ivanov,stirileprotv.ro,0,0,1,1,0.0,0.0
politician,stirileprotv.ro,0,27,1,28,-0.9642857142857143,0.9642857142857143
militar,stirileprotv.ro,0,1,0,1,-1.0,1.0
populație,stirileprotv.ro,0,1,7,8,-0.125,0.125
Antonescu,pressone.ro,0,1,1,2,-0.5,0.5
Bruxelles,pressone.ro,0,4,12,16,-0.25,0.25
Ciucă,pressone.ro,0,16,9,25,-0.64,0.64
Crin Antonescu,pressone.ro,0,1,6,7,-0.14285714285714285,0.14285714285714285
Călin Georgescu,pressone.ro,2,19,12,33,-0.5151515151515151,0.5151515151515151
Dacian Cioloș,pressone.ro,4,3,11,18,0.05555555555555555,0.05555555555555555
Dan Voiculescu,pressone.ro,0,4,5,9,-0.4444444444444444,0.4444444444444444
Florin Cîțu,pressone.ro,0,6,13,19,-0.3157894736842105,0.3157894736842105
Ludovic Orban,pressone.ro,0,9,16,25,-0.36,0.36
Mihai Tudose,pressone.ro,0,12,18,30,-0.4,0.4
Moldova,pressone.ro,2,8,11,21,-0.2857142857142857,0.2857142857142857
Polonia,pressone.ro,0,4,20,24,-0.16666666666666666,0.16666666666666666
Ponta,pressone.ro,0,30,6,36,-0.8333333333333334,0.8333333333333334
Sibiu,pressone.ro,0,0,15,15,0.0,0.0
Sorin Grindeanu,pressone.ro,0,9,16,25,-0.36,0.36
Ungaria,pressone.ro,0,11,24,35,-0.3142857142857143,0.3142857142857143
Ungarie,pressone.ro,0,5,5,10,-0.5,0.5
Viorica Dăncilă,pressone.ro,0,13,6,19,-0.6842105263157895,0.6842105263157895
democrat,pressone.ro,0,1,0,1,-1.0,1.0
individ,pressone.ro,3,12,8,23,-0.391304347826087,0.391304347826087
jucător,pressone.ro,1,4,7,12,-0.25,0.25
ministru,pressone.ro,2,103,80,185,-0.5459459459459459,0.5459459459459459
popor,pressone.ro,5,12,10,27,-0.25925925925925924,0.25925925925925924
președinte arbitru,pressone.ro,0,1,0,1,-1.0,1.0
securist,pressone.ro,0,6,0,6,-1.0,1.0
zombi,pressone.ro,0,1,0,1,-1.0,1.0
Țările Baltice,pressone.ro,0,0,1,1,0.0,0.0
Becali,www.g4media.ro,0,2,1,3,-0.6666666666666666,0.6666666666666666
Claudiu Târziu,www.g4media.ro,0,6,9,15,-0.4,0.4
Gigi Becali,www.g4media.ro,0,3,0,3,-1.0,1.0
TikTok,www.g4media.ro,0,1,1,2,-0.5,0.5
Târziu,www.g4media.ro,0,1,2,3,-0.3333333333333333,0.3333333333333333
moderator,www.g4media.ro,0,0,3,3,0.0,0.0
patron,www.g4media.ro,0,8,0,8,-1.0,1.0
suveran,www.g4media.ro,0,1,0,1,-1.0,1.0
Corneliu Mureșan,agerpres.ro,1,0,2,3,0.3333333333333333,0.3333333333333333
Cotroceni,agerpres.ro,0,0,3,3,0.0,0.0
Olanda,agerpres.ro,0,0,2,2,0.0,0.0
Rotterdam,agerpres.ro,0,0,2,2,0.0,0.0
bunic,agerpres.ro,1,1,0,2,0.0,0.0
coleg,agerpres.ro,1,2,6,9,-0.1111111111111111,0.1111111111111111
cunoscut,agerpres.ro,0,0,1,1,0.0,0.0
familie,agerpres.ro,7,0,1,8,0.875,0.875
frate,agerpres.ro,2,0,1,3,0.6666666666666666,0.6666666666666666
nepot,agerpres.ro,2,1,0,3,0.3333333333333333,0.3333333333333333
prieteni,agerpres.ro,1,0,0,1,1.0,1.0
părinte,agerpres.ro,2,2,0,4,0.0,0.0
străbunici,agerpres.ro,0,0,1,1,0.0,0.0
verișor,agerpres.ro,0,1,0,1,-1.0,1.0
Auschwitz,www.digi24.ro,0,1,0,1,-1.0,1.0
Dan Barna,www.digi24.ro,0,2,6,8,-0.25,0.25
Dancă,www.digi24.ro,0,0,1,1,0.0,0.0
Ionel Dancă,www.digi24.ro,0,0,1,1,0.0,0.0
Muntenegru,www.digi24.ro,0,1,0,1,-1.0,1.0
Petre Daea,www.digi24.ro,0,2,0,2,-1.0,1.0
Podgorița,www.digi24.ro,0,1,0,1,-1.0,1.0
Priștina,www.digi24.ro,0,1,0,1,-1.0,1.0
purtător de cuvânt,www.digi24.ro,0,3,8,11,-0.2727272727272727,0.2727272727272727
Viorica Dăncilă,www.digi24.ro,1,4,6,11,-0.2727272727272727,0.2727272727272727
oficial,www.digi24.ro,0,9,4,13,-0.6923076923076923,0.6923076923076923
Chirica,www.gandul.ro,0,0,1,1,0.0,0.0
Mihai Chirica,www.gandul.ro,0,0,3,3,0.0,0.0
primar,www.gandul.ro,1,24,43,68,-0.3382352941176471,0.3382352941176471
Rusia,www.gandul.ro,0,21,8,29,-0.7241379310344828,0.7241379310344828
Strasbourg,www.gandul.ro,0,0,1,1,0.0,0.0
Ucraina,www.gandul.ro,3,8,36,47,-0.10638297872340426,0.10638297872340426
Ursula von der Leyen,www.gandul.ro,0,1,12,13,-0.07692307692307693,0.07692307692307693
edil,www.gandul.ro,0,16,4,20,-0.8,0.8
electorat,www.gandul.ro,1,1,8,10,0.0,0.0
nebun,www.gandul.ro,0,1,0,1,-1.0,1.0
simpatizant,www.gandul.ro,0,2,1,3,-0.6666666666666666,0.6666666666666666
,www.realitatea.net,0,1,1,2,-0.5,0.5
Călin Georgescu,www.realitatea.net,15,13,45,73,0.0273972602739726,0.0273972602739726
independent,www.realitatea.net,1,0,1,2,0.5,0.5
populație,www.realitatea.net,0,2,5,7,-0.2857142857142857,0.2857142857142857
respondent,www.realitatea.net,0,0,6,6,0.0,0.0
Emil Hurezeanu,adevarul.ro,1,1,8,10,0.0,0.0
Mark Rutte,adevarul.ro,0,0,3,3,0.0,0.0
Munchen,adevarul.ro,0,0,3,3,0.0,0.0
oficial,adevarul.ro,0,12,9,21,-0.5714285714285714,0.5714285714285714
profesor,adevarul.ro,6,8,24,38,-0.05263157894736842,0.05263157894736842
Rutte,adevarul.ro,0,1,0,1,-1.0,1.0
SUA,adevarul.ro,5,9,42,56,-0.07142857142857142,0.07142857142857142
Valentin Naumescu,adevarul.ro,0,0,2,2,0.0,0.0
Valeriu Naumescu,adevarul.ro,0,0,1,1,0.0,0.0
actorii,adevarul.ro,1,2,6,9,-0.1111111111111111,0.1111111111111111
ministru,adevarul.ro,1,49,69,119,-0.40336134453781514,0.40336134453781514
Cătălin Predoiu,adevarul.ro,1,1,8,10,0.0,0.0
Cristian Sima,www.mediafax.ro,0,0,1,1,0.0,0.0
George Simion,www.mediafax.ro,0,2,19,21,-0.09523809523809523,0.09523809523809523
Georgescu,www.mediafax.ro,1,1,4,6,0.0,0.0
Simion,www.mediafax.ro,0,2,11,13,-0.15384615384615385,0.15384615384615385
candidat,www.mediafax.ro,4,29,49,82,-0.3048780487804878,0.3048780487804878
colaborator,www.mediafax.ro,0,0,2,2,0.0,0.0
membru,www.mediafax.ro,5,14,49,68,-0.1323529411764706,0.1323529411764706
Lucian Romașcanu,www.mediafax.ro,0,0,2,2,0.0,0.0
Bolojan,stirileprotv.ro,0,1,12,13,-0.07692307692307693,0.07692307692307693
Cătălin Predoiu,stirileprotv.ro,0,0,7,7,0.0,0.0
Mircea Abrudean,stirileprotv.ro,0,0,1,1,0.0,0.0
Predoiu,stirileprotv.ro,0,0,2,2,0.0,0.0
antreprenor,stirileprotv.ro,4,0,0,4,1.0,1.0
Crin Antonescu,stirileprotv.ro,2,2,28,32,0.0,0.0
electorat,stirileprotv.ro,2,2,5,9,0.0,0.0
familie,stirileprotv.ro,5,1,3,9,0.4444444444444444,0.4444444444444444
intelectual,stirileprotv.ro,1,0,2,3,0.3333333333333333,0.3333333333333333
Ciadud,www.romaniatv.net,0,2,1,3,-0.6666666666666666,0.6666666666666666
suveranist,www.romaniatv.net,0,12,0,12,-1.0,1.0
tânăr,www.g4media.ro,3,2,5,10,0.1,0.1
Crin Antonescu,www.comisarul.ro,4,18,56,78,-0.1794871794871795,0.1794871794871795
coleg,www.comisarul.ro,3,3,18,24,0.0,0.0
Alfred Simonis,www.activenews.ro,0,1,3,4,-0.25,0.25
Arabia Saudită,www.activenews.ro,0,1,0,1,-1.0,1.0
Ceaușescu,www.activenews.ro,0,4,0,4,-1.0,1.0
Ciolacu,www.activenews.ro,0,14,4,18,-0.7777777777777778,0.7777777777777778
Călin,www.activenews.ro,0,1,1,2,-0.5,0.5
Călău,www.activenews.ro,0,1,0,1,-1.0,1.0
doamnă,www.activenews.ro,1,3,1,5,-0.4,0.4
Georgescu,www.activenews.ro,2,7,2,11,-0.45454545454545453,0.45454545454545453
Hunor,www.activenews.ro,0,1,1,2,-0.5,0.5
Klaus Iohannis,www.activenews.ro,0,29,5,34,-0.8529411764705882,0.8529411764705882
Maica Domnului,www.activenews.ro,1,0,1,2,0.5,0.5
Mesia,www.activenews.ro,0,1,0,1,-1.0,1.0
Pambuccian,www.activenews.ro,0,1,0,1,-1.0,1.0
Simion,www.activenews.ro,4,5,5,14,-0.07142857142857142,0.07142857142857142
Simonis,www.activenews.ro,0,2,0,2,-1.0,1.0
agent,www.activenews.ro,0,3,0,3,-1.0,1.0
bodyguard,www.activenews.ro,0,1,0,1,-1.0,1.0
dezaxat,www.activenews.ro,0,1,0,1,-1.0,1.0
dânse,www.activenews.ro,0,1,0,1,-1.0,1.0
erou,www.activenews.ro,0,2,0,2,-1.0,1.0
interlop,www.activenews.ro,0,1,0,1,-1.0,1.0
iubit,www.activenews.ro,0,1,0,1,-1.0,1.0
laș,www.activenews.ro,0,1,1,2,-0.5,0.5
nebun,www.activenews.ro,0,3,0,3,-1.0,1.0
parlamentar,www.activenews.ro,0,5,1,6,-0.8333333333333334,0.8333333333333334
personaj,www.activenews.ro,0,4,6,10,-0.4,0.4
soră,www.activenews.ro,0,2,6,8,-0.25,0.25
victimă,www.activenews.ro,0,2,0,2,-1.0,1.0
șarlatan,www.activenews.ro,0,1,0,1,-1.0,1.0
Alexandru Dimitriu,agerpres.ro,0,0,1,1,0.0,0.0
Ciprian Ciubuc,agerpres.ro,0,0,6,6,0.0,0.0
Ciubuc,agerpres.ro,0,6,0,6,-1.0,1.0
Dimitriu,agerpres.ro,0,0,1,1,0.0,0.0
editor,agerpres.ro,0,3,57,60,-0.05,0.05
redactor,agerpres.ro,0,0,17,17,0.0,0.0
AUR,www.comisarul.ro,0,1,1,2,-0.5,0.5
alegător,www.comisarul.ro,1,20,19,40,-0.475,0.475
George Nicolae Simion,www.comisarul.ro,0,1,1,2,-0.5,0.5
Baia Mare,recorder.ro,0,1,3,4,-0.25,0.25
Gaza,recorder.ro,0,6,4,10,-0.6,0.6
militar,recorder.ro,0,3,8,11,-0.2727272727272727,0.2727272727272727
soacră,recorder.ro,0,1,0,1,-1.0,1.0
Buzau,www.aktual24.ro,0,1,5,6,-0.16666666666666666,0.16666666666666666
Statele Unite,www.aktual24.ro,1,3,15,19,-0.10526315789473684,0.10526315789473684
ales,www.aktual24.ro,1,1,0,2,0.0,0.0
Clotilde Armand,pressone.ro,0,0,3,3,0.0,0.0
Daniel Tudorache,pressone.ro,0,0,3,3,0.0,0.0
Antonescu,www.mediafax.ro,0,6,16,22,-0.2727272727272727,0.2727272727272727
Belgrad,www.mediafax.ro,0,5,11,16,-0.3125,0.3125
Crin Antonescu,www.mediafax.ro,1,5,20,26,-0.15384615384615385,0.15384615384615385
premier,www.mediafax.ro,2,17,48,67,-0.22388059701492538,0.22388059701492538
Angelo Miculescu,adevarul.ro,0,0,1,1,0.0,0.0
Cornel Anastase,adevarul.ro,0,1,0,1,-1.0,1.0
Călin Popescu Tăriceanu,adevarul.ro,0,0,5,5,0.0,0.0
Daciana,adevarul.ro,0,0,1,1,0.0,0.0
Dan Amadeo Lăzărescu,adevarul.ro,0,0,1,1,0.0,0.0
Dan Amedeo Lăzărescu,adevarul.ro,0,1,0,1,-1.0,1.0
Dana Miculescu,adevarul.ro,0,0,1,1,0.0,0.0
deputat,adevarul.ro,0,31,45,76,-0.40789473684210525,0.40789473684210525
Elena Băsescu,adevarul.ro,0,1,1,2,-0.5,0.5
Elena,adevarul.ro,0,0,1,1,0.0,0.0
fiică,adevarul.ro,0,6,7,13,-0.46153846153846156,0.46153846153846156
George Maior,adevarul.ro,2,0,1,3,0.6666666666666666,0.6666666666666666
Grigorie Preoteasa,adevarul.ro,0,0,1,1,0.0,0.0
Ilie Sârbu,adevarul.ro,0,1,0,1,-1.0,1.0
Liviu Maior,adevarul.ro,0,1,1,2,-0.5,0.5
Lăzărescu,adevarul.ro,0,0,1,1,0.0,0.0
Mihai Apostolache,adevarul.ro,0,0,2,2,0.0,0.0
miss,adevarul.ro,0,1,0,1,-1.0,1.0
Năstase,adevarul.ro,0,3,1,4,-0.75,0.75
Petre Roman,adevarul.ro,0,0,3,3,0.0,0.0
Rareș Mănescu,adevarul.ro,0,0,1,1,0.0,0.0
Roberta Anastase,adevarul.ro,0,1,3,4,-0.25,0.25
Roman,adevarul.ro,0,2,3,5,-0.4,0.4
Stolojan,adevarul.ro,0,0,2,2,0.0,0.0
tânăr,adevarul.ro,14,3,13,30,0.36666666666666664,0.36666666666666664
Tăriceanu,adevarul.ro,0,2,2,4,-0.5,0.5
urmaș,adevarul.ro,0,1,2,3,-0.3333333333333333,0.3333333333333333
Victor,adevarul.ro,0,1,1,2,-0.5,0.5
Walter,adevarul.ro,0,1,0,1,-1.0,1.0
demnitar,adevarul.ro,0,13,0,13,-1.0,1.0
familie,adevarul.ro,6,6,9,21,0.0,0.0
fiu,adevarul.ro,0,3,11,14,-0.21428571428571427,0.21428571428571427
fruntaș,adevarul.ro,0,2,0,2,-1.0,1.0
informator,adevarul.ro,0,2,0,2,-1.0,1.0
Mihai Râmniceanu,adevarul.ro,0,0,1,1,0.0,0.0
Traian Băsescu,adevarul.ro,3,29,44,76,-0.34210526315789475,0.34210526315789475
părinte,adevarul.ro,0,4,6,10,-0.4,0.4
Mihai I,adevarul.ro,0,0,6,6,0.0,0.0
rudă,adevarul.ro,0,2,0,2,-1.0,1.0
secretar,adevarul.ro,0,1,28,29,-0.034482758620689655,0.034482758620689655
senator,adevarul.ro,0,9,31,40,-0.225,0.225
tată,adevarul.ro,1,3,7,11,-0.18181818181818182,0.18181818181818182
veteran,adevarul.ro,0,0,4,4,0.0,0.0
Beijing,www.aktual24.ro,0,0,1,1,0.0,0.0
Berlin,www.aktual24.ro,0,0,2,2,0.0,0.0
Chinei,www.aktual24.ro,0,1,0,1,-1.0,1.0
Friedrich Merz,www.aktual24.ro,0,1,4,5,-0.2,0.2
Germania,www.aktual24.ro,2,1,13,16,0.0625,0.0625
Johann Wadephul,www.aktual24.ro,0,0,1,1,0.0,0.0
Moscova,www.aktual24.ro,0,12,4,16,-0.75,0.75
SUA,www.aktual24.ro,2,8,11,21,-0.2857142857142857,0.2857142857142857
Wadephul,www.aktual24.ro,1,0,1,2,0.5,0.5
Washington,www.aktual24.ro,0,2,7,9,-0.2222222222222222,0.2222222222222222
adversar,www.aktual24.ro,0,5,0,5,-1.0,1.0
aliat,www.aktual24.ro,3,3,5,11,0.0,0.0
expert,www.aktual24.ro,0,1,5,6,-0.16666666666666666,0.16666666666666666
jurnalist,www.aktual24.ro,2,15,22,39,-0.3333333333333333,0.3333333333333333
veteran,www.aktual24.ro,1,0,0,1,1.0,1.0
Bacău,www.mediafax.ro,0,0,6,6,0.0,0.0
Blaga,www.mediafax.ro,0,0,5,5,0.0,0.0
Boc,www.mediafax.ro,0,2,6,8,-0.25,0.25
București,www.mediafax.ro,0,4,12,16,-0.25,0.25
Băsescu,www.mediafax.ro,0,9,7,16,-0.5625,0.5625
Cristian Preda,www.mediafax.ro,0,0,4,4,0.0,0.0
Ioan Oltean,www.mediafax.ro,0,0,2,2,0.0,0.0
Lăzăroiu,www.mediafax.ro,0,0,2,2,0.0,0.0
Monica Macovei,www.mediafax.ro,0,0,4,4,0.0,0.0
Oltean,www.mediafax.ro,0,1,2,3,-0.3333333333333333,0.3333333333333333
Sebastian Lăzăroiu,www.mediafax.ro,0,0,2,2,0.0,0.0
secretar general,www.mediafax.ro,0,0,10,10,0.0,0.0
Sorin Frunzăverde,www.mediafax.ro,0,0,4,4,0.0,0.0
Vasile Blaga,www.mediafax.ro,0,0,9,9,0.0,0.0
consilier prezidențial,www.mediafax.ro,0,1,1,2,-0.5,0.5
om,www.mediafax.ro,7,20,22,49,-0.2653061224489796,0.2653061224489796
ziarist,www.mediafax.ro,0,1,1,2,-0.5,0.5
șef,www.mediafax.ro,0,28,26,54,-0.5185185185185185,0.5185185185185185
Jack Posobiac,www.activenews.ro,0,0,1,1,0.0,0.0
X,www.activenews.ro,0,0,1,1,0.0,0.0
lume,www.activenews.ro,0,1,0,1,-1.0,1.0
Ciprian Ciucu,www.digi24.ro,0,0,4,4,0.0,0.0
edil,www.digi24.ro,2,3,4,9,-0.1111111111111111,0.1111111111111111
Bolojan,primanews.ro,1,4,12,17,-0.17647058823529413,0.17647058823529413
Crin Antonescu,primanews.ro,2,3,21,26,-0.038461538461538464,0.038461538461538464
Ilie Bolojan,primanews.ro,4,4,38,46,0.0,0.0
Alexandru Vlad Mihai Cristescu,snoop.ro,0,0,1,1,0.0,0.0
Bittman,snoop.ro,0,1,0,1,-1.0,1.0
Bod,snoop.ro,0,0,1,1,0.0,0.0
Ciolacu,snoop.ro,0,6,2,8,-0.75,0.75
Craiovei,snoop.ro,0,0,1,1,0.0,0.0
Dan Bittman,snoop.ro,0,0,1,1,0.0,0.0
Daniel Băluță,snoop.ro,0,1,0,1,-1.0,1.0
Grindeanu,snoop.ro,0,0,1,1,0.0,0.0
Kiseleff,snoop.ro,0,1,1,2,-0.5,0.5
Lehliu,snoop.ro,0,0,1,1,0.0,0.0
Lia Olguța Vasilescu,snoop.ro,0,0,1,1,0.0,0.0
Luduș,snoop.ro,0,0,1,1,0.0,0.0
Marcel Ciolacu,snoop.ro,0,9,19,28,-0.32142857142857145,0.32142857142857145
Mihaela Neagu,snoop.ro,1,0,2,3,0.3333333333333333,0.3333333333333333
Mihai Morar,snoop.ro,0,0,1,1,0.0,0.0
ministru,snoop.ro,0,17,22,39,-0.4358974358974359,0.4358974358974359
Neagu,snoop.ro,0,0,2,2,0.0,0.0
Paul Stănescu,snoop.ro,0,0,2,2,0.0,0.0
Petre Daea,snoop.ro,0,0,1,1,0.0,0.0
secretar general,snoop.ro,0,5,11,16,-0.3125,0.3125
Sorin Grindeanu,snoop.ro,0,0,2,2,0.0,0.0
Sorina Plăcintă,snoop.ro,0,0,1,1,0.0,0.0
Stănescu,snoop.ro,0,0,1,1,0.0,0.0
administrator,snoop.ro,0,11,15,26,-0.4230769230769231,0.4230769230769231
afaceristă,snoop.ro,0,1,0,1,-1.0,1.0
competitor,snoop.ro,0,3,0,3,-1.0,1.0
câștigător,snoop.ro,0,0,1,1,0.0,0.0
directoare,snoop.ro,0,3,2,5,-0.6,0.6
doamnă,snoop.ro,0,0,4,4,0.0,0.0
doamna Neagu,snoop.ro,0,1,0,1,-1.0,1.0
edil,snoop.ro,0,8,6,14,-0.5714285714285714,0.5714285714285714
ea,snoop.ro,0,0,2,2,0.0,0.0
Cristescu,snoop.ro,0,1,0,1,-1.0,1.0
femeie de afaceri,snoop.ro,0,0,2,2,0.0,0.0
invitat,snoop.ro,0,2,5,7,-0.2857142857142857,0.2857142857142857
Sebastian Zachmann,snoop.ro,0,0,1,1,0.0,0.0
participant,snoop.ro,1,3,4,8,-0.25,0.25
roa,snoop.ro,0,1,0,1,-1.0,1.0
strateg,snoop.ro,0,1,1,2,-0.5,0.5
susținătoare,snoop.ro,0,1,0,1,-1.0,1.0
telespectator,snoop.ro,0,2,1,3,-0.6666666666666666,0.6666666666666666
vicepremier,snoop.ro,0,0,2,2,0.0,0.0
Cristian Alexandru Micu,snoop.ro,0,0,1,1,0.0,0.0
custode,adevarul.ro,0,1,0,1,-1.0,1.0
Principesa Margareta,adevarul.ro,0,1,0,1,-1.0,1.0
Nicolae al României,adevarul.ro,0,0,1,1,0.0,0.0
Regală,adevarul.ro,0,2,0,2,-1.0,1.0
Mihai,adevarul.ro,0,2,0,2,-1.0,1.0
nepot,adevarul.ro,0,2,0,2,-1.0,1.0
principe Nicolae,adevarul.ro,0,0,1,1,0.0,0.0
Adrian Dădârlat,agerpres.ro,0,0,24,24,0.0,0.0
Antonescu,observatornews.ro,0,1,6,7,-0.14285714285714285,0.14285714285714285
Crin Antonescu,observatornews.ro,1,0,28,29,0.034482758620689655,0.034482758620689655
Traian Băsescu,observatornews.ro,0,3,1,4,-0.75,0.75
alegător,observatornews.ro,0,8,11,19,-0.42105263157894735,0.42105263157894735
artizan,observatornews.ro,0,0,1,1,0.0,0.0
Antonescu,www.g4media.ro,1,3,9,13,-0.15384615384615385,0.15384615384615385
Cluj,www.g4media.ro,0,0,5,5,0.0,0.0
Tișe,www.g4media.ro,0,0,1,1,0.0,0.0
Alin Tișe,www.g4media.ro,0,0,1,1,0.0,0.0
Adina Vălean,stirileprotv.ro,0,0,1,1,0.0,0.0
Brie Pegum,stirileprotv.ro,0,0,1,1,0.0,0.0
Caroline Greer,stirileprotv.ro,0,0,1,1,0.0,0.0
Dan Nica,stirileprotv.ro,0,0,1,1,0.0,0.0
europarlamentar,stirileprotv.ro,1,9,11,21,-0.38095238095238093,0.38095238095238093
Pierre Jouvet,stirileprotv.ro,0,0,1,1,0.0,0.0
director,stirileprotv.ro,0,3,4,7,-0.42857142857142855,0.42857142857142855
Roberta Metsola,stirileprotv.ro,0,0,2,2,0.0,0.0
radio,adevarul.ro,0,0,1,1,0.0,0.0
zor,adevarul.ro,0,0,1,1,0.0,0.0
Aurelian Pavelescu,www.digi24.ro,0,0,1,1,0.0,0.0
Dragnea,www.digi24.ro,0,4,4,8,-0.5,0.5
Pavelescu,www.digi24.ro,0,1,0,1,-1.0,1.0
activist,www.comisarul.ro,1,2,1,4,-0.25,0.25
Botswana,www.comisarul.ro,0,0,1,1,0.0,0.0
Cho,www.comisarul.ro,1,0,0,1,1.0,1.0
Chombo,www.comisarul.ro,1,1,0,2,0.0,0.0
Elveția,www.comisarul.ro,1,0,3,4,0.25,0.25
Emiratele,www.comisarul.ro,0,0,1,1,0.0,0.0
Gaborone,www.comisarul.ro,0,0,1,1,0.0,0.0
Lesego Chombo,www.comisarul.ro,2,0,0,2,1.0,1.0
Președintele Boko,www.comisarul.ro,0,1,0,1,-1.0,1.0
Duma Boko,www.comisarul.ro,0,0,2,2,0.0,0.0
avocat,www.comisarul.ro,1,2,1,4,-0.25,0.25
copil,www.comisarul.ro,3,5,22,30,-0.06666666666666667,0.06666666666666667
delegat,www.comisarul.ro,1,1,1,3,0.0,0.0
deținătoare,www.comisarul.ro,0,1,0,1,-1.0,1.0
femeie,www.comisarul.ro,0,5,12,17,-0.29411764705882354,0.29411764705882354
mbo,www.comisarul.ro,0,0,1,1,0.0,0.0
oare,www.comisarul.ro,0,0,1,1,0.0,0.0
swana,www.comisarul.ro,0,0,1,1,0.0,0.0
tânăr,www.comisarul.ro,11,3,6,20,0.4,0.4
Ionuț Cristache,primanews.ro,0,0,2,2,0.0,0.0
invitat,primanews.ro,0,0,6,6,0.0,0.0
premier,primanews.ro,1,11,37,49,-0.20408163265306123,0.20408163265306123
Giurgiu,adevarul.ro,1,0,5,6,0.16666666666666666,0.16666666666666666
Niculae Bădălău,adevarul.ro,0,0,1,1,0.0,0.0
locuitor,adevarul.ro,0,0,4,4,0.0,0.0
Arad,pressone.ro,0,1,16,17,-0.058823529411764705,0.058823529411764705
Constanța,pressone.ro,1,2,12,15,-0.06666666666666667,0.06666666666666667
Diana Șoșoacă,pressone.ro,0,14,10,24,-0.5833333333333334,0.5833333333333334
Dolj,pressone.ro,1,2,8,11,-0.09090909090909091,0.09090909090909091
Georgia,pressone.ro,0,2,2,4,-0.5,0.5
Harghita,pressone.ro,0,1,9,10,-0.1,0.1
Ilie Bolojan,pressone.ro,0,2,7,9,-0.2222222222222222,0.2222222222222222
lume,pressone.ro,0,23,4,27,-0.8518518518518519,0.8518518518518519
Marcel Ciolacu,pressone.ro,0,15,22,37,-0.40540540540540543,0.40540540540540543
Olt,pressone.ro,0,1,10,11,-0.09090909090909091,0.09090909090909091
polițist,pressone.ro,0,13,2,15,-0.8666666666666667,0.8666666666666667
Vladimir Putin,pressone.ro,1,19,2,22,-0.8181818181818182,0.8181818181818182
Rareș Bogdan,pressone.ro,0,7,5,12,-0.5833333333333334,0.5833333333333334
Suceava,pressone.ro,1,1,15,17,0.0,0.0
Teleorman,pressone.ro,0,5,11,16,-0.3125,0.3125
Timiș,pressone.ro,0,0,11,11,0.0,0.0
autor,pressone.ro,1,29,29,59,-0.4745762711864407,0.4745762711864407
boț,pressone.ro,0,1,0,1,-1.0,1.0
respondent,pressone.ro,0,1,3,4,-0.25,0.25
senator,pressone.ro,1,57,90,148,-0.3783783783783784,0.3783783783783784
Bolojan,observatornews.ro,0,1,12,13,-0.07692307692307693,0.07692307692307693
Ilie Bolojan,observatornews.ro,0,2,44,46,-0.043478260869565216,0.043478260869565216
candidați,observatornews.ro,0,0,11,11,0.0,0.0
electorat,observatornews.ro,0,4,7,11,-0.36363636363636365,0.36363636363636365
Daniel Baciu,primanews.ro,0,0,1,1,0.0,0.0
pensionar,primanews.ro,0,2,3,5,-0.4,0.4
șef,primanews.ro,2,7,20,29,-0.1724137931034483,0.1724137931034483
Ciolacu,observatornews.ro,0,13,30,43,-0.3023255813953488,0.3023255813953488
Președintele României,observatornews.ro,0,0,2,2,0.0,0.0
actorii,observatornews.ro,0,0,3,3,0.0,0.0
actor politic,observatornews.ro,0,0,1,1,0.0,0.0
cetățean,observatornews.ro,11,3,22,36,0.2222222222222222,0.2222222222222222
donator,observatornews.ro,0,1,0,1,-1.0,1.0
mandatar,observatornews.ro,0,2,1,3,-0.6666666666666666,0.6666666666666666
persoană,observatornews.ro,2,15,31,48,-0.2708333333333333,0.2708333333333333
personal,observatornews.ro,0,2,3,5,-0.4,0.4
public,observatornews.ro,2,0,2,4,0.5,0.5
sponsor,observatornews.ro,0,0,2,2,0.0,0.0
împuternicit,observatornews.ro,0,0,1,1,0.0,0.0
Belgia,www.gandul.ro,0,0,5,5,0.0,0.0
Bruxelles,www.gandul.ro,0,2,14,16,-0.125,0.125
cetățean,www.gandul.ro,21,4,23,48,0.3541666666666667,0.3541666666666667
Charles Michel,www.gandul.ro,0,0,1,1,0.0,0.0
Dan Barna,www.gandul.ro,0,0,3,3,0.0,0.0
deputat,www.gandul.ro,0,12,19,31,-0.3870967741935484,0.3870967741935484
Emmanuel Macron,www.gandul.ro,1,1,5,7,0.0,0.0
Josep Borrell,www.gandul.ro,0,0,1,1,0.0,0.0
Mihai Tudose,www.gandul.ro,0,1,8,9,-0.1111111111111111,0.1111111111111111
Polonia,www.gandul.ro,0,0,6,6,0.0,0.0
Vasile Cristian Terheș,www.gandul.ro,0,0,1,1,0.0,0.0
Vlaams Belang,www.gandul.ro,0,0,1,1,0.0,0.0
astricht,www.gandul.ro,0,1,0,1,-1.0,1.0
comisar,www.gandul.ro,1,7,11,19,-0.3157894736842105,0.3157894736842105
premier,www.gandul.ro,6,12,43,61,-0.09836065573770492,0.09836065573770492
vicepremier,www.gandul.ro,0,0,6,6,0.0,0.0
Înalt Reprezentant,www.gandul.ro,0,0,1,1,0.0,0.0
Capitale,www.comisarul.ro,0,5,20,25,-0.2,0.2
Călin Georgescu,www.comisarul.ro,3,28,46,77,-0.3246753246753247,0.3246753246753247
independent,www.comisarul.ro,0,1,9,10,-0.1,0.1
Anamaria Gavrilă,adevarul.ro,0,4,22,26,-0.15384615384615385,0.15384615384615385
Danileț,adevarul.ro,0,1,1,2,-0.5,0.5
Dăncilă,adevarul.ro,0,2,2,4,-0.5,0.5
Gavrilă,adevarul.ro,0,4,5,9,-0.4444444444444444,0.4444444444444444
Viorica Dăncilă,adevarul.ro,0,4,8,12,-0.3333333333333333,0.3333333333333333
contestatar,adevarul.ro,0,5,2,7,-0.7142857142857143,0.7142857142857143
prof. Avramescu,adevarul.ro,0,0,1,1,0.0,0.0
profesorul Avramescu,adevarul.ro,0,2,0,2,-1.0,1.0
Cătălin Avramescu,adevarul.ro,0,2,8,10,-0.2,0.2
suveranist,adevarul.ro,0,4,2,6,-0.6666666666666666,0.6666666666666666
suveran,adevarul.ro,0,17,0,17,-1.0,1.0
șefă,adevarul.ro,1,10,15,26,-0.34615384615384615,0.34615384615384615
Daniel David,www.aktual24.ro,0,0,7,7,0.0,0.0
Emil Hurezeanu,www.aktual24.ro,0,1,6,7,-0.14285714285714285,0.14285714285714285
Ioan Aurel Pop,www.aktual24.ro,0,0,4,4,0.0,0.0
acesta,www.aktual24.ro,0,1,2,3,-0.3333333333333333,0.3333333333333333
Cristian Andrei,adevarul.ro,0,0,1,1,0.0,0.0
competitor,adevarul.ro,0,11,8,19,-0.5789473684210527,0.5789473684210527
studentă,adevarul.ro,1,0,1,2,0.5,0.5
Allen Coliban,adevarul.ro,0,4,6,10,-0.4,0.4
Argeș,adevarul.ro,0,0,9,9,0.0,0.0
Câmpulung,adevarul.ro,0,0,6,6,0.0,0.0
Cătălin Drulă,adevarul.ro,0,0,6,6,0.0,0.0
Hațeg,adevarul.ro,0,0,2,2,0.0,0.0
Lasconi,adevarul.ro,1,9,54,64,-0.125,0.125
Liviu Țâroiu,adevarul.ro,0,1,0,1,-1.0,1.0
angajat,adevarul.ro,3,5,9,17,-0.11764705882352941,0.11764705882352941
corespondent,adevarul.ro,0,0,3,3,0.0,0.0
evaluator,adevarul.ro,0,0,1,1,0.0,0.0
manager,adevarul.ro,0,1,1,2,-0.5,0.5
moderator,adevarul.ro,0,0,6,6,0.0,0.0
producător,adevarul.ro,0,0,1,1,0.0,0.0
realizator,adevarul.ro,0,0,3,3,0.0,0.0
soț,adevarul.ro,0,3,6,9,-0.3333333333333333,0.3333333333333333
trainer,adevarul.ro,0,0,1,1,0.0,0.0
Dan,www.news.ro,0,1,5,6,-0.16666666666666666,0.16666666666666666
Nicușor Dan,www.news.ro,4,28,68,100,-0.24,0.24
Sibiu,www.news.ro,0,0,3,3,0.0,0.0
Barna Tanczos,primanews.ro,0,0,2,2,0.0,0.0
Tanczos,primanews.ro,0,0,1,1,0.0,0.0
Liviu Voiculescu,www.mediafax.ro,0,0,2,2,0.0,0.0
consilier,www.mediafax.ro,0,3,11,14,-0.21428571428571427,0.21428571428571427
pesedist,www.mediafax.ro,0,1,0,1,-1.0,1.0
primar,www.mediafax.ro,1,17,29,47,-0.3404255319148936,0.3404255319148936
Dumnezeu,www.antena3.ro,2,2,3,7,0.0,0.0
Victor Ponta,www.antena3.ro,0,28,27,55,-0.509090909090909,0.509090909090909
Africa de Sud,snoop.ro,0,0,2,2,0.0,0.0
Australia,snoop.ro,0,0,2,2,0.0,0.0
Australia de Sud,snoop.ro,1,0,0,1,1.0,1.0
avocat,snoop.ro,0,5,16,21,-0.23809523809523808,0.23809523809523808
Bulgaria,snoop.ro,0,0,3,3,0.0,0.0
Canada,snoop.ro,0,0,1,1,0.0,0.0
cercetător,snoop.ro,2,2,12,16,0.0,0.0
Cosmin,snoop.ro,0,0,1,1,0.0,0.0
Gabriel Gheorghe,snoop.ro,0,0,3,3,0.0,0.0
jucător,snoop.ro,0,0,10,10,0.0,0.0
Missouri,snoop.ro,0,0,1,1,0.0,0.0
Natasha Dow Schull,snoop.ro,0,0,1,1,0.0,0.0
Ontario,snoop.ro,0,0,1,1,0.0,0.0
operator,snoop.ro,1,4,2,7,-0.42857142857142855,0.42857142857142855
Pocora,snoop.ro,0,0,1,1,0.0,0.0
Tsvetelina Sokolova,snoop.ro,0,0,1,1,0.0,0.0
apropiat,snoop.ro,0,8,3,11,-0.7272727272727273,0.7272727272727273
autoare,snoop.ro,0,0,2,2,0.0,0.0
celorlalt,snoop.ro,0,1,0,1,-1.0,1.0
client,snoop.ro,1,6,10,17,-0.29411764705882354,0.29411764705882354
consumator,snoop.ro,1,2,4,7,-0.14285714285714285,0.14285714285714285
dependent,snoop.ro,0,4,0,4,-1.0,1.0
expert,snoop.ro,0,8,16,24,-0.3333333333333333,0.3333333333333333
manager,snoop.ro,0,8,10,18,-0.4444444444444444,0.4444444444444444
organizator,snoop.ro,0,1,2,3,-0.3333333333333333,0.3333333333333333
responsabil,snoop.ro,0,1,0,1,-1.0,1.0
surse,snoop.ro,0,1,0,1,-1.0,1.0
tânăr,snoop.ro,0,5,22,27,-0.18518518518518517,0.18518518518518517
utilizator,snoop.ro,0,4,14,18,-0.2222222222222222,0.2222222222222222
America,www.activenews.ro,0,3,1,4,-0.75,0.75
Călin Georgescu,www.activenews.ro,4,13,14,31,-0.2903225806451613,0.2903225806451613
Dagelijkse Standaard,www.activenews.ro,0,1,0,1,-1.0,1.0
Donald Trump,www.activenews.ro,1,16,7,24,-0.625,0.625
Elon Musk,www.activenews.ro,0,2,2,4,-0.5,0.5
Michael van der Galien,www.activenews.ro,0,0,1,1,0.0,0.0
aspirant,www.activenews.ro,0,2,0,2,-1.0,1.0
candidat,www.activenews.ro,0,45,28,73,-0.6164383561643836,0.6164383561643836
dictator,www.activenews.ro,0,2,0,2,-1.0,1.0
judecător,www.activenews.ro,0,8,1,9,-0.8888888888888888,0.8888888888888888
occidental,www.activenews.ro,0,1,0,1,-1.0,1.0
proprietarii,www.activenews.ro,0,1,0,1,-1.0,1.0
tehnocrat,www.activenews.ro,0,2,0,2,-1.0,1.0
tirano,www.activenews.ro,0,1,0,1,-1.0,1.0
Dan Barna,www.mediafax.ro,0,1,4,5,-0.2,0.2
Ludovic Orban,www.mediafax.ro,0,3,7,10,-0.3,0.3
Republica Moldova,www.mediafax.ro,1,1,10,12,0.0,0.0
cetățean,www.mediafax.ro,6,16,16,38,-0.2631578947368421,0.2631578947368421
penal,www.mediafax.ro,0,3,0,3,-1.0,1.0
politician,www.mediafax.ro,0,23,1,24,-0.9583333333333334,0.9583333333333334
șef de stat,www.mediafax.ro,2,3,14,19,-0.05263157894736842,0.05263157894736842
Gaza,www.gandul.ro,0,1,3,4,-0.25,0.25
influencer,www.gandul.ro,0,6,6,12,-0.5,0.5
Ionuț Pătrășcoiu,www.gandul.ro,0,0,2,2,0.0,0.0
Klaus Iohannis,www.gandul.ro,1,6,46,53,-0.09433962264150944,0.09433962264150944
Mircea Geoană,www.gandul.ro,0,4,11,15,-0.26666666666666666,0.26666666666666666
Oradea,www.gandul.ro,0,0,3,3,0.0,0.0
Teleorman,www.gandul.ro,0,1,0,1,-1.0,1.0
Turcia,www.gandul.ro,0,1,4,5,-0.2,0.2
Victor Micula,www.gandul.ro,0,1,0,1,-1.0,1.0
angajat,www.gandul.ro,0,3,1,4,-0.75,0.75
consumator,www.gandul.ro,0,2,1,3,-0.6666666666666666,0.6666666666666666
creator,www.gandul.ro,0,0,3,3,0.0,0.0
luptător,www.gandul.ro,0,1,0,1,-1.0,1.0
public,www.gandul.ro,0,1,1,2,-0.5,0.5
susținător,www.gandul.ro,4,3,9,16,0.0625,0.0625
urmăritor,www.gandul.ro,0,5,0,5,-1.0,1.0
Dragii,www.realitatea.net,0,1,0,1,-1.0,1.0
Elveția,www.realitatea.net,0,0,1,1,0.0,0.0
Statele Unite,www.realitatea.net,2,5,9,16,-0.1875,0.1875
voi,www.realitatea.net,1,1,0,2,0.0,0.0
candidat,www.realitatea.net,2,22,49,73,-0.273972602739726,0.273972602739726
demon,www.realitatea.net,0,1,0,1,-1.0,1.0
diavol,www.realitatea.net,0,1,0,1,-1.0,1.0
răzput,www.realitatea.net,0,1,0,1,-1.0,1.0
salahor,www.realitatea.net,0,1,0,1,-1.0,1.0
suveran,www.realitatea.net,0,8,1,9,-0.8888888888888888,0.8888888888888888
Cluj,www.euronews.ro,0,0,6,6,0.0,0.0
Covasna,www.euronews.ro,0,0,2,2,0.0,0.0
Gorj,www.euronews.ro,0,0,5,5,0.0,0.0
Harghita,www.euronews.ro,0,0,4,4,0.0,0.0
Ilfov,www.euronews.ro,0,0,4,4,0.0,0.0
Mureș,www.euronews.ro,0,0,4,4,0.0,0.0
tânăr,www.euronews.ro,5,3,8,16,0.125,0.125
alegător,www.euronews.ro,0,11,41,52,-0.21153846153846154,0.21153846153846154
harghiteni,www.euronews.ro,0,1,0,1,-1.0,1.0
mulți,www.euronews.ro,0,1,0,1,-1.0,1.0
persoană,www.euronews.ro,2,12,43,57,-0.17543859649122806,0.17543859649122806
populație,www.euronews.ro,1,3,10,14,-0.14285714285714285,0.14285714285714285
Ionuț Moșteanu,www.news.ro,0,1,9,10,-0.1,0.1
actor,agerpres.ro,0,0,4,4,0.0,0.0
adulți,agerpres.ro,0,0,2,2,0.0,0.0
angajat,agerpres.ro,2,0,7,9,0.2222222222222222,0.2222222222222222
investitor,agerpres.ro,6,0,7,13,0.46153846153846156,0.46153846153846156
participant,agerpres.ro,0,0,2,2,0.0,0.0
pasager,agerpres.ro,0,0,4,4,0.0,0.0
persoană,agerpres.ro,0,4,16,20,-0.2,0.2
Ademola Lookman,www.romaniatv.net,0,0,1,1,0.0,0.0
Alejandro Grimaldo,www.romaniatv.net,0,0,1,1,0.0,0.0
Ana Maria Bărbosu,www.romaniatv.net,0,0,1,1,0.0,0.0
Anglia,www.romaniatv.net,0,0,2,2,0.0,0.0
Antonio Rüdiger,www.romaniatv.net,0,0,1,1,0.0,0.0
Argentina,www.romaniatv.net,0,0,1,1,0.0,0.0
Artem Dovbik,www.romaniatv.net,0,0,1,1,0.0,0.0
Brazilia,www.romaniatv.net,0,0,2,2,0.0,0.0
Bukayo Saka,www.romaniatv.net,0,0,1,1,0.0,0.0
Casillas,www.romaniatv.net,0,0,1,1,0.0,0.0
Cole Palmer,www.romaniatv.net,0,0,1,1,0.0,0.0
Dani Carvajal,www.romaniatv.net,0,0,1,1,0.0,0.0
Dani Olmo,www.romaniatv.net,0,0,1,1,0.0,0.0
Declan Rice,www.romaniatv.net,0,0,1,1,0.0,0.0
Elveția,www.romaniatv.net,0,0,1,1,0.0,0.0
Emiliano Martinez,www.romaniatv.net,0,0,1,1,0.0,0.0
Erling Haaland,www.romaniatv.net,0,0,1,1,0.0,0.0
Federico Valverde,www.romaniatv.net,0,0,1,1,0.0,0.0
Florian Wirtz,www.romaniatv.net,0,0,1,1,0.0,0.0
Franța,www.romaniatv.net,0,6,11,17,-0.35294117647058826,0.35294117647058826
George Weah,www.romaniatv.net,0,0,1,1,0.0,0.0
Germania,www.romaniatv.net,0,0,6,6,0.0,0.0
Granit Xhaka,www.romaniatv.net,0,0,1,1,0.0,0.0
Hakan Çalhanoglu,www.romaniatv.net,0,0,1,1,0.0,0.0
Harry Kane,www.romaniatv.net,0,0,1,1,0.0,0.0
Hong Kong,www.romaniatv.net,0,0,1,1,0.0,0.0
Iniesta,www.romaniatv.net,0,0,1,1,0.0,0.0
Jude Bellingham,www.romaniatv.net,0,0,1,1,0.0,0.0
Kylian Mbappé,www.romaniatv.net,0,0,1,1,0.0,0.0
Lamine,www.romaniatv.net,1,0,0,1,1.0,1.0
Lamine Yamal,www.romaniatv.net,0,0,1,1,0.0,0.0
Laura,www.romaniatv.net,1,0,0,1,1.0,1.0
Martin Ödegaard,www.romaniatv.net,0,0,1,1,0.0,0.0
Mats Hummels,www.romaniatv.net,0,0,1,1,0.0,0.0
Nico Williams,www.romaniatv.net,0,0,1,1,0.0,0.0
Nigeria,www.romaniatv.net,0,0,1,1,0.0,0.0
Norvegia,www.romaniatv.net,0,0,1,1,0.0,0.0
Pablo,www.romaniatv.net,2,0,0,2,1.0,1.0
Paris,www.romaniatv.net,0,0,5,5,0.0,0.0
Phil Foden,www.romaniatv.net,0,0,1,1,0.0,0.0
Portugalia,www.romaniatv.net,0,0,4,4,0.0,0.0
Rodri,www.romaniatv.net,1,0,0,1,1.0,1.0
Ruben Dias,www.romaniatv.net,0,0,1,1,0.0,0.0
Simona Halep,www.romaniatv.net,0,0,1,1,0.0,0.0
Spania,www.romaniatv.net,0,0,7,7,0.0,0.0
Toni Kroos,www.romaniatv.net,0,0,1,1,0.0,0.0
Turcia,www.romaniatv.net,0,0,2,2,0.0,0.0
Uruguay,www.romaniatv.net,0,0,1,1,0.0,0.0
Vinicius Junior,www.romaniatv.net,0,0,1,1,0.0,0.0
Vitinha,www.romaniatv.net,0,0,1,1,0.0,0.0
William Saliba,www.romaniatv.net,0,0,1,1,0.0,0.0
Xavi,www.romaniatv.net,0,0,1,1,0.0,0.0
băiat,www.romaniatv.net,0,1,3,4,-0.25,0.25
campion,www.romaniatv.net,1,0,0,1,1.0,1.0
familie,www.romaniatv.net,6,3,6,15,0.2,0.2
fotbalist,www.romaniatv.net,0,0,1,1,0.0,0.0
jucător,www.romaniatv.net,0,0,2,2,0.0,0.0
portar,www.romaniatv.net,0,1,1,2,-0.5,0.5
Didier Drogba,www.romaniatv.net,0,0,1,1,0.0,0.0
prieten,www.romaniatv.net,4,5,3,12,-0.08333333333333333,0.08333333333333333
Luis,www.romaniatv.net,0,1,0,1,-1.0,1.0
Taro Martinez,www.romaniatv.net,0,0,1,1,0.0,0.0
tată,www.romaniatv.net,1,2,2,5,-0.2,0.2
Andrii Yermak,recorder.ro,0,0,1,1,0.0,0.0
Arabia Saudită,recorder.ro,0,1,2,3,-0.3333333333333333,0.3333333333333333
Dmitri Peskov,recorder.ro,0,1,0,1,-1.0,1.0
Donald Trump,recorder.ro,0,29,15,44,-0.6590909090909091,0.6590909090909091
Georgescu,recorder.ro,0,9,5,14,-0.6428571428571429,0.6428571428571429
Herson,recorder.ro,0,0,2,2,0.0,0.0
Jeddah,recorder.ro,0,0,1,1,0.0,0.0
Marco Rubio,recorder.ro,0,0,2,2,0.0,0.0
Moscova,recorder.ro,0,15,4,19,-0.7894736842105263,0.7894736842105263
Odesa,recorder.ro,0,0,1,1,0.0,0.0
Peskov,recorder.ro,0,1,0,1,-1.0,1.0
Rusia,recorder.ro,0,31,9,40,-0.775,0.775
Statele Unite ale Americii,recorder.ro,0,1,2,3,-0.3333333333333333,0.3333333333333333
Sumî,recorder.ro,0,0,2,2,0.0,0.0
Ursula von der Leyen,recorder.ro,0,2,3,5,-0.4,0.4
Vance,recorder.ro,0,1,0,1,-1.0,1.0
Vladimir Putin,recorder.ro,0,16,4,20,-0.8,0.8
Volodimir Zelenski,recorder.ro,0,3,6,9,-0.3333333333333333,0.3333333333333333
Washington,recorder.ro,0,8,6,14,-0.5714285714285714,0.5714285714285714
finanțator,recorder.ro,0,3,0,3,-1.0,1.0
jandarm,recorder.ro,0,9,1,10,-0.9,0.9
opozant,recorder.ro,0,3,0,3,-1.0,1.0
Victor Ponta,recorder.ro,1,8,17,26,-0.2692307692307692,0.2692307692307692
purtător de cuvânt,recorder.ro,0,4,7,11,-0.36363636363636365,0.36363636363636365
Bogdan Loghin,www.cotidianul.ro,0,1,0,1,-1.0,1.0
Gheorghe Șoldan,www.cotidianul.ro,0,0,1,1,0.0,0.0
Ilie Bolojan,www.cotidianul.ro,5,3,27,35,0.05714285714285714,0.05714285714285714
Loghin,www.cotidianul.ro,0,1,0,1,-1.0,1.0
Rădăuți,www.cotidianul.ro,0,0,1,1,0.0,0.0
independent,www.cotidianul.ro,0,0,2,2,0.0,0.0
premier,www.cotidianul.ro,1,15,27,43,-0.32558139534883723,0.32558139534883723
primar,www.cotidianul.ro,1,18,17,36,-0.4722222222222222,0.4722222222222222
Șoldan,www.cotidianul.ro,0,0,1,1,0.0,0.0
Alexandru Muraru,www.comisarul.ro,0,0,1,1,0.0,0.0
Germina Nagâț,www.comisarul.ro,0,1,0,1,-1.0,1.0
Germinei Nagâț,www.comisarul.ro,0,1,0,1,-1.0,1.0
Muraru,www.comisarul.ro,0,1,1,2,-0.5,0.5
colaborator,www.comisarul.ro,0,3,0,3,-1.0,1.0
liberal,www.comisarul.ro,0,3,1,4,-0.75,0.75
prieten,www.comisarul.ro,0,4,4,8,-0.5,0.5
Belgrad,www.digi24.ro,1,3,9,13,-0.15384615384615385,0.15384615384615385
Cătălin Predoiu,www.digi24.ro,1,2,9,12,-0.08333333333333333,0.08333333333333333
Predoiu,www.digi24.ro,0,1,3,4,-0.25,0.25
Serbia,www.digi24.ro,0,4,3,7,-0.5714285714285714,0.5714285714285714
Serb,www.digi24.ro,0,0,3,3,0.0,0.0
public,www.digi24.ro,0,6,4,10,-0.6,0.6
Diana Șoșoacă,a1.ro,0,2,5,7,-0.2857142857142857,0.2857142857142857
oficial,a1.ro,2,8,4,14,-0.42857142857142855,0.42857142857142855
reprezentant,a1.ro,1,5,8,14,-0.2857142857142857,0.2857142857142857
Șoșoacă,a1.ro,0,1,1,2,-0.5,0.5
independenților,www.mediafax.ro,0,1,0,1,-1.0,1.0
Csoma Botond,primanews.ro,0,0,5,5,0.0,0.0
deputat,primanews.ro,0,10,15,25,-0.4,0.4
Ponta,primanews.ro,0,7,1,8,-0.875,0.875
cetățean,primanews.ro,11,3,21,35,0.22857142857142856,0.22857142857142856
om,primanews.ro,17,6,18,41,0.2682926829268293,0.2682926829268293
votant,primanews.ro,0,1,1,2,-0.5,0.5
procuror,a1.ro,0,18,11,29,-0.6206896551724138,0.6206896551724138
Șerban Mihailescu,a1.ro,0,0,2,2,0.0,0.0
Serban Mihăilescu,a1.ro,0,0,1,1,0.0,0.0
ministru coordonator,a1.ro,0,1,0,1,-1.0,1.0
tânăr,a1.ro,1,2,13,16,-0.0625,0.0625
Alex,www.realitatea.net,0,0,1,1,0.0,0.0
Alex Jones,www.realitatea.net,0,1,0,1,-1.0,1.0
Călin,www.realitatea.net,1,0,0,1,1.0,1.0
jurnalist,www.realitatea.net,0,14,6,20,-0.7,0.7
Rusia,www.realitatea.net,0,11,2,13,-0.8461538461538461,0.8461538461538461
Ucraina,www.realitatea.net,1,1,18,20,0.0,0.0
Ursula von der Leyen,www.realitatea.net,0,1,0,1,-1.0,1.0
global,www.realitatea.net,0,1,0,1,-1.0,1.0
spion,www.realitatea.net,0,1,0,1,-1.0,1.0
Boris Johnson,recorder.ro,0,1,0,1,-1.0,1.0
Brașov,recorder.ro,0,1,17,18,-0.05555555555555555,0.05555555555555555
Ghimbav,recorder.ro,0,0,1,1,0.0,0.0
Grecia,recorder.ro,0,0,4,4,0.0,0.0
Marea Britanie,recorder.ro,1,1,9,11,0.0,0.0
imigrant,recorder.ro,0,5,1,6,-0.8333333333333334,0.8333333333333334
preot,recorder.ro,0,5,7,12,-0.4166666666666667,0.4166666666666667
Daniel David,www.news.ro,0,0,2,2,0.0,0.0
Crin Antonescu,www.romaniatv.net,3,14,34,51,-0.21568627450980393,0.21568627450980393
Ilie Bolojan,www.romaniatv.net,2,5,51,58,-0.05172413793103448,0.05172413793103448
Lucian Romașcanu,www.romaniatv.net,0,1,13,14,-0.07142857142857142,0.07142857142857142
Marcel Ciolacu,www.romaniatv.net,3,23,94,120,-0.16666666666666666,0.16666666666666666
Mihnea Costoiu,www.romaniatv.net,0,0,2,2,0.0,0.0
purtător de cuvânt,www.romaniatv.net,0,3,13,16,-0.1875,0.1875
Romașcanu,www.romaniatv.net,0,1,8,9,-0.1111111111111111,0.1111111111111111
alegător,www.romaniatv.net,2,14,18,34,-0.35294117647058826,0.35294117647058826
olac,www.romaniatv.net,0,0,1,1,0.0,0.0
învingător,www.romaniatv.net,4,0,0,4,1.0,1.0
Banciu,www.b1tv.ro,0,1,0,1,-1.0,1.0
Dan Voiculescu,www.b1tv.ro,0,0,1,1,0.0,0.0
Felix,www.b1tv.ro,0,1,0,1,-1.0,1.0
jurnalist,www.b1tv.ro,0,1,2,3,-0.3333333333333333,0.3333333333333333
Radu Banciu,www.b1tv.ro,0,0,2,2,0.0,0.0
nimic,www.b1tv.ro,0,1,0,1,-1.0,1.0
Boc,www.news.ro,0,1,2,3,-0.3333333333333333,0.3333333333333333
Bulgaria,www.news.ro,0,1,2,3,-0.3333333333333333,0.3333333333333333
Costa Rica,www.news.ro,0,0,2,2,0.0,0.0
Elena Udrea,www.news.ro,0,2,1,3,-0.6666666666666666,0.6666666666666666
Elene Udrea,www.news.ro,0,2,0,2,-1.0,1.0
Traian Băsescu,www.news.ro,0,10,11,21,-0.47619047619047616,0.47619047619047616
Udrea,www.news.ro,0,1,0,1,-1.0,1.0
Victor Ponta,www.news.ro,0,24,33,57,-0.42105263157894735,0.42105263157894735
vinovat,www.news.ro,0,2,0,2,-1.0,1.0
Antonescu,www.cotidianul.ro,0,2,12,14,-0.14285714285714285,0.14285714285714285
Elena Lasconi,www.cotidianul.ro,1,3,14,18,-0.1111111111111111,0.1111111111111111
Lasconi,www.cotidianul.ro,0,0,4,4,0.0,0.0
Slatina,www.cotidianul.ro,0,0,3,3,0.0,0.0
ales,www.cotidianul.ro,0,2,0,2,-1.0,1.0
Bolojan,www.news.ro,1,2,20,23,-0.043478260869565216,0.043478260869565216
Cătălin Predoiu,www.news.ro,0,0,6,6,0.0,0.0
Ilie Bolojan,www.news.ro,1,1,41,43,0.0,0.0
vicepremier,www.news.ro,0,0,3,3,0.0,0.0
Crin Antonescu,www.b1tv.ro,2,5,26,33,-0.09090909090909091,0.09090909090909091
Președintele,www.antena3.ro,0,3,1,4,-0.75,0.75
actor,www.antena3.ro,0,2,3,5,-0.4,0.4
actorii,www.antena3.ro,0,0,1,1,0.0,0.0
alegător,www.antena3.ro,0,17,7,24,-0.7083333333333334,0.7083333333333334
Cristi Danileț,www.antena3.ro,0,0,1,1,0.0,0.0
Cristinel Grosu,www.antena3.ro,0,0,1,1,0.0,0.0
persoană,www.antena3.ro,3,6,39,48,-0.0625,0.0625
titular,www.antena3.ro,0,1,3,4,-0.25,0.25
Ciucă,adevarul.ro,0,10,11,21,-0.47619047619047616,0.47619047619047616
Nicolae Ciucă,adevarul.ro,2,12,50,64,-0.15625,0.15625
Băluță,www.comisarul.ro,1,0,5,6,0.16666666666666666,0.16666666666666666
Ceaușescu,www.comisarul.ro,0,3,0,3,-1.0,1.0
Georgescu,www.comisarul.ro,5,13,20,38,-0.21052631578947367,0.21052631578947367
Gheorghe Zaman,www.comisarul.ro,0,0,1,1,0.0,0.0
Ioan Oltean,www.comisarul.ro,0,0,1,1,0.0,0.0
Klaus Iohannis,www.comisarul.ro,0,14,15,29,-0.4827586206896552,0.4827586206896552
Mircea Geoană,www.comisarul.ro,0,1,6,7,-0.14285714285714285,0.14285714285714285
Nicolae Ceaușescu,www.comisarul.ro,0,5,0,5,-1.0,1.0
Octav Cozmâncă,www.comisarul.ro,0,0,1,1,0.0,0.0
Petre Roman,www.comisarul.ro,0,1,0,1,-1.0,1.0
Regatul Unit,www.comisarul.ro,0,0,4,4,0.0,0.0
Roma,www.comisarul.ro,0,1,5,6,-0.16666666666666666,0.16666666666666666
Roman,www.comisarul.ro,0,0,1,1,0.0,0.0
Sergiu Celac,www.comisarul.ro,0,1,1,2,-0.5,0.5
Sorin Frunzăverde,www.comisarul.ro,0,0,1,1,0.0,0.0
Statele Unite,www.comisarul.ro,0,0,11,11,0.0,0.0
ajutor,www.comisarul.ro,0,0,1,1,0.0,0.0
consilier,www.comisarul.ro,0,8,21,29,-0.27586206896551724,0.27586206896551724
lobbyist,www.comisarul.ro,0,1,0,1,-1.0,1.0
Ion Iliescu,www.comisarul.ro,0,2,7,9,-0.2222222222222222,0.2222222222222222
personaj,www.comisarul.ro,0,4,7,11,-0.36363636363636365,0.36363636363636365
primar,www.comisarul.ro,5,31,41,77,-0.33766233766233766,0.33766233766233766
profesionist,www.comisarul.ro,3,0,1,4,0.75,0.75
secretar general,www.comisarul.ro,0,0,7,7,0.0,0.0
traducător,www.comisarul.ro,0,2,0,2,-1.0,1.0
votant,www.comisarul.ro,0,13,18,31,-0.41935483870967744,0.41935483870967744
Ștefan Georgescu,www.comisarul.ro,0,0,1,1,0.0,0.0
Președintele,adevarul.ro,0,0,20,20,0.0,0.0
Dumnezeu,www.euronews.ro,1,0,0,1,1.0,1.0
Klaus Iohannis,www.euronews.ro,2,19,57,78,-0.21794871794871795,0.21794871794871795
cetățean,www.euronews.ro,13,9,16,38,0.10526315789473684,0.10526315789473684
șef,www.euronews.ro,0,24,24,48,-0.5,0.5
Victor Ponta,www.romaniatv.net,1,15,34,50,-0.28,0.28
Ponta,www.romaniatv.net,0,13,9,22,-0.5909090909090909,0.5909090909090909
concetățean,www.activenews.ro,0,0,1,1,0.0,0.0
Constanța,www.activenews.ro,0,0,3,3,0.0,0.0
Gabriela Firea,www.activenews.ro,0,2,5,7,-0.2857142857142857,0.2857142857142857
heterosexual,www.activenews.ro,0,1,1,2,-0.5,0.5
Isus,www.activenews.ro,0,0,1,1,0.0,0.0
Marcel Ciolacu,www.activenews.ro,0,13,11,24,-0.5416666666666666,0.5416666666666666
Natalia Intotero,www.activenews.ro,0,0,1,1,0.0,0.0
Olguța Vasilescu,www.activenews.ro,0,1,0,1,-1.0,1.0
Pilat,www.activenews.ro,0,1,0,1,-1.0,1.0
Ponta,www.activenews.ro,0,6,1,7,-0.8571428571428571,0.8571428571428571
Stoiciu,www.activenews.ro,0,2,0,2,-1.0,1.0
Vasile Dîncu,www.activenews.ro,0,2,2,4,-0.5,0.5
Victoria Stoiciu,www.activenews.ro,0,2,3,5,-0.4,0.4
activistă,www.activenews.ro,0,1,2,3,-0.3333333333333333,0.3333333333333333
adversar,www.activenews.ro,0,4,0,4,-1.0,1.0
ateu,www.activenews.ro,0,1,0,1,-1.0,1.0
bi,www.activenews.ro,0,1,0,1,-1.0,1.0
consultant,www.activenews.ro,0,1,0,1,-1.0,1.0
copil,www.activenews.ro,6,16,14,36,-0.2777777777777778,0.2777777777777778
credincios,www.activenews.ro,2,3,3,8,-0.125,0.125
cuplu,www.activenews.ro,0,2,2,4,-0.5,0.5
duhovnic,www.activenews.ro,0,0,1,1,0.0,0.0
episcop,www.activenews.ro,0,2,0,2,-1.0,1.0
homo,www.activenews.ro,0,0,1,1,0.0,0.0
homosexual,www.activenews.ro,0,9,0,9,-1.0,1.0
lesbiană,www.activenews.ro,0,1,0,1,-1.0,1.0
membru,www.activenews.ro,0,8,15,23,-0.34782608695652173,0.34782608695652173
mulțime,www.activenews.ro,0,4,0,4,-1.0,1.0
participant,www.activenews.ro,0,3,0,3,-1.0,1.0
pesedist,www.activenews.ro,0,1,0,1,-1.0,1.0
politician,www.activenews.ro,0,17,1,18,-0.9444444444444444,0.9444444444444444
popă,www.activenews.ro,0,2,0,2,-1.0,1.0
popor,www.activenews.ro,9,17,8,34,-0.23529411764705882,0.23529411764705882
public,www.activenews.ro,0,2,1,3,-0.6666666666666666,0.6666666666666666
susținătoare,www.activenews.ro,1,1,0,2,0.0,0.0
vicepreședinte,www.activenews.ro,0,4,8,12,-0.3333333333333333,0.3333333333333333
voi,www.activenews.ro,0,1,2,3,-0.3333333333333333,0.3333333333333333
votant,www.activenews.ro,0,3,3,6,-0.5,0.5
autor,www.b1tv.ro,0,0,3,3,0.0,0.0
persoană,www.b1tv.ro,1,8,15,24,-0.2916666666666667,0.2916666666666667
Gîrbovan,www.mediafax.ro,0,0,1,1,0.0,0.0
absolvent,www.mediafax.ro,0,1,1,2,-0.5,0.5
acestia,www.mediafax.ro,0,0,1,1,0.0,0.0
beneficiar,www.mediafax.ro,1,1,3,5,0.0,0.0
Dana Gîrbovan,www.mediafax.ro,0,0,2,2,0.0,0.0
magistrat,www.mediafax.ro,1,8,5,14,-0.5,0.5
personal,www.mediafax.ro,0,3,4,7,-0.42857142857142855,0.42857142857142855
Ardelean,www.gandul.ro,0,0,1,1,0.0,0.0
Ben-Oni Ardelean,www.gandul.ro,0,1,0,1,-1.0,1.0
nemulțumit,www.gandul.ro,0,1,0,1,-1.0,1.0
vicepreședinte,www.gandul.ro,0,1,15,16,-0.0625,0.0625
Adrian Paunescu,adevarul.ro,0,1,0,1,-1.0,1.0
Atena,adevarul.ro,0,1,2,3,-0.3333333333333333,0.3333333333333333
Beijing,adevarul.ro,0,1,0,1,-1.0,1.0
Budapesta,adevarul.ro,0,0,9,9,0.0,0.0
diplomat,adevarul.ro,2,1,6,9,0.1111111111111111,0.1111111111111111
Donca,adevarul.ro,0,1,1,2,-0.5,0.5
George Ciamba,adevarul.ro,0,0,1,1,0.0,0.0
Ioan Donca,adevarul.ro,0,0,1,1,0.0,0.0
Ireny Comaroschi,adevarul.ro,0,0,1,1,0.0,0.0
ambasador,adevarul.ro,2,2,13,17,0.0,0.0
soție,adevarul.ro,0,4,15,19,-0.21052631578947367,0.21052631578947367
București,www.news.ro,0,3,22,25,-0.12,0.12
capitală,www.news.ro,0,1,4,5,-0.2,0.2
conducător,www.news.ro,0,0,1,1,0.0,0.0
Cîrstoiu,www.news.ro,0,0,1,1,0.0,0.0
Cătălin Cîrstoiu,www.news.ro,0,1,4,5,-0.2,0.2
doctor,www.news.ro,0,0,4,4,0.0,0.0
Geană Veronica,www.news.ro,0,1,0,1,-1.0,1.0
Ilfov,www.news.ro,0,0,1,1,0.0,0.0
manager,www.news.ro,0,1,4,5,-0.2,0.2
Mogoșoaia,www.news.ro,0,0,2,2,0.0,0.0
soție,www.news.ro,0,1,5,6,-0.16666666666666666,0.16666666666666666
medic,www.news.ro,1,2,3,6,-0.16666666666666666,0.16666666666666666
membru,www.news.ro,0,15,24,39,-0.38461538461538464,0.38461538461538464
persoană,www.news.ro,3,11,32,46,-0.17391304347826086,0.17391304347826086
profesor,www.news.ro,3,2,6,11,0.09090909090909091,0.09090909090909091
Adrian Ursu,www.antena3.ro,0,0,8,8,0.0,0.0
Banu,www.antena3.ro,0,0,1,1,0.0,0.0
Gina Vacariu,www.antena3.ro,0,0,4,4,0.0,0.0
Mugur Ciuvică,www.antena3.ro,0,0,3,3,0.0,0.0
Muscel,www.antena3.ro,0,0,3,3,0.0,0.0
Oana Zamfir,www.antena3.ro,0,0,2,2,0.0,0.0
Radu Tudor,www.antena3.ro,0,0,4,4,0.0,0.0
Președintele,a1.ro,0,1,4,5,-0.2,0.2
candidat,a1.ro,2,14,98,114,-0.10526315789473684,0.10526315789473684
Coldea,www.realitatea.net,0,1,2,3,-0.3333333333333333,0.3333333333333333
Dubai,www.realitatea.net,0,0,1,1,0.0,0.0
Edi Rama,www.realitatea.net,0,1,0,1,-1.0,1.0
Forian Coldea,www.realitatea.net,0,0,1,1,0.0,0.0
Liviu Tudose,www.realitatea.net,0,1,0,1,-1.0,1.0
maior,www.realitatea.net,0,1,1,2,-0.5,0.5
Marina Pandarof,www.realitatea.net,0,1,0,1,-1.0,1.0
Ponta,www.realitatea.net,0,19,3,22,-0.8636363636363636,0.8636363636363636
Sebastian Ghiță,www.realitatea.net,0,3,0,3,-1.0,1.0
Victor Ponta,www.realitatea.net,0,18,9,27,-0.6666666666666666,0.6666666666666666
blondă,www.realitatea.net,0,0,1,1,0.0,0.0
familie,www.realitatea.net,1,2,3,6,-0.16666666666666666,0.16666666666666666
general,www.realitatea.net,0,2,0,2,-1.0,1.0
Anca Alexandrescu,www.realitatea.net,0,1,7,8,-0.125,0.125
procuror-șef,www.realitatea.net,0,1,0,1,-1.0,1.0
Cristian Terheș,www.romaniatv.net,0,1,2,3,-0.3333333333333333,0.3333333333333333
Dominic Fritz,www.romaniatv.net,0,0,4,4,0.0,0.0
Fritz,www.romaniatv.net,0,0,2,2,0.0,0.0
Olt,www.romaniatv.net,0,1,2,3,-0.3333333333333333,0.3333333333333333
Traian Băsescu,www.romaniatv.net,0,11,9,20,-0.55,0.55
reprezentant,www.romaniatv.net,0,17,27,44,-0.38636363636363635,0.38636363636363635
statistician,www.romaniatv.net,0,0,1,1,0.0,0.0
Augustin Zegrean,pressone.ro,0,0,7,7,0.0,0.0
Florin Roman,pressone.ro,0,2,4,6,-0.3333333333333333,0.3333333333333333
prim-ministru,observatornews.ro,1,2,10,13,-0.07692307692307693,0.07692307692307693
Cătălin Macovei,www.mediafax.ro,0,0,2,2,0.0,0.0
Macovei,www.mediafax.ro,0,0,2,2,0.0,0.0
Mircea Dinescu,www.mediafax.ro,0,0,4,4,0.0,0.0
demnitar,www.mediafax.ro,0,4,1,5,-0.8,0.8
Președintele,www.euronews.ro,0,1,7,8,-0.125,0.125
Băsescu,www.g4media.ro,0,2,0,2,-1.0,1.0
ci,www.g4media.ro,0,1,0,1,-1.0,1.0
Traian Băsescu,www.g4media.ro,0,12,5,17,-0.7058823529411765,0.7058823529411765
Kelemen Hunor,primanews.ro,1,0,10,11,0.09090909090909091,0.09090909090909091
Anei Birchall,primanews.ro,0,0,1,1,0.0,0.0
Cotroceni,primanews.ro,0,0,3,3,0.0,0.0
Cristian Diaconescu,primanews.ro,0,1,1,2,-0.5,0.5
Cristian Terheș,primanews.ro,0,0,4,4,0.0,0.0
Călin Georgescu,primanews.ro,1,3,10,14,-0.14285714285714285,0.14285714285714285
Diana Șoșoacă,primanews.ro,0,0,1,1,0.0,0.0
Elena Lasconi,primanews.ro,0,2,16,18,-0.1111111111111111,0.1111111111111111
Ludovic Orban,primanews.ro,0,1,3,4,-0.25,0.25
Marcel Ciolacu,primanews.ro,0,13,67,80,-0.1625,0.1625
Mircea Geoană,primanews.ro,0,1,5,6,-0.16666666666666666,0.16666666666666666
Miron Cozma,primanews.ro,0,1,0,1,-1.0,1.0
Capitale,www.g4media.ro,0,1,11,12,-0.08333333333333333,0.08333333333333333
Elena Lasconi,www.g4media.ro,2,0,18,20,0.1,0.1
Victor Ponta,www.g4media.ro,0,7,13,20,-0.35,0.35
contracandidat,www.g4media.ro,0,3,3,6,-0.5,0.5
electorat,www.g4media.ro,2,10,9,21,-0.38095238095238093,0.38095238095238093
primar general,www.g4media.ro,0,2,4,6,-0.3333333333333333,0.3333333333333333
respondent,www.g4media.ro,0,0,1,1,0.0,0.0
Carja,www.aktual24.ro,0,1,0,1,-1.0,1.0
Ceaușescu,www.aktual24.ro,0,5,0,5,-1.0,1.0
Codreanu,www.aktual24.ro,0,1,0,1,-1.0,1.0
Corneliu Codreanu,www.aktual24.ro,0,1,1,2,-0.5,0.5
Covid,www.aktual24.ro,0,1,0,1,-1.0,1.0
Dan,www.aktual24.ro,2,3,3,8,-0.125,0.125
Doina Radu,www.aktual24.ro,0,0,1,1,0.0,0.0
Dumitru,www.aktual24.ro,0,1,0,1,-1.0,1.0
Ferentari,www.aktual24.ro,0,1,0,1,-1.0,1.0
Gelu Duminică,www.aktual24.ro,0,0,1,1,0.0,0.0
Grecia,www.aktual24.ro,0,0,3,3,0.0,0.0
JD Vance,www.aktual24.ro,0,1,2,3,-0.3333333333333333,0.3333333333333333
Nicolae Carja,www.aktual24.ro,0,0,1,1,0.0,0.0
Nicolae Ceaușescu,www.aktual24.ro,0,2,0,2,-1.0,1.0
Nicu Dumitru,www.aktual24.ro,0,0,1,1,0.0,0.0
Petre,www.aktual24.ro,0,0,1,1,0.0,0.0
Pirvulescu,www.aktual24.ro,0,0,3,3,0.0,0.0
Portugalia,www.aktual24.ro,0,0,3,3,0.0,0.0
Stefan Serban,www.aktual24.ro,0,0,1,1,0.0,0.0
Donald Trump,www.aktual24.ro,0,17,18,35,-0.4857142857142857,0.4857142857142857
URSS,www.aktual24.ro,0,1,0,1,-1.0,1.0
Ungaria,www.aktual24.ro,0,0,4,4,0.0,0.0
Ungarie,www.aktual24.ro,0,2,1,3,-0.6666666666666666,0.6666666666666666
Viktor Orban,www.aktual24.ro,0,3,0,3,-1.0,1.0
agitator,www.aktual24.ro,0,1,0,1,-1.0,1.0
alegător,www.aktual24.ro,1,39,15,55,-0.6909090909090909,0.6909090909090909
alții,www.aktual24.ro,0,15,3,18,-0.8333333333333334,0.8333333333333334
an,www.aktual24.ro,0,0,1,1,0.0,0.0
angajat,www.aktual24.ro,0,4,7,11,-0.36363636363636365,0.36363636363636365
copil,www.aktual24.ro,8,8,4,20,0.0,0.0
critic,www.aktual24.ro,0,6,0,6,-1.0,1.0
deputat,www.aktual24.ro,2,23,35,60,-0.35,0.35
dezvoltator,www.aktual24.ro,0,2,0,2,-1.0,1.0
dictator,www.aktual24.ro,0,4,0,4,-1.0,1.0
fan,www.aktual24.ro,1,2,1,4,-0.25,0.25
huligan,www.aktual24.ro,0,2,0,2,-1.0,1.0
imion,www.aktual24.ro,0,1,0,1,-1.0,1.0
istoric,www.aktual24.ro,0,4,2,6,-0.6666666666666666,0.6666666666666666
locuitor,www.aktual24.ro,1,5,9,15,-0.26666666666666666,0.26666666666666666
manie,www.aktual24.ro,0,1,1,2,-0.5,0.5
matematician,www.aktual24.ro,0,1,1,2,-0.5,0.5
observator,www.aktual24.ro,0,1,2,3,-0.3333333333333333,0.3333333333333333
pionier,www.aktual24.ro,1,0,0,1,1.0,1.0
politician,www.aktual24.ro,0,30,1,31,-0.967741935483871,0.967741935483871
prieten,www.aktual24.ro,2,6,1,9,-0.4444444444444444,0.4444444444444444
prim,www.aktual24.ro,0,0,1,1,0.0,0.0
provocator,www.aktual24.ro,0,1,0,1,-1.0,1.0
rival,www.aktual24.ro,0,6,0,6,-1.0,1.0
salvator,www.aktual24.ro,1,0,0,1,1.0,1.0
ședință,www.aktual24.ro,0,0,1,1,0.0,0.0
suporter,www.aktual24.ro,0,2,0,2,-1.0,1.0
ultra,www.aktual24.ro,0,1,0,1,-1.0,1.0
ultranationalist,www.aktual24.ro,0,2,0,2,-1.0,1.0
vicepreședinte,www.aktual24.ro,0,4,22,26,-0.15384615384615385,0.15384615384615385
Dragnea,pressone.ro,0,34,9,43,-0.7906976744186046,0.7906976744186046
Emilie Șercan,pressone.ro,0,2,0,2,-1.0,1.0
Iliescu,pressone.ro,0,6,4,10,-0.6,0.6
Ion Rațiu,pressone.ro,1,0,1,2,0.5,0.5
Rațiu,pressone.ro,1,0,0,1,1.0,1.0
Ucraina,pressone.ro,3,16,21,40,-0.325,0.325
Viktor Orban,pressone.ro,0,12,5,17,-0.7058823529411765,0.7058823529411765
Věra Jourová,pressone.ro,0,0,1,1,0.0,0.0
adversar,pressone.ro,0,18,0,18,-1.0,1.0
amic,pressone.ro,2,1,1,4,0.25,0.25
aristocrat,pressone.ro,0,1,0,1,-1.0,1.0
comisar,pressone.ro,0,7,3,10,-0.7,0.7
erou,pressone.ro,4,3,3,10,0.1,0.1
extraterestru,pressone.ro,0,2,0,2,-1.0,1.0
familie,pressone.ro,17,8,24,49,0.1836734693877551,0.1836734693877551
imigrant,pressone.ro,0,8,1,9,-0.8888888888888888,0.8888888888888888
judecător,pressone.ro,0,18,7,25,-0.72,0.72
jurnalist,pressone.ro,7,53,38,98,-0.46938775510204084,0.46938775510204084
măscărici,pressone.ro,0,2,0,2,-1.0,1.0
nou,pressone.ro,0,1,0,1,-1.0,1.0
populație,pressone.ro,0,25,22,47,-0.5319148936170213,0.5319148936170213
premier,pressone.ro,2,42,43,87,-0.45977011494252873,0.45977011494252873
rude,pressone.ro,0,4,3,7,-0.5714285714285714,0.5714285714285714
suporter,pressone.ro,1,4,2,7,-0.42857142857142855,0.42857142857142855
Bulgaria,pressone.ro,0,2,7,9,-0.2222222222222222,0.2222222222222222
China,pressone.ro,0,2,5,7,-0.2857142857142857,0.2857142857142857
Claudiu Năsui,pressone.ro,1,1,4,6,0.0,0.0
Croația,pressone.ro,0,0,2,2,0.0,0.0
Danemarca,pressone.ro,0,0,4,4,0.0,0.0
Donald Trump,pressone.ro,0,21,7,28,-0.75,0.75
Emmanuel Macron,pressone.ro,0,1,3,4,-0.25,0.25
Irlanda,pressone.ro,0,0,1,1,0.0,0.0
Jakkapant,pressone.ro,0,1,0,1,-1.0,1.0
Macron,pressone.ro,0,2,2,4,-0.5,0.5
Malta,pressone.ro,0,0,1,1,0.0,0.0
Mark Rutte,pressone.ro,0,0,1,1,0.0,0.0
Paris,pressone.ro,0,0,6,6,0.0,0.0
salariați,pressone.ro,0,1,0,1,-1.0,1.0
Stochița,pressone.ro,0,0,1,1,0.0,0.0
afacerist,pressone.ro,0,4,0,4,-1.0,1.0
analist,pressone.ro,0,3,14,17,-0.17647058823529413,0.17647058823529413
angajat,pressone.ro,3,19,25,47,-0.3404255319148936,0.3404255319148936
angajator,pressone.ro,0,4,0,4,-1.0,1.0
bugetar,pressone.ro,0,6,0,6,-1.0,1.0
bugetari,pressone.ro,0,1,1,2,-0.5,0.5
cadru didactic,pressone.ro,0,1,9,10,-0.1,0.1
Radu Stochița,pressone.ro,0,0,1,1,0.0,0.0
cumpărător,pressone.ro,0,1,0,1,-1.0,1.0
decident,pressone.ro,0,7,2,9,-0.7777777777777778,0.7777777777777778
elev,pressone.ro,6,6,20,32,0.0,0.0
guvernant,pressone.ro,0,6,0,6,-1.0,1.0
locuitor,pressone.ro,1,8,12,21,-0.3333333333333333,0.3333333333333333
mecanic,pressone.ro,0,2,0,2,-1.0,1.0
medic,pressone.ro,2,16,24,42,-0.3333333333333333,0.3333333333333333
personal,pressone.ro,3,4,12,19,-0.05263157894736842,0.05263157894736842
public,pressone.ro,4,27,20,51,-0.45098039215686275,0.45098039215686275
salariat,pressone.ro,0,1,3,4,-0.25,0.25
salariaț,pressone.ro,0,2,1,3,-0.6666666666666666,0.6666666666666666
Ștefan Guga,pressone.ro,0,0,1,1,0.0,0.0
votant,pressone.ro,1,32,21,54,-0.5740740740740741,0.5740740740740741
Adrian Chesnoiu,www.activenews.ro,0,0,1,1,0.0,0.0
Adrian Câciu,www.activenews.ro,0,0,1,1,0.0,0.0
Alexandru Rafila,www.activenews.ro,0,0,1,1,0.0,0.0
Bogdan Aurescu,www.activenews.ro,0,0,2,2,0.0,0.0
Ciucă,www.activenews.ro,0,7,2,9,-0.7777777777777778,0.7777777777777778
Constantin Cadariu,www.activenews.ro,0,0,1,1,0.0,0.0
Attila Cseke,www.activenews.ro,0,0,1,1,0.0,0.0
Cătălin Predoiu,www.activenews.ro,0,4,7,11,-0.36363636363636365,0.36363636363636365
Dan Vîlceanu,www.activenews.ro,0,0,1,1,0.0,0.0
Eduard Novak,www.activenews.ro,0,0,1,1,0.0,0.0
Florin Pușcaș,www.activenews.ro,0,0,1,1,0.0,0.0
Florin Roman,www.activenews.ro,0,0,1,1,0.0,0.0
Florin Spătaru,www.activenews.ro,0,0,1,1,0.0,0.0
Kelemen Hunor,www.activenews.ro,0,1,4,5,-0.2,0.2
Lucian Bode,www.activenews.ro,0,0,1,1,0.0,0.0
Lucian Romașcanu,www.activenews.ro,0,0,1,1,0.0,0.0
Marius Budăi,www.activenews.ro,0,0,1,1,0.0,0.0
Nicolae Ciucă,www.activenews.ro,0,3,6,9,-0.3333333333333333,0.3333333333333333
prim-ministru,www.activenews.ro,0,0,3,3,0.0,0.0
Sorin Cîmpeanu,www.activenews.ro,0,0,4,4,0.0,0.0
Sorin Grindeanu,www.activenews.ro,0,0,3,3,0.0,0.0
Tanczos Barna,www.activenews.ro,0,1,1,2,-0.5,0.5
vicepremier,www.activenews.ro,0,0,3,3,0.0,0.0
Virgil Popescu,www.activenews.ro,0,0,2,2,0.0,0.0
miniștri,www.activenews.ro,0,3,1,4,-0.75,0.75
Andreea Rotaru,agerpres.ro,0,0,17,17,0.0,0.0
Ciolacu,agerpres.ro,0,13,8,21,-0.6190476190476191,0.6190476190476191
prim-ministru,agerpres.ro,0,1,5,6,-0.16666666666666666,0.16666666666666666
semnatar,agerpres.ro,0,13,0,13,-1.0,1.0
inițiator,agerpres.ro,0,5,4,9,-0.5555555555555556,0.5555555555555556
premier,agerpres.ro,0,5,30,35,-0.14285714285714285,0.14285714285714285
suveranist,agerpres.ro,0,1,0,1,-1.0,1.0
Moldova,www.mediafax.ro,0,0,3,3,0.0,0.0
Ceaușescu,www.news.ro,0,2,0,2,-1.0,1.0
Cristian Preda,www.news.ro,0,0,1,1,0.0,0.0
Decanul,www.news.ro,0,0,1,1,0.0,0.0
Preda,www.news.ro,0,0,1,1,0.0,0.0
lume,www.news.ro,0,6,3,9,-0.6666666666666666,0.6666666666666666
nătărău,www.news.ro,0,1,0,1,-1.0,1.0
om politic,www.news.ro,1,7,1,9,-0.6666666666666666,0.6666666666666666
politician,www.news.ro,0,28,2,30,-0.9333333333333333,0.9333333333333333
secretar de stat,www.news.ro,0,0,4,4,0.0,0.0
specialist,www.news.ro,0,0,4,4,0.0,0.0
Andrzej Duda,observatornews.ro,0,1,0,1,-1.0,1.0
Duda,observatornews.ro,0,1,0,1,-1.0,1.0
Polonia,observatornews.ro,0,1,7,8,-0.125,0.125
Tusk,observatornews.ro,1,0,0,1,1.0,1.0
Varșovia,observatornews.ro,0,1,1,2,-0.5,0.5
aliat,observatornews.ro,1,3,1,5,-0.4,0.4
Donald Tusk,observatornews.ro,0,0,1,1,0.0,0.0
Arad,agerpres.ro,0,0,6,6,0.0,0.0
Gheorghe Falcă,agerpres.ro,0,1,3,4,-0.25,0.25
Marian Buga,agerpres.ro,0,0,7,7,0.0,0.0
București,www.digi24.ro,3,4,24,31,-0.03225806451612903,0.03225806451612903
actorii,www.digi24.ro,0,0,1,1,0.0,0.0
sponsor,www.digi24.ro,0,0,2,2,0.0,0.0
Bolojan,www.mediafax.ro,0,0,3,3,0.0,0.0
Cristian Diaconescu,www.mediafax.ro,0,1,1,2,-0.5,0.5
Anamaria Gavrila,www.aktual24.ro,0,1,4,5,-0.2,0.2
Gavrila,www.aktual24.ro,0,1,2,3,-0.3333333333333333,0.3333333333333333
Sefa,www.aktual24.ro,0,1,1,2,-0.5,0.5
Loredana Diacu,www.aktual24.ro,0,0,2,2,0.0,0.0
Paul Stănescu,www.cotidianul.ro,0,0,4,4,0.0,0.0
secretar general,www.cotidianul.ro,0,1,8,9,-0.1111111111111111,0.1111111111111111
Stănescu,www.cotidianul.ro,0,0,1,1,0.0,0.0
Timi Slicaru,www.cotidianul.ro,0,0,3,3,0.0,0.0
Victor Ponta,www.cotidianul.ro,0,6,6,12,-0.5,0.5
Anastase,www.mediafax.ro,0,0,1,1,0.0,0.0
Roberta Anastase,www.mediafax.ro,0,0,1,1,0.0,0.0
Alin Tișe,stirileprotv.ro,0,0,1,1,0.0,0.0
Uniunea,stirileprotv.ro,1,1,0,2,0.0,0.0
incompetent,stirileprotv.ro,0,1,0,1,-1.0,1.0
individ,stirileprotv.ro,0,2,1,3,-0.6666666666666666,0.6666666666666666
mamă,stirileprotv.ro,0,1,0,1,-1.0,1.0
oportunist,stirileprotv.ro,0,1,0,1,-1.0,1.0
povestitor,stirileprotv.ro,0,1,0,1,-1.0,1.0
Alexander Hamilton,observatornews.ro,1,0,0,1,1.0,1.0
Antony Blinken,observatornews.ro,0,0,2,2,0.0,0.0
Călin Georgescu,observatornews.ro,0,8,19,27,-0.2962962962962963,0.2962962962962963
Emmanuel Macron,observatornews.ro,1,0,6,7,0.14285714285714285,0.14285714285714285
Georgescu,observatornews.ro,0,4,7,11,-0.36363636363636365,0.36363636363636365
Hamilton,observatornews.ro,1,0,0,1,1.0,1.0
stat,observatornews.ro,1,0,1,2,0.5,0.5
câștigător,observatornews.ro,0,1,1,2,-0.5,0.5
jurnalist,observatornews.ro,0,0,12,12,0.0,0.0
părinte,observatornews.ro,1,2,3,6,-0.16666666666666666,0.16666666666666666
secretar de stat,observatornews.ro,0,2,5,7,-0.2857142857142857,0.2857142857142857
Bridget Brink,www.comisarul.ro,0,1,2,3,-0.3333333333333333,0.3333333333333333
Brink,www.comisarul.ro,0,0,1,1,0.0,0.0
Kiev,www.comisarul.ro,2,1,8,11,0.09090909090909091,0.09090909090909091
Volodimir Zelenski,www.comisarul.ro,0,1,7,8,-0.125,0.125
aliat,www.comisarul.ro,0,3,3,6,-0.5,0.5
ambasadoare,www.comisarul.ro,0,0,1,1,0.0,0.0
diplomat,www.comisarul.ro,0,3,2,5,-0.6,0.6
inamic,www.comisarul.ro,0,1,0,1,-1.0,1.0
oră,www.comisarul.ro,0,1,0,1,-1.0,1.0
Joe Biden,www.comisarul.ro,0,0,3,3,0.0,0.0
Caransebeș,www.romaniatv.net,0,0,1,1,0.0,0.0
Culiță Sterp,www.romaniatv.net,0,1,0,1,-1.0,1.0
Eminescu,www.romaniatv.net,0,0,1,1,0.0,0.0
Gheorghe Colcear,www.romaniatv.net,0,0,1,1,0.0,0.0
Hunedoara,www.romaniatv.net,0,0,2,2,0.0,0.0
Ion Stepanescu,www.romaniatv.net,0,1,0,1,-1.0,1.0
manelist,www.romaniatv.net,0,2,0,2,-1.0,1.0
Nicolae Guță,www.romaniatv.net,0,1,0,1,-1.0,1.0
organizator,www.romaniatv.net,0,1,2,3,-0.3333333333333333,0.3333333333333333
Romeo Dunca,www.romaniatv.net,0,0,1,1,0.0,0.0
Stana Stepanescu,www.romaniatv.net,0,1,0,1,-1.0,1.0
cântăreț,www.romaniatv.net,0,1,0,1,-1.0,1.0
fată,www.romaniatv.net,0,1,0,1,-1.0,1.0
invitat,www.romaniatv.net,1,1,1,3,0.0,0.0
minion,www.romaniatv.net,0,0,1,1,0.0,0.0
participant,www.romaniatv.net,0,2,4,6,-0.3333333333333333,0.3333333333333333
primar,www.romaniatv.net,6,23,39,68,-0.25,0.25
simpatizant,www.romaniatv.net,0,7,0,7,-1.0,1.0
susținător,www.romaniatv.net,6,17,16,39,-0.28205128205128205,0.28205128205128205
ta,www.romaniatv.net,0,0,1,1,0.0,0.0
Alina Novăceanu,agerpres.ro,0,0,23,23,0.0,0.0
Andreea Lăzăroiu,agerpres.ro,0,0,13,13,0.0,0.0
Capitale,agerpres.ro,1,0,8,9,0.1111111111111111,0.1111111111111111
Florin Marin,agerpres.ro,0,0,35,35,0.0,0.0
New York,www.euronews.ro,0,0,3,3,0.0,0.0
Donald Trump,a1.ro,0,10,18,28,-0.35714285714285715,0.35714285714285715
Elena Lasconi,a1.ro,3,4,51,58,-0.017241379310344827,0.017241379310344827
Klaus Iohannis,a1.ro,0,4,12,16,-0.25,0.25
Ion Iliescu,a1.ro,0,5,6,11,-0.45454545454545453,0.45454545454545453
luptător,a1.ro,0,1,1,2,-0.5,0.5
Marcel Ciolacu,a1.ro,0,1,39,40,-0.025,0.025
persoană,a1.ro,5,11,28,44,-0.13636363636363635,0.13636363636363635
membru,a1.ro,1,7,37,45,-0.13333333333333333,0.13333333333333333
reclamant,a1.ro,0,1,0,1,-1.0,1.0
revoluționar,a1.ro,0,0,1,1,0.0,0.0
secretar,a1.ro,1,0,8,9,0.1111111111111111,0.1111111111111111
Blaga,www.euronews.ro,0,0,1,1,0.0,0.0
Cătălin Predoiu,www.euronews.ro,2,1,9,12,0.08333333333333333,0.08333333333333333
Băsescu,www.realitatea.net,0,5,1,6,-0.8333333333333334,0.8333333333333334
Kelemen Hunor,www.realitatea.net,0,0,7,7,0.0,0.0
Ramona Ioana Bruynseels,observatornews.ro,0,0,3,3,0.0,0.0
umaniști,observatornews.ro,0,1,0,1,-1.0,1.0
Amărăștii de Jos,recorder.ro,0,1,0,1,-1.0,1.0
Anișoara Stănculescu,recorder.ro,0,0,1,1,0.0,0.0
Bulgaria,recorder.ro,1,1,9,11,0.0,0.0
Cluj,recorder.ro,2,1,24,27,0.037037037037037035,0.037037037037037035
Cosmin Durle,recorder.ro,0,0,1,1,0.0,0.0
Craiova,recorder.ro,0,1,8,9,-0.1111111111111111,0.1111111111111111
Craiovei,recorder.ro,0,0,4,4,0.0,0.0
Cristi Nedelcu,recorder.ro,0,0,1,1,0.0,0.0
da,recorder.ro,0,0,1,1,0.0,0.0
Dan Senor,recorder.ro,0,0,1,1,0.0,0.0
Daniel Sorin Gheba,recorder.ro,0,0,1,1,0.0,0.0
Dolj,recorder.ro,0,0,4,4,0.0,0.0
Doljul,recorder.ro,0,1,0,1,-1.0,1.0
Eliza Peța,recorder.ro,0,1,0,1,-1.0,1.0
Florinel Stancu,recorder.ro,0,0,1,1,0.0,0.0
Gabriel Garcia Marquez,recorder.ro,0,0,3,3,0.0,0.0
George Orwell,recorder.ro,0,0,2,2,0.0,0.0
Ion Prioteasa,recorder.ro,0,0,1,1,0.0,0.0
Ionuț Stroe,recorder.ro,0,0,2,2,0.0,0.0
Iulian Badea,recorder.ro,0,0,1,1,0.0,0.0
jurnal,recorder.ro,5,0,1,6,0.8333333333333334,0.8333333333333334
Keith Hitchins,recorder.ro,0,0,2,2,0.0,0.0
Lugoj,recorder.ro,0,0,3,3,0.0,0.0
Mihai Genoiu,recorder.ro,0,0,1,1,0.0,0.0
Neagu Djuvara Cosmin Poteraș,recorder.ro,0,0,1,1,0.0,0.0
Nicolae Giugea,recorder.ro,0,0,1,1,0.0,0.0
Nicolae Velea,recorder.ro,0,0,1,1,0.0,0.0
Oltenia,recorder.ro,1,1,3,5,0.0,0.0
Pitești,recorder.ro,0,1,3,4,-0.25,0.25
Radu Paraschivescu,recorder.ro,0,0,3,3,0.0,0.0
Saul Singer,recorder.ro,0,0,1,1,0.0,0.0
Severin,recorder.ro,0,1,1,2,-0.5,0.5
Timișoara,recorder.ro,3,0,15,18,0.16666666666666666,0.16666666666666666
Târgu Jiu,recorder.ro,0,0,1,1,0.0,0.0
administrator,recorder.ro,0,8,21,29,-0.27586206896551724,0.27586206896551724
alegător,recorder.ro,2,16,3,21,-0.6666666666666666,0.6666666666666666
ales,recorder.ro,0,8,5,13,-0.6153846153846154,0.6153846153846154
antreprenor,recorder.ro,16,4,20,40,0.3,0.3
asistent,recorder.ro,1,4,15,20,-0.15,0.15
avocat,recorder.ro,2,8,37,47,-0.1276595744680851,0.1276595744680851
beneficiar,recorder.ro,2,6,7,15,-0.26666666666666666,0.26666666666666666
băiat,recorder.ro,1,4,3,8,-0.375,0.375
candidați,recorder.ro,2,9,42,53,-0.1320754716981132,0.1320754716981132
cititor,recorder.ro,27,3,14,44,0.5454545454545454,0.5454545454545454
coleg,recorder.ro,23,19,43,85,0.047058823529411764,0.047058823529411764
comandant,recorder.ro,1,3,3,7,-0.2857142857142857,0.2857142857142857
contabil,recorder.ro,0,0,5,5,0.0,0.0
cătuș,recorder.ro,0,0,1,1,0.0,0.0
dinozaur,recorder.ro,0,0,1,1,0.0,0.0
doljenitor,recorder.ro,0,1,0,1,-1.0,1.0
economist,recorder.ro,1,2,34,37,-0.02702702702702703,0.02702702702702703
elector,recorder.ro,0,0,1,1,0.0,0.0
elev,recorder.ro,12,10,29,51,0.0392156862745098,0.0392156862745098
expert,recorder.ro,2,12,41,55,-0.18181818181818182,0.18181818181818182
fermier,recorder.ro,9,5,11,25,0.16,0.16
intermediar,recorder.ro,0,3,0,3,-1.0,1.0
jurist,recorder.ro,2,1,36,39,0.02564102564102564,0.02564102564102564
jurnalist,recorder.ro,0,18,57,75,-0.24,0.24
Eugen Gioancă,recorder.ro,0,1,0,1,-1.0,1.0
lucrător,recorder.ro,0,0,4,4,0.0,0.0
mecanic,recorder.ro,0,3,1,4,-0.75,0.75
Daea,recorder.ro,0,1,0,1,-1.0,1.0
miniștri,recorder.ro,0,16,2,18,-0.8888888888888888,0.8888888888888888
personal,recorder.ro,6,15,23,44,-0.20454545454545456,0.20454545454545456
popor,recorder.ro,0,7,4,11,-0.6363636363636364,0.6363636363636364
populație,recorder.ro,0,20,23,43,-0.46511627906976744,0.46511627906976744
producător,recorder.ro,7,5,4,16,0.125,0.125
profesor,recorder.ro,5,14,60,79,-0.11392405063291139,0.11392405063291139
părinte,recorder.ro,9,16,38,63,-0.1111111111111111,0.1111111111111111
reprezentant,recorder.ro,2,18,14,34,-0.47058823529411764,0.47058823529411764
s,recorder.ro,0,1,1,2,-0.5,0.5
senator,recorder.ro,0,25,64,89,-0.2808988764044944,0.2808988764044944
specialist,recorder.ro,17,14,31,62,0.04838709677419355,0.04838709677419355
subprefect,recorder.ro,0,1,11,12,-0.08333333333333333,0.08333333333333333
tineret,recorder.ro,4,1,7,12,0.25,0.25
tip,recorder.ro,0,1,0,1,-1.0,1.0
tuturor,recorder.ro,0,0,2,2,0.0,0.0
vecin,recorder.ro,1,3,1,5,-0.4,0.4
Ștefan Bucur Stoica,recorder.ro,0,0,1,1,0.0,0.0
șomer,recorder.ro,0,4,0,4,-1.0,1.0
Adrian Tamplaru,www.aktual24.ro,0,1,0,1,-1.0,1.0
Alex Bodi,www.aktual24.ro,0,1,0,1,-1.0,1.0
Bianca Dragusanu,www.aktual24.ro,0,0,1,1,0.0,0.0
Bodi,www.aktual24.ro,0,1,0,1,-1.0,1.0
Ciolacu,www.aktual24.ro,0,48,35,83,-0.5783132530120482,0.5783132530120482
Claudiu Manda,www.aktual24.ro,0,1,7,8,-0.125,0.125
Craiova,www.aktual24.ro,0,0,6,6,0.0,0.0
Dolj,www.aktual24.ro,0,3,2,5,-0.6,0.6
Laura Vicol,www.aktual24.ro,0,8,3,11,-0.7272727272727273,0.7272727272727273
Lia Olguța Vasilescu,www.aktual24.ro,2,4,3,9,-0.2222222222222222,0.2222222222222222
Olguta Vasilescu,www.aktual24.ro,0,3,8,11,-0.2727272727272727,0.2727272727272727
Manda,www.aktual24.ro,0,0,3,3,0.0,0.0
Marinescu,www.aktual24.ro,0,3,0,3,-1.0,1.0
Nutu Camataru,www.aktual24.ro,0,4,0,4,-1.0,1.0
Olgitei Vasilescu,www.aktual24.ro,0,0,2,2,0.0,0.0
Radu Marinescu,www.aktual24.ro,0,6,2,8,-0.75,0.75
Sile,www.aktual24.ro,0,3,1,4,-0.75,0.75
Tamplaru,www.aktual24.ro,0,1,0,1,-1.0,1.0
Vasilescu,www.aktual24.ro,0,3,2,5,-0.6,0.6
Vicol,www.aktual24.ro,0,4,4,8,-0.5,0.5
Vladimir Ciorba,www.aktual24.ro,0,0,4,4,0.0,0.0
apropiat,www.aktual24.ro,0,8,4,12,-0.6666666666666666,0.6666666666666666
avocat,www.aktual24.ro,0,8,6,14,-0.5714285714285714,0.5714285714285714
beneficiar,www.aktual24.ro,0,4,0,4,-1.0,1.0
client,www.aktual24.ro,0,3,1,4,-0.75,0.75
cuplu,www.aktual24.ro,0,1,2,3,-0.3333333333333333,0.3333333333333333
fin,www.aktual24.ro,0,1,0,1,-1.0,1.0
Guta Vasilescu,www.aktual24.ro,0,1,0,1,-1.0,1.0
inculpat,www.aktual24.ro,0,1,0,1,-1.0,1.0
interlop,www.aktual24.ro,0,2,0,2,-1.0,1.0
iubit,www.aktual24.ro,0,1,0,1,-1.0,1.0
persoană,www.aktual24.ro,7,13,36,56,-0.10714285714285714,0.10714285714285714
revoluționar,www.aktual24.ro,0,2,3,5,-0.4,0.4
șef,www.aktual24.ro,1,48,17,66,-0.7121212121212122,0.7121212121212122
soț,www.aktual24.ro,0,5,5,10,-0.5,0.5
tânăr,www.aktual24.ro,6,7,4,17,-0.058823529411764705,0.058823529411764705
Alexandru Muraru,www.realitatea.net,0,0,1,1,0.0,0.0
Andrei Muraru,www.realitatea.net,0,0,2,2,0.0,0.0
Gheorghe Falcă,www.realitatea.net,0,0,1,1,0.0,0.0
Hațeg,www.realitatea.net,0,0,1,1,0.0,0.0
Ilie Bolojan,www.realitatea.net,0,4,7,11,-0.36363636363636365,0.36363636363636365
Lucian Romașcanu,www.realitatea.net,0,0,1,1,0.0,0.0
Mircea Geoană,www.realitatea.net,0,0,6,6,0.0,0.0
Robert Sighiartău,www.realitatea.net,0,0,1,1,0.0,0.0
Statele Unite ale Americii,www.realitatea.net,1,3,2,6,-0.3333333333333333,0.3333333333333333
"Washington, D.C.",www.realitatea.net,0,1,1,2,-0.5,0.5
mentor,www.realitatea.net,0,0,1,1,0.0,0.0
pastor,www.realitatea.net,0,0,1,1,0.0,0.0
personaj,www.realitatea.net,0,6,1,7,-0.8571428571428571,0.8571428571428571
Andrew Tate,www.comisarul.ro,0,1,1,2,-0.5,0.5
Bruxelles,www.comisarul.ro,0,5,8,13,-0.38461538461538464,0.38461538461538464
București,www.comisarul.ro,3,4,52,59,-0.01694915254237288,0.01694915254237288
contracandidat,www.comisarul.ro,0,23,9,32,-0.71875,0.71875
Dan,www.comisarul.ro,1,0,11,12,0.08333333333333333,0.08333333333333333
detractor,www.comisarul.ro,0,1,0,1,-1.0,1.0
Frații,www.comisarul.ro,0,1,0,1,-1.0,1.0
investitor,www.comisarul.ro,2,3,1,6,-0.16666666666666666,0.16666666666666666
Moscova,www.comisarul.ro,0,3,3,6,-0.5,0.5
matematician,www.comisarul.ro,2,0,1,3,0.6666666666666666,0.6666666666666666
Slovac,www.comisarul.ro,0,0,1,1,0.0,0.0
Tristan Tate,www.comisarul.ro,0,0,2,2,0.0,0.0
admirator,www.comisarul.ro,0,4,1,5,-0.8,0.8
analișt,www.comisarul.ro,0,2,1,3,-0.6666666666666666,0.6666666666666666
câștigător,www.comisarul.ro,1,4,8,13,-0.23076923076923078,0.23076923076923078
frați,www.comisarul.ro,0,1,0,1,-1.0,1.0
influencer,www.comisarul.ro,0,5,4,9,-0.5555555555555556,0.5555555555555556
mulțime,www.comisarul.ro,0,10,0,10,-1.0,1.0
naționalist,www.comisarul.ro,0,1,0,1,-1.0,1.0
Sorin Cucerai,www.comisarul.ro,0,0,1,1,0.0,0.0
Dan Barna,www.comisarul.ro,0,0,2,2,0.0,0.0
profesor,www.comisarul.ro,3,1,11,15,0.13333333333333333,0.13333333333333333
partid,www.comisarul.ro,0,0,1,1,0.0,0.0
reformator,www.comisarul.ro,0,0,1,1,0.0,0.0
susținător,www.comisarul.ro,2,15,20,37,-0.35135135135135137,0.35135135135135137
ultra,www.comisarul.ro,0,1,0,1,-1.0,1.0
vicepreședinte,www.comisarul.ro,0,3,14,17,-0.17647058823529413,0.17647058823529413
Allen Coliban,www.aktual24.ro,0,2,0,2,-1.0,1.0
Chiriches,www.aktual24.ro,0,2,0,2,-1.0,1.0
Ciprian Chiriches,www.aktual24.ro,0,1,0,1,-1.0,1.0
Coliban,www.aktual24.ro,0,1,0,1,-1.0,1.0
consilier local,www.aktual24.ro,0,2,0,2,-1.0,1.0
femeie,www.aktual24.ro,7,1,6,14,0.42857142857142855,0.42857142857142855
George Scripcaru,www.aktual24.ro,1,1,1,3,0.0,0.0
Ghiza,www.aktual24.ro,0,1,0,1,-1.0,1.0
Ilinca,www.aktual24.ro,0,1,1,2,-0.5,0.5
Ilinca Ghiza,www.aktual24.ro,0,1,0,1,-1.0,1.0
Scripcaru,www.aktual24.ro,0,1,0,1,-1.0,1.0
brasovean,www.aktual24.ro,1,0,1,2,0.5,0.5
colegă,www.aktual24.ro,1,1,0,2,0.0,0.0
coleg,www.aktual24.ro,10,8,6,24,0.08333333333333333,0.08333333333333333
consilieră,www.aktual24.ro,0,3,1,4,-0.75,0.75
membru,www.aktual24.ro,5,25,62,92,-0.21739130434782608,0.21739130434782608
primar,www.aktual24.ro,3,31,46,80,-0.35,0.35
Adrian Năstase,stirileprotv.ro,0,0,1,1,0.0,0.0
Berlin,www.gandul.ro,0,0,4,4,0.0,0.0
Bulgaria,www.gandul.ro,0,0,2,2,0.0,0.0
Constantin Brâncuși,www.gandul.ro,0,0,1,1,0.0,0.0
Grecia,www.gandul.ro,0,0,2,2,0.0,0.0
Londra,www.gandul.ro,0,0,3,3,0.0,0.0
Madrid,www.gandul.ro,0,0,1,1,0.0,0.0
Negrescu,www.gandul.ro,0,0,3,3,0.0,0.0
Paris,www.gandul.ro,0,0,7,7,0.0,0.0
Republica Moldova,www.gandul.ro,3,4,13,20,-0.05,0.05
Roma,www.gandul.ro,0,0,3,3,0.0,0.0
Târgu Jiu,www.gandul.ro,0,0,1,1,0.0,0.0
Ungaria,www.gandul.ro,0,0,3,3,0.0,0.0
Washington,www.gandul.ro,0,2,4,6,-0.3333333333333333,0.3333333333333333
Cristian Bușoi,pressone.ro,0,1,6,7,-0.14285714285714285,0.14285714285714285
Câțiva,pressone.ro,0,1,0,1,-1.0,1.0
Dan Barna,pressone.ro,0,2,6,8,-0.25,0.25
Dobrovie,pressone.ro,0,0,1,1,0.0,0.0
Gabriel Vlase,pressone.ro,0,2,4,6,-0.3333333333333333,0.3333333333333333
Găești,pressone.ro,0,0,1,1,0.0,0.0
Ioan Munteanu,pressone.ro,0,0,1,1,0.0,0.0
Ioana Bran,pressone.ro,0,2,1,3,-0.6666666666666666,0.6666666666666666
Liviu Pleșoianu,pressone.ro,0,0,2,2,0.0,0.0
maestru,pressone.ro,0,0,1,1,0.0,0.0
Martin Luther King,pressone.ro,0,0,1,1,0.0,0.0
Matei Dobrovie,pressone.ro,0,0,1,1,0.0,0.0
Niculae Bădălău,pressone.ro,0,0,1,1,0.0,0.0
Nini Săpunaru,pressone.ro,0,0,1,1,0.0,0.0
Orban,pressone.ro,0,9,13,22,-0.4090909090909091,0.4090909090909091
participanți,pressone.ro,1,1,0,2,0.0,0.0
Petre Daea,pressone.ro,0,0,2,2,0.0,0.0
Pleșoianu,pressone.ro,0,0,4,4,0.0,0.0
Raluca Turcan,pressone.ro,0,2,7,9,-0.2222222222222222,0.2222222222222222
Ramona Dinu,pressone.ro,0,1,0,1,-1.0,1.0
reporter,pressone.ro,0,14,30,44,-0.3181818181818182,0.3181818181818182
Roman,pressone.ro,0,2,1,3,-0.6666666666666666,0.6666666666666666
Tudose,pressone.ro,0,9,6,15,-0.6,0.6
Tăriceanu,pressone.ro,0,4,10,14,-0.2857142857142857,0.2857142857142857
Vrancea,pressone.ro,0,1,4,5,-0.2,0.2
băiat,pressone.ro,0,4,10,14,-0.2857142857142857,0.2857142857142857
Cătălin Rădulescu,pressone.ro,0,3,4,7,-0.42857142857142855,0.42857142857142855
fotograf,pressone.ro,1,0,1,2,0.5,0.5
jandarm,pressone.ro,0,8,4,12,-0.6666666666666666,0.6666666666666666
liberal,pressone.ro,0,17,7,24,-0.7083333333333334,0.7083333333333334
mulțime,pressone.ro,0,7,0,7,-1.0,1.0
protestatar,pressone.ro,1,17,8,26,-0.6153846153846154,0.6153846153846154
secretar,pressone.ro,1,2,33,36,-0.027777777777777776,0.027777777777777776
Alina Gorghiu,pressone.ro,0,2,8,10,-0.2,0.2
susținător,pressone.ro,5,25,16,46,-0.43478260869565216,0.43478260869565216
ul,pressone.ro,0,3,3,6,-0.5,0.5
Levente Novak,agerpres.ro,0,0,5,5,0.0,0.0
Novak,agerpres.ro,0,0,1,1,0.0,0.0
alegător,agerpres.ro,2,7,17,26,-0.19230769230769232,0.19230769230769232
chestor,agerpres.ro,0,0,1,1,0.0,0.0
Adrian Câciu,www.romaniatv.net,1,3,0,4,-0.5,0.5
Boc,www.romaniatv.net,0,4,0,4,-1.0,1.0
Boc cel Mare,www.romaniatv.net,0,1,0,1,-1.0,1.0
Bolojan,www.romaniatv.net,2,6,20,28,-0.14285714285714285,0.14285714285714285
Ciucă,www.romaniatv.net,0,6,5,11,-0.5454545454545454,0.5454545454545454
Cluj,www.romaniatv.net,0,0,7,7,0.0,0.0
Crin,www.romaniatv.net,0,2,1,3,-0.6666666666666666,0.6666666666666666
Domnia Sa,www.romaniatv.net,1,0,0,1,1.0,1.0
Tanczos,www.romaniatv.net,1,0,1,2,0.5,0.5
brigadier,www.romaniatv.net,0,1,0,1,-1.0,1.0
bugetar,www.romaniatv.net,0,5,0,5,-1.0,1.0
contabil,www.romaniatv.net,0,1,0,1,-1.0,1.0
călău,www.romaniatv.net,0,1,0,1,-1.0,1.0
ministru,www.romaniatv.net,3,36,37,76,-0.4342105263157895,0.4342105263157895
premiu,www.romaniatv.net,0,1,1,2,-0.5,0.5
Ungureanu,www.mediafax.ro,0,1,1,2,-0.5,0.5
Bogdan Aurescu,a1.ro,0,0,1,1,0.0,0.0
conferențiar,a1.ro,0,0,1,1,0.0,0.0
Danemarca,a1.ro,0,0,1,1,0.0,0.0
Franța,a1.ro,1,0,7,8,0.125,0.125
Germania,a1.ro,0,0,6,6,0.0,0.0
Iași,a1.ro,0,0,3,3,0.0,0.0
Marea Britanie,a1.ro,0,0,2,2,0.0,0.0
Nicolae Ciucă,a1.ro,0,0,11,11,0.0,0.0
Quebec,a1.ro,0,0,1,1,0.0,0.0
Scoția,a1.ro,0,0,1,1,0.0,0.0
Statele Unite,a1.ro,0,1,7,8,-0.125,0.125
Victor Costache,a1.ro,0,0,1,1,0.0,0.0
Victor Sebastian Costache,a1.ro,0,0,1,1,0.0,0.0
director,a1.ro,1,6,12,19,-0.2631578947368421,0.2631578947368421
medic,a1.ro,2,1,5,8,0.125,0.125
pacient,a1.ro,0,0,4,4,0.0,0.0
specialist,a1.ro,2,1,1,4,0.25,0.25
demnitar,www.b1tv.ro,0,4,0,4,-1.0,1.0
Ilie Bolojan,www.b1tv.ro,2,1,6,9,0.1111111111111111,0.1111111111111111
beneficiar,www.b1tv.ro,1,0,1,2,0.5,0.5
consilier,www.b1tv.ro,1,3,1,5,-0.4,0.4
membru,www.b1tv.ro,2,8,13,23,-0.2608695652173913,0.2608695652173913
participant,www.b1tv.ro,0,0,2,2,0.0,0.0
prefect,www.b1tv.ro,0,0,3,3,0.0,0.0
secretar,www.b1tv.ro,0,0,2,2,0.0,0.0
secretar general,www.b1tv.ro,0,2,2,4,-0.5,0.5
subcontract,www.b1tv.ro,0,0,1,1,0.0,0.0
subprefect,www.b1tv.ro,0,0,1,1,0.0,0.0
subsecretar de stat,www.b1tv.ro,0,0,2,2,0.0,0.0
șef,www.b1tv.ro,0,12,5,17,-0.7058823529411765,0.7058823529411765
Ady Ivașcu,agerpres.ro,0,0,21,21,0.0,0.0
Afganistan,agerpres.ro,0,0,1,1,0.0,0.0
Alexander Dobrindt,agerpres.ro,0,0,3,3,0.0,0.0
Andreas Rosskopf,agerpres.ro,0,0,1,1,0.0,0.0
Austria,agerpres.ro,0,0,2,2,0.0,0.0
Bavaria,agerpres.ro,0,0,1,1,0.0,0.0
Dobrindt,agerpres.ro,0,1,0,1,-1.0,1.0
Elveția,agerpres.ro,0,0,1,1,0.0,0.0
Friedrich Merz,agerpres.ro,0,0,2,2,0.0,0.0
Germania,agerpres.ro,0,0,3,3,0.0,0.0
Mariana Ionescu,agerpres.ro,0,0,3,3,0.0,0.0
Nancy Faeser,agerpres.ro,0,0,1,1,0.0,0.0
observator,agerpres.ro,0,0,4,4,0.0,0.0
Polonia,agerpres.ro,0,0,2,2,0.0,0.0
Republica Cehă,agerpres.ro,0,0,1,1,0.0,0.0
Ross,agerpres.ro,0,0,1,1,0.0,0.0
Rosskopf,agerpres.ro,0,1,0,1,-1.0,1.0
Serbia,agerpres.ro,0,0,2,2,0.0,0.0
Siria,agerpres.ro,0,0,2,2,0.0,0.0
Sommer,agerpres.ro,0,0,1,1,0.0,0.0
Turcia,agerpres.ro,0,0,3,3,0.0,0.0
Ungaria,agerpres.ro,0,0,3,3,0.0,0.0
cancelar,agerpres.ro,0,2,0,2,-1.0,1.0
migrant,agerpres.ro,0,3,0,3,-1.0,1.0
personal,agerpres.ro,0,0,3,3,0.0,0.0
politician,agerpres.ro,0,6,1,7,-0.8571428571428571,0.8571428571428571
polițist,agerpres.ro,0,1,1,2,-0.5,0.5
refugiat,agerpres.ro,0,2,0,2,-1.0,1.0
solicitant,agerpres.ro,0,2,0,2,-1.0,1.0
susținător,agerpres.ro,2,1,0,3,0.3333333333333333,0.3333333333333333
vecin,agerpres.ro,0,0,1,1,0.0,0.0
Bruxelles,www.news.ro,0,2,5,7,-0.2857142857142857,0.2857142857142857
Daniel Funeriu,www.news.ro,0,1,12,13,-0.07692307692307693,0.07692307692307693
Las Vegas,www.news.ro,0,0,1,1,0.0,0.0
Liverpool,www.news.ro,0,0,1,1,0.0,0.0
cetățean,www.news.ro,14,5,12,31,0.2903225806451613,0.2903225806451613
copil,www.news.ro,1,3,9,13,-0.15384615384615385,0.15384615384615385
prunc,www.news.ro,0,0,1,1,0.0,0.0
tată,www.news.ro,0,0,2,2,0.0,0.0
tip,www.news.ro,0,1,0,1,-1.0,1.0
Bogdan,www.digi24.ro,0,0,1,1,0.0,0.0
Rareș Bogdan,www.digi24.ro,0,1,6,7,-0.14285714285714285,0.14285714285714285
Silviu Mănăstire,www.digi24.ro,0,0,1,1,0.0,0.0
europarlamentar,www.digi24.ro,1,4,17,22,-0.13636363636363635,0.13636363636363635
invitat,www.digi24.ro,0,0,5,5,0.0,0.0
liberal,www.digi24.ro,1,3,4,8,-0.25,0.25
realizator,www.digi24.ro,0,1,2,3,-0.3333333333333333,0.3333333333333333
secretar,www.digi24.ro,0,4,12,16,-0.25,0.25
Alexandru Visinescu,a1.ro,0,0,1,1,0.0,0.0
Aurora Dumitrescu,a1.ro,0,0,1,1,0.0,0.0
China,a1.ro,0,1,3,4,-0.25,0.25
jurnalist,a1.ro,2,4,7,13,-0.15384615384615385,0.15384615384615385
Remus Cernea,a1.ro,0,1,1,2,-0.5,0.5
Visinescu,a1.ro,0,2,0,2,-1.0,1.0
bărbat,a1.ro,1,4,8,13,-0.23076923076923078,0.23076923076923078
comandant,a1.ro,0,1,1,2,-0.5,0.5
deținut,a1.ro,0,1,0,1,-1.0,1.0
Nicolae,a1.ro,0,1,1,2,-0.5,0.5
soț,a1.ro,0,8,20,28,-0.2857142857142857,0.2857142857142857
t,a1.ro,0,1,0,1,-1.0,1.0
Rozalia Biro,agerpres.ro,1,0,1,2,0.5,0.5
femeie,agerpres.ro,0,0,10,10,0.0,0.0
Capitale,www.news.ro,0,4,18,22,-0.18181818181818182,0.18181818181818182
primar,www.news.ro,1,33,39,73,-0.4383561643835616,0.4383561643835616
bucureștean,www.news.ro,0,0,1,1,0.0,0.0
guvernant,www.news.ro,0,1,0,1,-1.0,1.0
Daniela Malache,agerpres.ro,0,0,3,3,0.0,0.0
edil,agerpres.ro,0,3,0,3,-1.0,1.0
Iași,agerpres.ro,0,0,1,1,0.0,0.0
Mihai Chirica,agerpres.ro,0,0,1,1,0.0,0.0
Elena Lascon,adevarul.ro,0,0,1,1,0.0,0.0
Ionuț Moșteanu,adevarul.ro,0,1,7,8,-0.125,0.125
Moșteanu,adevarul.ro,0,0,3,3,0.0,0.0
Adrian Năstase,www.romaniatv.net,0,3,1,4,-0.75,0.75
Bruxelles,www.romaniatv.net,0,1,7,8,-0.125,0.125
Giorgia Meloni,www.romaniatv.net,0,1,2,3,-0.3333333333333333,0.3333333333333333
Năstase,www.romaniatv.net,0,2,1,3,-0.6666666666666666,0.6666666666666666
Vasile Blaga,www.romaniatv.net,0,3,3,6,-0.5,0.5
garantat,www.romaniatv.net,0,1,0,1,-1.0,1.0
icușor,www.romaniatv.net,0,0,1,1,0.0,0.0
Mircea Florin Andrei,www.luju.ro,0,0,1,1,0.0,0.0
Bruxelles,www.luju.ro,0,4,4,8,-0.5,0.5
București,www.luju.ro,1,4,17,22,-0.13636363636363635,0.13636363636363635
cadru didactic,www.luju.ro,0,0,2,2,0.0,0.0
capitală,www.luju.ro,0,0,2,2,0.0,0.0
Capitale,www.luju.ro,0,3,3,6,-0.5,0.5
Clotilde,www.luju.ro,0,1,0,1,-1.0,1.0
Clotilde Armand,www.luju.ro,0,5,1,6,-0.8333333333333334,0.8333333333333334
Domnia Sa,www.luju.ro,0,1,0,1,-1.0,1.0
Dorin Iacob,www.luju.ro,1,0,0,1,1.0,1.0
Ilfov,www.luju.ro,0,0,7,7,0.0,0.0
Mircea Andrei,www.luju.ro,1,0,1,2,0.5,0.5
Paris,www.luju.ro,0,0,3,3,0.0,0.0
Razvan Savaliuc,www.luju.ro,0,0,1,1,0.0,0.0
Robert Negoita,www.luju.ro,0,1,0,1,-1.0,1.0
analist,www.luju.ro,0,0,1,1,0.0,0.0
angajat,www.luju.ro,0,6,7,13,-0.46153846153846156,0.46153846153846156
arbitru,www.luju.ro,0,0,1,1,0.0,0.0
arendator,www.luju.ro,0,1,0,1,-1.0,1.0
candidat,www.luju.ro,3,41,45,89,-0.42696629213483145,0.42696629213483145
Micea Florin Andrei,www.luju.ro,0,0,1,1,0.0,0.0
cetățean,www.luju.ro,19,10,22,51,0.17647058823529413,0.17647058823529413
coleg,www.luju.ro,6,2,13,21,0.19047619047619047,0.19047619047619047
contracandidat,www.luju.ro,0,5,0,5,-1.0,1.0
contracandidați,www.luju.ro,0,2,0,2,-1.0,1.0
copil,www.luju.ro,2,1,3,6,0.16666666666666666,0.16666666666666666
ctionar,www.luju.ro,0,1,0,1,-1.0,1.0
cumpărător,www.luju.ro,0,2,1,3,-0.6666666666666666,0.6666666666666666
dealer,www.luju.ro,0,2,0,2,-1.0,1.0
dispecerat,www.luju.ro,0,1,0,1,-1.0,1.0
doamna Bruynseels,www.luju.ro,0,1,0,1,-1.0,1.0
Ramona Ioana Bruynseels,www.luju.ro,0,1,0,1,-1.0,1.0
domn,www.luju.ro,0,5,0,5,-1.0,1.0
domnie,www.luju.ro,0,2,0,2,-1.0,1.0
Daniel Tudorache,www.luju.ro,0,1,0,1,-1.0,1.0
George Tuta,www.luju.ro,0,1,0,1,-1.0,1.0
Liviu Negoita,www.luju.ro,0,1,0,1,-1.0,1.0
Hellvig,www.luju.ro,0,1,0,1,-1.0,1.0
ea,www.luju.ro,0,1,1,2,-0.5,0.5
elector,www.luju.ro,0,0,1,1,0.0,0.0
funcționar,www.luju.ro,0,13,1,14,-0.9285714285714286,0.9285714285714286
eu,www.luju.ro,0,1,1,2,-0.5,0.5
inculpat,www.luju.ro,0,30,11,41,-0.7317073170731707,0.7317073170731707
judecător,www.luju.ro,2,75,87,164,-0.4451219512195122,0.4451219512195122
magistrat,www.luju.ro,1,42,30,73,-0.5616438356164384,0.5616438356164384
membru,www.luju.ro,1,25,33,59,-0.4067796610169492,0.4067796610169492
notar,www.luju.ro,0,1,3,4,-0.25,0.25
om,www.luju.ro,11,20,23,54,-0.16666666666666666,0.16666666666666666
ofițer,www.luju.ro,0,3,1,4,-0.75,0.75
organizator,www.luju.ro,0,1,1,2,-0.5,0.5
prieten,www.luju.ro,1,0,3,4,0.25,0.25
primar,www.luju.ro,2,18,9,29,-0.5517241379310345,0.5517241379310345
procuror,www.luju.ro,1,67,36,104,-0.6346153846153846,0.6346153846153846
profesionist,www.luju.ro,4,1,3,8,0.375,0.375
șef,www.luju.ro,0,18,18,36,-0.5,0.5
senator,www.luju.ro,0,4,6,10,-0.4,0.4
tot,www.luju.ro,0,2,1,3,-0.6666666666666666,0.6666666666666666
vecin,www.luju.ro,1,0,0,1,1.0,1.0
votant,www.luju.ro,1,2,0,3,-0.3333333333333333,0.3333333333333333
Barascu,www.luju.ro,0,0,1,1,0.0,0.0
Dragoș Chiriță,www.luju.ro,0,0,1,1,0.0,0.0
Cristea Horia Dorin,www.luju.ro,0,0,1,1,0.0,0.0
CSM,www.luju.ro,0,1,0,1,-1.0,1.0
dumneavoastră,www.luju.ro,2,3,4,9,-0.1111111111111111,0.1111111111111111
Florea Ecaterina,www.luju.ro,0,0,1,1,0.0,0.0
Nina Fotache,www.luju.ro,0,0,1,1,0.0,0.0
Remus Vasilică,www.luju.ro,0,0,1,1,0.0,0.0
Denisa Murariu,www.luju.ro,0,0,1,1,0.0,0.0
Narcadiu,www.luju.ro,0,0,1,1,0.0,0.0
Puscasu,www.luju.ro,0,1,0,1,-1.0,1.0
Ciobanu Andree Lorena,www.luju.ro,0,0,1,1,0.0,0.0
Andreea Ciucă,www.luju.ro,0,0,1,1,0.0,0.0
Laura Maria Dehelean,www.luju.ro,0,0,1,1,0.0,0.0
Raluca Elena Ghita,www.luju.ro,0,1,0,1,-1.0,1.0
Minodora Marincas,www.luju.ro,0,0,1,1,0.0,0.0
Mirlogeanu Mariana,www.luju.ro,0,0,1,1,0.0,0.0
Nechifor Mirela,www.luju.ro,0,0,1,1,0.0,0.0
Necula Mariana,www.luju.ro,0,0,1,1,0.0,0.0
Rusan Christiana Michaela Fraga,www.luju.ro,0,0,1,1,0.0,0.0
SANDOR CAMELIA,www.luju.ro,0,0,1,1,0.0,0.0
Cristian Vasile Dăscălescu,www.luju.ro,0,0,1,1,0.0,0.0
Gherman Lucian Iohan,www.luju.ro,0,0,1,1,0.0,0.0
Petru JUCA,www.luju.ro,0,0,1,1,0.0,0.0
Lazăr Doru Musat,www.luju.ro,0,1,0,1,-1.0,1.0
Vasile Aenoaie,www.luju.ro,0,0,1,1,0.0,0.0
Vrabie Cristian,www.luju.ro,0,1,0,1,-1.0,1.0
Edgar Dumbrau,www.luju.ro,0,0,1,1,0.0,0.0
ist,www.luju.ro,0,1,0,1,-1.0,1.0
judecat,www.luju.ro,0,0,2,2,0.0,0.0
judecătoare,www.luju.ro,2,8,16,26,-0.23076923076923078,0.23076923076923078
Andreea Ciuca,www.luju.ro,0,1,0,1,-1.0,1.0
Voicu Puscasu,www.luju.ro,0,0,1,1,0.0,0.0
timisornic,www.luju.ro,1,0,0,1,1.0,1.0
titular,www.luju.ro,0,0,3,3,0.0,0.0
transportator,www.luju.ro,0,1,0,1,-1.0,1.0
vicepreședinte,www.luju.ro,0,5,13,18,-0.2777777777777778,0.2777777777777778
câștigător,www.g4media.ro,1,2,3,6,-0.16666666666666666,0.16666666666666666
miniștri,www.g4media.ro,0,4,8,12,-0.3333333333333333,0.3333333333333333
Ionut Mosteanu,www.aktual24.ro,0,0,2,2,0.0,0.0
cetățean,www.aktual24.ro,22,8,19,49,0.2857142857142857,0.2857142857142857
e,www.aktual24.ro,0,0,1,1,0.0,0.0
elev,www.aktual24.ro,1,0,2,3,0.3333333333333333,0.3333333333333333
familie,www.aktual24.ro,7,4,4,15,0.2,0.2
functionar,www.aktual24.ro,0,1,0,1,-1.0,1.0
pensionar,www.aktual24.ro,3,1,3,7,0.2857142857142857,0.2857142857142857
președintă,www.aktual24.ro,0,1,9,10,-0.1,0.1
reprezentant,www.aktual24.ro,0,11,25,36,-0.3055555555555556,0.3055555555555556
secretar,www.aktual24.ro,1,7,7,15,-0.4,0.4
student,www.aktual24.ro,0,2,3,5,-0.4,0.4
tot,www.aktual24.ro,2,4,6,12,-0.16666666666666666,0.16666666666666666
Paul Stanescu,www.aktual24.ro,1,5,9,15,-0.26666666666666666,0.26666666666666666
secretar general,www.aktual24.ro,0,2,9,11,-0.18181818181818182,0.18181818181818182
Stanescu,www.aktual24.ro,0,3,1,4,-0.75,0.75
Bogdan Ivan,www.aktual24.ro,0,0,7,7,0.0,0.0
Kelemen,www.aktual24.ro,0,0,1,1,0.0,0.0
Kelemen Hunor,www.aktual24.ro,0,0,9,9,0.0,0.0
Becali,www.news.ro,0,0,5,5,0.0,0.0
Călin Georgescu,www.news.ro,2,7,30,39,-0.1282051282051282,0.1282051282051282
Dan Dungaciu,www.news.ro,1,0,2,3,0.3333333333333333,0.3333333333333333
deputat,www.news.ro,1,7,27,35,-0.17142857142857143,0.17142857142857143
Dungaciu,www.news.ro,1,0,0,1,1.0,1.0
George Becali,www.news.ro,0,1,6,7,-0.14285714285714285,0.14285714285714285
George Simion,www.news.ro,1,8,37,46,-0.15217391304347827,0.15217391304347827
Georgescu,www.news.ro,0,10,10,20,-0.5,0.5
prezidențiabil,www.news.ro,1,0,1,2,0.5,0.5
Cristian Popescu Piedone,www.news.ro,0,1,2,3,-0.3333333333333333,0.3333333333333333
Piedone,www.news.ro,0,1,0,1,-1.0,1.0
Brașov,www.news.ro,0,0,2,2,0.0,0.0
Corneliu Zelea Codreanu,www.news.ro,0,1,0,1,-1.0,1.0
Făgăraș,www.news.ro,0,0,1,1,0.0,0.0
Ion Antonescu,www.news.ro,0,1,0,1,-1.0,1.0
Ion Iliescu,www.news.ro,0,2,4,6,-0.3333333333333333,0.3333333333333333
Marcian Bleahu,www.news.ro,0,0,1,1,0.0,0.0
Ponta,www.news.ro,0,17,9,26,-0.6538461538461539,0.6538461538461539
procuror,www.news.ro,0,5,2,7,-0.7142857142857143,0.7142857142857143
Theodor Stolojan,www.news.ro,0,0,1,1,0.0,0.0
Dan Puric,www.news.ro,0,0,1,1,0.0,0.0
expert,www.news.ro,1,0,5,6,0.16666666666666666,0.16666666666666666
inginer,www.news.ro,0,0,1,1,0.0,0.0
lider,www.news.ro,6,35,89,130,-0.2230769230769231,0.2230769230769231
mareșal,www.news.ro,0,1,0,1,-1.0,1.0
nume,www.news.ro,0,0,1,1,0.0,0.0
secretar,www.news.ro,0,0,11,11,0.0,0.0
Adrian Năstase,recorder.ro,0,4,4,8,-0.5,0.5
Bruxelles,recorder.ro,0,2,35,37,-0.05405405405405406,0.05405405405405406
Ciucă,recorder.ro,0,4,6,10,-0.4,0.4
Dacian Cioloș,recorder.ro,0,1,8,9,-0.1111111111111111,0.1111111111111111
George Maior,recorder.ro,0,0,1,1,0.0,0.0
Ioan Rus,recorder.ro,0,0,1,1,0.0,0.0
Vasile Dîncu,recorder.ro,0,0,3,3,0.0,0.0
Vasile Puscas,recorder.ro,0,1,0,1,-1.0,1.0
afacerist,recorder.ro,0,4,1,5,-0.8,0.8
apropiat,recorder.ro,0,17,6,23,-0.7391304347826086,0.7391304347826086
conducător,recorder.ro,0,9,0,9,-1.0,1.0
coordonator,recorder.ro,0,3,6,9,-0.3333333333333333,0.3333333333333333
doctor,recorder.ro,4,1,19,24,0.125,0.125
eurodeputat,recorder.ro,0,0,18,18,0.0,0.0
europarlamentar,recorder.ro,1,6,24,31,-0.16129032258064516,0.16129032258064516
om politic,recorder.ro,0,4,0,4,-1.0,1.0
observator,recorder.ro,0,3,3,6,-0.5,0.5
prieten,recorder.ro,2,3,6,11,-0.09090909090909091,0.09090909090909091
vicepremier,recorder.ro,0,1,8,9,-0.1111111111111111,0.1111111111111111
aceastia,stirileprotv.ro,1,1,0,2,0.0,0.0
Adrian Severin,stirileprotv.ro,0,1,0,1,-1.0,1.0
ai,stirileprotv.ro,0,2,1,3,-0.6666666666666666,0.6666666666666666
Bruxelles,stirileprotv.ro,0,4,10,14,-0.2857142857142857,0.2857142857142857
procuror,stirileprotv.ro,0,18,5,23,-0.782608695652174,0.782608695652174
Severin,stirileprotv.ro,0,1,0,1,-1.0,1.0
jurnalist,stirileprotv.ro,0,5,14,19,-0.2631578947368421,0.2631578947368421
magistrat,stirileprotv.ro,0,6,12,18,-0.3333333333333333,0.3333333333333333
California,adevarul.ro,0,0,2,2,0.0,0.0
Cristian Terheș,adevarul.ro,0,2,26,28,-0.07142857142857142,0.07142857142857142
Fullerto,adevarul.ro,0,0,1,1,0.0,0.0
Ioan Botezătorul,adevarul.ro,0,0,1,1,0.0,0.0
Oradea,adevarul.ro,0,0,4,4,0.0,0.0
date SQL,adevarul.ro,0,0,1,1,0.0,0.0
Sălaj,adevarul.ro,0,0,3,3,0.0,0.0
Terheș,adevarul.ro,0,2,2,4,-0.5,0.5
Tustin,adevarul.ro,0,0,1,1,0.0,0.0
Zalău,adevarul.ro,0,0,3,3,0.0,0.0
e,adevarul.ro,0,0,1,1,0.0,0.0
preot,adevarul.ro,0,9,13,22,-0.4090909090909091,0.4090909090909091
programator,adevarul.ro,0,0,1,1,0.0,0.0
Chișinău,www.romaniatv.net,0,0,6,6,0.0,0.0
Moldova,www.romaniatv.net,0,1,3,4,-0.25,0.25
republică,www.romaniatv.net,0,0,2,2,0.0,0.0
persoană,www.romaniatv.net,2,24,44,70,-0.3142857142857143,0.3142857142857143
Grindeanu,stirileprotv.ro,0,3,3,6,-0.5,0.5
Sorin Grindeanu,stirileprotv.ro,1,2,10,13,-0.07692307692307693,0.07692307692307693
r,stirileprotv.ro,0,0,1,1,0.0,0.0
Daniel David,www.antena3.ro,0,0,4,4,0.0,0.0
domn,www.antena3.ro,0,2,3,5,-0.4,0.4
populație,www.antena3.ro,0,2,5,7,-0.2857142857142857,0.2857142857142857
rector,www.antena3.ro,0,1,2,3,-0.3333333333333333,0.3333333333333333
București,www.romaniatv.net,2,4,33,39,-0.05128205128205128,0.05128205128205128
Capitale,www.romaniatv.net,1,4,22,27,-0.1111111111111111,0.1111111111111111
Câciu,www.romaniatv.net,0,1,0,1,-1.0,1.0
Dan,www.romaniatv.net,0,3,8,11,-0.2727272727272727,0.2727272727272727
SUA,www.romaniatv.net,0,8,9,17,-0.47058823529411764,0.47058823529411764
Bucureștean,www.romaniatv.net,0,1,0,1,-1.0,1.0
edil,www.romaniatv.net,0,6,3,9,-0.6666666666666666,0.6666666666666666
Klaus Iohannis,www.romaniatv.net,0,18,32,50,-0.36,0.36
Austria,www.news.ro,0,0,1,1,0.0,0.0
prim-ministru,www.news.ro,0,3,5,8,-0.375,0.375
Sofia,www.news.ro,0,0,1,1,0.0,0.0
director,www.comisarul.ro,0,3,14,17,-0.17647058823529413,0.17647058823529413
Elena Lasconi,www.comisarul.ro,0,4,39,43,-0.09302325581395349,0.09302325581395349
Remus Ștefureac,www.comisarul.ro,0,1,5,6,-0.16666666666666666,0.16666666666666666
respondent,www.comisarul.ro,0,0,12,12,0.0,0.0
Ștefureac,www.comisarul.ro,0,0,2,2,0.0,0.0
Klaus Iohannis,www.cotidianul.ro,0,22,24,46,-0.4782608695652174,0.4782608695652174
New York,www.cotidianul.ro,0,0,2,2,0.0,0.0
Roxana Mînzatu,www.cotidianul.ro,1,0,0,1,1.0,1.0
Strasbourg,www.cotidianul.ro,0,0,2,2,0.0,0.0
Ursula von der Leyen,www.cotidianul.ro,1,4,3,8,-0.375,0.375
comisar,www.cotidianul.ro,0,2,0,2,-1.0,1.0
negociator,www.cotidianul.ro,0,1,0,1,-1.0,1.0
vicepreședinte,www.cotidianul.ro,0,3,10,13,-0.23076923076923078,0.23076923076923078
șef,www.cotidianul.ro,0,11,12,23,-0.4782608695652174,0.4782608695652174
șef de stat,www.cotidianul.ro,0,1,0,1,-1.0,1.0
Antonio Costa,primanews.ro,1,0,0,1,1.0,1.0
Bogdan Peșchir,recorder.ro,0,1,1,2,-0.5,0.5
Coreea de Sud,recorder.ro,0,1,3,4,-0.25,0.25
Corneliu Zelea Codreanu,recorder.ro,0,3,1,4,-0.75,0.75
Elena Puiu,recorder.ro,0,1,0,1,-1.0,1.0
Eugen Sechila,recorder.ro,0,0,1,1,0.0,0.0
Victor Ilie,recorder.ro,0,0,2,2,0.0,0.0
Marius Tucă,recorder.ro,0,0,2,2,0.0,0.0
Sec,recorder.ro,0,1,0,1,-1.0,1.0
Tâncăbești,recorder.ro,0,2,0,2,-1.0,1.0
a,recorder.ro,0,1,2,3,-0.3333333333333333,0.3333333333333333
Mihai Stelescu,recorder.ro,0,0,2,2,0.0,0.0
influencer,recorder.ro,0,5,0,5,-1.0,1.0
Ion Antonescu,recorder.ro,0,1,1,2,-0.5,0.5
neolegionar,recorder.ro,0,1,0,1,-1.0,1.0
sfânt,recorder.ro,0,3,0,3,-1.0,1.0
Elecheș,adevarul.ro,0,0,1,1,0.0,0.0
George Pop-Elecheș,adevarul.ro,0,0,1,1,0.0,0.0
Grigore Pop Elecheș,adevarul.ro,0,0,2,2,0.0,0.0
Ion Iliescu,adevarul.ro,0,3,13,16,-0.1875,0.1875
Grigore Pop-Elecheș,adevarul.ro,0,0,2,2,0.0,0.0
Vadim Tudor,adevarul.ro,0,1,3,4,-0.25,0.25
Vadim Tudor Arc,adevarul.ro,0,0,1,1,0.0,0.0
Donald Trump,www.euronews.ro,4,26,18,48,-0.4583333333333333,0.4583333333333333
Gaza,www.euronews.ro,0,1,3,4,-0.25,0.25
Iran,www.euronews.ro,0,4,4,8,-0.5,0.5
Israel,www.euronews.ro,1,14,9,24,-0.5416666666666666,0.5416666666666666
Pontiful,www.euronews.ro,0,0,1,1,0.0,0.0
Qatar,www.euronews.ro,0,1,1,2,-0.5,0.5
Statele Unite,www.euronews.ro,0,6,14,20,-0.3,0.3
Teheran,www.euronews.ro,0,1,2,3,-0.3333333333333333,0.3333333333333333
inspector,www.euronews.ro,0,1,0,1,-1.0,1.0
primar general,www.euronews.ro,0,2,3,5,-0.4,0.4
Al Kamenei,www.euronews.ro,0,1,0,1,-1.0,1.0
Alex Olaru,pressone.ro,0,1,6,7,-0.14285714285714285,0.14285714285714285
Aurelian Surulescu,pressone.ro,0,0,2,2,0.0,0.0
Cerv,pressone.ro,0,0,1,1,0.0,0.0
Chris Terheș,pressone.ro,0,0,1,1,0.0,0.0
Codrin Ștefănescu,pressone.ro,0,0,2,2,0.0,0.0
Codruța,pressone.ro,0,0,1,1,0.0,0.0
Dan Chitic,pressone.ro,0,0,1,1,0.0,0.0
Daniel Dragomir,pressone.ro,0,0,1,1,0.0,0.0
Dragomir,pressone.ro,0,0,2,2,0.0,0.0
elefant,pressone.ro,0,1,0,1,-1.0,1.0
Gheorghe Piperea,pressone.ro,0,4,5,9,-0.4444444444444444,0.4444444444444444
Iosefina Pascal,pressone.ro,0,0,1,1,0.0,0.0
Liviu Florin Albei,pressone.ro,0,0,1,1,0.0,0.0
Marea Britanie,pressone.ro,1,3,10,14,-0.14285714285714285,0.14285714285714285
Maria Grapini,pressone.ro,1,0,8,9,0.1111111111111111,0.1111111111111111
Mihai Lasca,pressone.ro,0,3,0,3,-1.0,1.0
Mirel Palada,pressone.ro,0,0,2,2,0.0,0.0
NOI,pressone.ro,0,0,1,1,0.0,0.0
Oana Lovin,pressone.ro,0,0,1,1,0.0,0.0
Oana Popescu Zamfir,pressone.ro,0,0,3,3,0.0,0.0
Oradea,pressone.ro,1,0,12,13,0.07692307692307693,0.07692307692307693
Pompiliu Diplan,pressone.ro,0,2,0,2,-1.0,1.0
Regatul Țărilor de Jos,pressone.ro,0,0,2,2,0.0,0.0
Silviu Filip,pressone.ro,0,0,1,1,0.0,0.0
actor,pressone.ro,0,9,7,16,-0.5625,0.5625
aliat,pressone.ro,0,5,3,8,-0.625,0.625
cititor,pressone.ro,37,9,5,51,0.5490196078431373,0.5490196078431373
colonel,pressone.ro,0,3,1,4,-0.75,0.75
conducător,pressone.ro,0,15,6,21,-0.7142857142857143,0.7142857142857143
copil,pressone.ro,19,16,41,76,0.039473684210526314,0.039473684210526314
ea,pressone.ro,0,3,1,4,-0.75,0.75
elector,pressone.ro,0,1,5,6,-0.16666666666666666,0.16666666666666666
expert,pressone.ro,5,12,27,44,-0.1590909090909091,0.1590909090909091
frate,pressone.ro,1,8,11,20,-0.35,0.35
eu,pressone.ro,0,5,4,9,-0.5555555555555556,0.5555555555555556
idiot,pressone.ro,0,4,0,4,-1.0,1.0
multor,pressone.ro,0,3,0,3,-1.0,1.0
Nicolae Voiculeț,pressone.ro,0,1,0,1,-1.0,1.0
ori,pressone.ro,0,1,1,2,-0.5,0.5
politolog,pressone.ro,0,3,5,8,-0.375,0.375
promotoare,pressone.ro,0,2,0,2,-1.0,1.0
secretar de stat,pressone.ro,0,1,16,17,-0.058823529411764705,0.058823529411764705
simpatizant,pressone.ro,0,17,7,24,-0.7083333333333334,0.7083333333333334
slugă,pressone.ro,0,2,0,2,-1.0,1.0
străin,pressone.ro,0,10,0,10,-1.0,1.0
țap,pressone.ro,0,1,0,1,-1.0,1.0
ales,adevarul.ro,0,8,2,10,-0.8,0.8
alții,adevarul.ro,0,2,0,2,-1.0,1.0
Paul Pacuraru,adevarul.ro,0,1,1,2,-0.5,0.5
Lucian Crisan,adevarul.ro,0,0,2,2,0.0,0.0
Simona Marinescu,adevarul.ro,1,0,0,1,1.0,1.0
Simonei Marinescu,adevarul.ro,0,0,1,1,0.0,0.0
colegă,adevarul.ro,0,1,3,4,-0.25,0.25
colegiu,adevarul.ro,1,1,0,2,0.0,0.0
damă,adevarul.ro,1,0,0,1,1.0,1.0
fan,adevarul.ro,0,4,2,6,-0.6666666666666666,0.6666666666666666
militant,adevarul.ro,1,0,1,2,0.5,0.5
parlamentar,adevarul.ro,1,23,20,44,-0.5,0.5
Corneliu Bichinet,adevarul.ro,0,1,0,1,-1.0,1.0
Maia Sandu,www.comisarul.ro,0,4,4,8,-0.5,0.5
Republica Moldova,www.comisarul.ro,1,6,16,23,-0.21739130434782608,0.21739130434782608
Lucica Lupascu,www.luju.ro,0,0,1,1,0.0,0.0
Republica Moldova,www.luju.ro,0,4,1,5,-0.8,0.8
Sinaia,www.luju.ro,0,0,1,1,0.0,0.0
Vlad Oprea,www.luju.ro,0,0,1,1,0.0,0.0
edil,www.luju.ro,0,4,1,5,-0.8,0.8
istoric,www.luju.ro,0,0,1,1,0.0,0.0
Valeriu Zgonea,adevarul.ro,0,0,4,4,0.0,0.0
Zgonea,adevarul.ro,0,1,0,1,-1.0,1.0
Antonio Costa,www.antena3.ro,0,0,1,1,0.0,0.0
Bolojan,www.antena3.ro,1,2,9,12,-0.08333333333333333,0.08333333333333333
Ilie Bolojan,www.antena3.ro,5,3,24,32,0.0625,0.0625
Kiev,www.antena3.ro,0,2,0,2,-1.0,1.0
Rusia,www.antena3.ro,0,23,11,34,-0.6764705882352942,0.6764705882352942
Statele Unite,www.antena3.ro,2,3,13,18,-0.05555555555555555,0.05555555555555555
șef de stat,www.antena3.ro,0,0,9,9,0.0,0.0
Dan Vîlceanu,observatornews.ro,0,0,3,3,0.0,0.0
Vîlceanu,observatornews.ro,0,0,1,1,0.0,0.0
familie,observatornews.ro,2,1,7,10,0.1,0.1
lume,observatornews.ro,0,2,2,4,-0.5,0.5
mamă,observatornews.ro,0,2,1,3,-0.6666666666666666,0.6666666666666666
Argeș,snoop.ro,0,0,7,7,0.0,0.0
Cîrstoiu,snoop.ro,0,9,6,15,-0.6,0.6
Cătălin Cîrstoiu,snoop.ro,0,6,11,17,-0.35294117647058826,0.35294117647058826
inspector,snoop.ro,0,9,7,16,-0.5625,0.5625
Mamaia,snoop.ro,0,0,4,4,0.0,0.0
Mihail Geană,snoop.ro,0,0,2,2,0.0,0.0
Mioveni,snoop.ro,0,0,1,1,0.0,0.0
prim-ministru,snoop.ro,0,1,0,1,-1.0,1.0
Sinaia,snoop.ro,0,0,4,4,0.0,0.0
Socrul,snoop.ro,0,0,3,3,0.0,0.0
Veronica Geană,snoop.ro,0,0,1,1,0.0,0.0
familia Cârstoiu,snoop.ro,0,0,1,1,0.0,0.0
familia Cîrstoiu,snoop.ro,0,0,3,3,0.0,0.0
profesor,snoop.ro,0,23,11,34,-0.6764705882352942,0.6764705882352942
rezident,snoop.ro,0,0,11,11,0.0,0.0
tată,snoop.ro,0,8,15,23,-0.34782608695652173,0.34782608695652173
Franța,www.digi24.ro,0,2,9,11,-0.18181818181818182,0.18181818181818182
susținător,www.digi24.ro,1,5,7,13,-0.3076923076923077,0.3076923076923077
Ader Janos,stirileprotv.ro,0,0,1,1,0.0,0.0
Alexander Vershbow,stirileprotv.ro,0,0,1,1,0.0,0.0
Andrei,stirileprotv.ro,0,0,1,1,0.0,0.0
Andrzej Duda,stirileprotv.ro,0,0,1,1,0.0,0.0
Bulgaria,stirileprotv.ro,0,1,2,3,-0.3333333333333333,0.3333333333333333
Dalia Grybauskaitė,stirileprotv.ro,0,0,1,1,0.0,0.0
Georgia,stirileprotv.ro,0,0,2,2,0.0,0.0
Hendrik Ilves,stirileprotv.ro,0,0,1,1,0.0,0.0
Jan Hamáček,stirileprotv.ro,0,0,1,1,0.0,0.0
Kiska,stirileprotv.ro,0,0,1,1,0.0,0.0
Polonia,stirileprotv.ro,0,0,2,2,0.0,0.0
Republica Moldova,stirileprotv.ro,2,2,8,12,0.0,0.0
Raimonds Vejonis,stirileprotv.ro,0,0,1,1,0.0,0.0
Republica Cehă,stirileprotv.ro,0,0,2,2,0.0,0.0
Estonia,stirileprotv.ro,0,0,2,2,0.0,0.0
Republica Letonia,stirileprotv.ro,0,0,1,1,0.0,0.0
Republica Lituania,stirileprotv.ro,1,0,3,4,0.25,0.25
Republica Slovacă,stirileprotv.ro,0,0,1,1,0.0,0.0
Rosen Plevneliev,stirileprotv.ro,0,0,1,1,0.0,0.0
SUA,stirileprotv.ro,1,1,9,11,0.0,0.0
Toomas,stirileprotv.ro,0,0,1,1,0.0,0.0
Ucraina,stirileprotv.ro,2,3,9,14,-0.07142857142857142,0.07142857142857142
Ungarie,stirileprotv.ro,0,1,4,5,-0.2,0.2
Varșovia,stirileprotv.ro,0,0,2,2,0.0,0.0
aliat,stirileprotv.ro,1,0,0,1,1.0,1.0
omolog,stirileprotv.ro,2,0,2,4,0.5,0.5
secretar general,stirileprotv.ro,0,0,13,13,0.0,0.0
șef,stirileprotv.ro,1,33,20,54,-0.5925925925925926,0.5925925925925926
Capitale,www.cotidianul.ro,1,1,7,9,0.0,0.0
Nicoleta Gherasi,agerpres.ro,0,0,8,8,0.0,0.0
consumator,agerpres.ro,0,0,1,1,0.0,0.0
Argeș,www.mediafax.ro,0,0,1,1,0.0,0.0
Isreal,www.mediafax.ro,0,0,1,1,0.0,0.0
Radu Vasile,www.mediafax.ro,0,0,1,1,0.0,0.0
Vasile Lupu,www.mediafax.ro,0,0,1,1,0.0,0.0
profesor,www.mediafax.ro,0,0,5,5,0.0,0.0
secretar,www.mediafax.ro,0,0,9,9,0.0,0.0
senator,www.mediafax.ro,0,10,19,29,-0.3448275862068966,0.3448275862068966
Ion Vela,www.mediafax.ro,0,1,0,1,-1.0,1.0
Dragnea,adevarul.ro,0,1,3,4,-0.25,0.25
Liviu Dragnea,adevarul.ro,0,6,6,12,-0.5,0.5
vicepremier,adevarul.ro,0,2,7,9,-0.2222222222222222,0.2222222222222222
Banias,pressone.ro,0,0,1,1,0.0,0.0
Chedomnul Andreicuț,pressone.ro,0,1,0,1,-1.0,1.0
Dumnezeu,pressone.ro,1,5,5,11,-0.36363636363636365,0.36363636363636365
Gabriel Horia Nasra,pressone.ro,0,0,1,1,0.0,0.0
Ilarie Ivan,pressone.ro,0,0,1,1,0.0,0.0
Le,pressone.ro,0,0,1,1,0.0,0.0
Magheru,pressone.ro,0,0,2,2,0.0,0.0
Nasra,pressone.ro,0,0,1,1,0.0,0.0
Petre Florin Manole,pressone.ro,1,0,3,4,0.25,0.25
Siria,pressone.ro,0,0,2,2,0.0,0.0
Traian Băsescu,pressone.ro,0,12,20,32,-0.375,0.375
Umerii,pressone.ro,0,1,0,1,-1.0,1.0
adult,pressone.ro,0,0,6,6,0.0,0.0
ardelean,pressone.ro,0,0,1,1,0.0,0.0
fată,pressone.ro,0,5,5,10,-0.5,0.5
pesedist,pressone.ro,0,4,0,4,-1.0,1.0
purtător de cuvânt,pressone.ro,1,4,16,21,-0.14285714285714285,0.14285714285714285
spartan,pressone.ro,0,1,0,1,-1.0,1.0
Ciucă,www.digi24.ro,0,6,7,13,-0.46153846153846156,0.46153846153846156
Cotroceni,www.digi24.ro,0,0,4,4,0.0,0.0
Câmpulung,www.digi24.ro,0,0,1,1,0.0,0.0
Peiu,www.cotidianul.ro,0,0,3,3,0.0,0.0
reprezentant,www.cotidianul.ro,0,16,20,36,-0.4444444444444444,0.4444444444444444
senator,www.cotidianul.ro,0,6,19,25,-0.24,0.24
Basist,www.luju.ro,0,1,0,1,-1.0,1.0
Bolojan,www.luju.ro,0,8,0,8,-1.0,1.0
Bolojani,www.luju.ro,0,1,0,1,-1.0,1.0
Ciolaci,www.luju.ro,0,1,0,1,-1.0,1.0
Dragnea,www.luju.ro,0,3,0,3,-1.0,1.0
Franta,www.luju.ro,0,3,3,6,-0.5,0.5
Frantei,www.luju.ro,0,4,1,5,-0.8,0.8
Germania,www.luju.ro,0,2,3,5,-0.4,0.4
Grindeni,www.luju.ro,0,1,0,1,-1.0,1.0
Johannisti,www.luju.ro,0,1,0,1,-1.0,1.0
Liviu Dragnea,www.luju.ro,0,2,3,5,-0.4,0.4
Macron,www.luju.ro,0,3,1,4,-0.75,0.75
Ucraina,www.luju.ro,1,3,5,9,-0.2222222222222222,0.2222222222222222
cantarete,www.luju.ro,0,1,0,1,-1.0,1.0
cantaret,www.luju.ro,0,1,0,1,-1.0,1.0
complic,www.luju.ro,0,2,0,2,-1.0,1.0
jurnalist,www.luju.ro,1,3,4,8,-0.25,0.25
marionetă,www.luju.ro,0,1,0,1,-1.0,1.0
prost,www.luju.ro,0,2,0,2,-1.0,1.0
simpatizant,www.luju.ro,1,5,0,6,-0.6666666666666666,0.6666666666666666
sportiv,www.luju.ro,0,1,2,3,-0.3333333333333333,0.3333333333333333
tu,www.luju.ro,0,0,2,2,0.0,0.0
Călin Georgescu,www.cotidianul.ro,3,8,13,24,-0.20833333333333334,0.20833333333333334
Georgescu,www.cotidianul.ro,1,7,4,12,-0.5,0.5
participanț,www.cotidianul.ro,0,0,2,2,0.0,0.0
susținător,www.cotidianul.ro,0,6,4,10,-0.6,0.6
Daniel David,adevarul.ro,1,0,13,14,0.07142857142857142,0.07142857142857142
David,adevarul.ro,0,0,5,5,0.0,0.0
profesor universitar,adevarul.ro,0,1,4,5,-0.2,0.2
rector,adevarul.ro,0,2,11,13,-0.15384615384615385,0.15384615384615385
Buzău,adevarul.ro,1,0,7,8,0.125,0.125
Cezar Batog Bujeniță,adevarul.ro,0,1,0,1,-1.0,1.0
Lucian Romașcanu,adevarul.ro,0,1,4,5,-0.2,0.2
Mogoșoaia,adevarul.ro,0,0,2,2,0.0,0.0
Romașcanu,adevarul.ro,0,1,3,4,-0.25,0.25
afacerist,adevarul.ro,0,4,2,6,-0.6666666666666666,0.6666666666666666
jurnaliști,adevarul.ro,0,1,0,1,-1.0,1.0
ul,adevarul.ro,0,2,1,3,-0.6666666666666666,0.6666666666666666
Alina Gorghiu,adevarul.ro,0,1,11,12,-0.08333333333333333,0.08333333333333333
Băsescu,adevarul.ro,1,11,4,16,-0.625,0.625
Dacian Cioloș,adevarul.ro,0,3,7,10,-0.3,0.3
Timișoara,adevarul.ro,0,0,10,10,0.0,0.0
Piatra Neamț,www.news.ro,0,0,6,6,0.0,0.0
America,pressone.ro,0,4,6,10,-0.4,0.4
Andrei,pressone.ro,0,0,1,1,0.0,0.0
Andrei Gheorghe,pressone.ro,0,0,1,1,0.0,0.0
Andriușa,pressone.ro,0,0,1,1,0.0,0.0
Australia,pressone.ro,0,0,2,2,0.0,0.0
Becali,pressone.ro,0,1,0,1,-1.0,1.0
Bruce Lee,pressone.ro,1,0,1,2,0.5,0.5
băieți,pressone.ro,0,2,0,2,-1.0,1.0
Cambodgia,pressone.ro,0,0,1,1,0.0,0.0
Ceaușescu,pressone.ro,0,10,0,10,-1.0,1.0
Chișinău,pressone.ro,0,3,3,6,-0.5,0.5
Cichicean,pressone.ro,0,1,0,1,-1.0,1.0
Creangă,pressone.ro,0,0,1,1,0.0,0.0
doctor,pressone.ro,0,6,20,26,-0.23076923076923078,0.23076923076923078
Donnie Yen,pressone.ro,0,0,1,1,0.0,0.0
Eminescu,pressone.ro,0,2,0,2,-1.0,1.0
Esca,pressone.ro,0,1,0,1,-1.0,1.0
Filat,pressone.ro,0,1,0,1,-1.0,1.0
Gaspar Noé,pressone.ro,0,0,1,1,0.0,0.0
Ghimpu,pressone.ro,0,1,0,1,-1.0,1.0
Gordon Liu,pressone.ro,0,0,1,1,0.0,0.0
Hegel,pressone.ro,0,1,1,2,-0.5,0.5
Jet Li,pressone.ro,0,0,1,1,0.0,0.0
Li Lian Jie,pressone.ro,0,0,1,1,0.0,0.0
Lipeț,pressone.ro,0,0,1,1,0.0,0.0
Lor,pressone.ro,0,1,0,1,-1.0,1.0
Lucifer,pressone.ro,0,1,0,1,-1.0,1.0
Lupu,pressone.ro,0,1,1,2,-0.5,0.5
Maia Plisețkaia,pressone.ro,0,1,0,1,-1.0,1.0
Mefistofel,pressone.ro,0,1,0,1,-1.0,1.0
Monica Bellucci,pressone.ro,0,0,1,1,0.0,0.0
Mutu,pressone.ro,0,1,2,3,-0.3333333333333333,0.3333333333333333
Panamahai,pressone.ro,0,0,1,1,0.0,0.0
Rozanov,pressone.ro,0,1,0,1,-1.0,1.0
Serghei Dovlatov,pressone.ro,1,0,0,1,1.0,1.0
Transnistria,pressone.ro,0,2,1,3,-0.6666666666666666,0.6666666666666666
Turcia,pressone.ro,0,1,2,3,-0.3333333333333333,0.3333333333333333
Voronin,pressone.ro,0,1,0,1,-1.0,1.0
Vântu,pressone.ro,0,0,1,1,0.0,0.0
aparat,pressone.ro,0,1,0,1,-1.0,1.0
asistent,pressone.ro,0,7,12,19,-0.3684210526315789,0.3684210526315789
audiență,pressone.ro,1,1,0,2,0.0,0.0
basarabean,pressone.ro,0,1,1,2,-0.5,0.5
bătrân,pressone.ro,0,1,5,6,-0.16666666666666666,0.16666666666666666
băștinaș,pressone.ro,0,1,0,1,-1.0,1.0
cameraman,pressone.ro,0,0,1,1,0.0,0.0
clujean,pressone.ro,1,0,1,2,0.5,0.5
cântăreț,pressone.ro,0,1,1,2,-0.5,0.5
deținător,pressone.ro,0,3,1,4,-0.75,0.75
diavol,pressone.ro,0,1,0,1,-1.0,1.0
emigrant,pressone.ro,0,1,1,2,-0.5,0.5
Ertuğrul Ersoy,pressone.ro,0,1,0,1,-1.0,1.0
expație,pressone.ro,0,1,0,1,-1.0,1.0
freelancer,pressone.ro,0,0,1,1,0.0,0.0
ghiză,pressone.ro,0,1,0,1,-1.0,1.0
imperialist,pressone.ro,0,1,0,1,-1.0,1.0
mogul,pressone.ro,0,3,0,3,-1.0,1.0
moldovean,pressone.ro,0,1,0,1,-1.0,1.0
monșer,pressone.ro,0,1,0,1,-1.0,1.0
omenire,pressone.ro,0,1,2,3,-0.3333333333333333,0.3333333333333333
pacient,pressone.ro,1,9,6,16,-0.5,0.5
patron,pressone.ro,0,12,0,12,-1.0,1.0
proastă,pressone.ro,0,2,0,2,-1.0,1.0
producător,pressone.ro,0,1,1,2,-0.5,0.5
proști,pressone.ro,0,6,0,6,-1.0,1.0
pustnic,pressone.ro,0,1,1,2,-0.5,0.5
păun,pressone.ro,0,1,0,1,-1.0,1.0
ticăloș,pressone.ro,0,1,0,1,-1.0,1.0
voi,pressone.ro,0,0,3,3,0.0,0.0
ăla,pressone.ro,0,2,0,2,-1.0,1.0
America,a1.ro,0,1,4,5,-0.2,0.2
Barron,a1.ro,0,0,5,5,0.0,0.0
Donald,a1.ro,0,0,4,4,0.0,0.0
Florida,a1.ro,0,0,2,2,0.0,0.0
James Barron,a1.ro,0,0,1,1,0.0,0.0
Kamala Harris,a1.ro,0,1,5,6,-0.16666666666666666,0.16666666666666666
Marla Maples,a1.ro,0,2,1,3,-0.6666666666666666,0.6666666666666666
Melania,a1.ro,0,0,7,7,0.0,0.0
Melania Knauss,a1.ro,0,0,1,1,0.0,0.0
Melania Trump,a1.ro,1,1,5,7,0.0,0.0
Mogul,a1.ro,0,1,0,1,-1.0,1.0
New York,a1.ro,0,0,5,5,0.0,0.0
Palm Beach,a1.ro,0,0,2,2,0.0,0.0
Paolo Zampolli,a1.ro,0,0,1,1,0.0,0.0
politică,a1.ro,0,3,4,7,-0.42857142857142855,0.42857142857142855
Primă Doamnă,a1.ro,0,0,1,1,0.0,0.0
SUA,a1.ro,0,1,10,11,-0.09090909090909091,0.09090909090909091
agent,a1.ro,0,1,0,1,-1.0,1.0
copil,a1.ro,9,4,25,38,0.13157894736842105,0.13157894736842105
cuplu,a1.ro,0,0,5,5,0.0,0.0
cuplu prezidențial,a1.ro,0,0,2,2,0.0,0.0
căsătorit,a1.ro,0,0,1,1,0.0,0.0
editorialist,a1.ro,0,1,1,2,-0.5,0.5
femeie,a1.ro,7,4,8,19,0.15789473684210525,0.15789473684210525
invitat,a1.ro,0,4,3,7,-0.5714285714285714,0.5714285714285714
modeling,a1.ro,0,0,1,1,0.0,0.0
model,a1.ro,0,2,0,2,-1.0,1.0
Emil Hurezeanu,www.g4media.ro,0,1,5,6,-0.16666666666666666,0.16666666666666666
Gabriel Andronache,www.g4media.ro,0,0,2,2,0.0,0.0
inițiator,www.g4media.ro,0,5,1,6,-0.8333333333333334,0.8333333333333334
Mircea Dinescu,www.gandul.ro,0,0,1,1,0.0,0.0
bunică,www.gandul.ro,1,0,1,2,0.5,0.5
protestatar,www.cotidianul.ro,0,2,3,5,-0.4,0.4
Adrian Veștea,www.romaniatv.net,0,0,2,2,0.0,0.0
Adrian Țuțuianu,www.romaniatv.net,0,1,0,1,-1.0,1.0
Bogdan Ivan,www.romaniatv.net,0,1,4,5,-0.2,0.2
Carmen Avram,www.romaniatv.net,0,1,0,1,-1.0,1.0
Daniel Constantin,www.romaniatv.net,0,1,0,1,-1.0,1.0
Gabriel Mutu,www.romaniatv.net,0,0,1,1,0.0,0.0
George Stângă,www.romaniatv.net,0,1,0,1,-1.0,1.0
Ligia Deca,www.romaniatv.net,0,1,1,2,-0.5,0.5
Lucian Bode,www.romaniatv.net,0,0,1,1,0.0,0.0
Marcel Vela,www.romaniatv.net,0,0,1,1,0.0,0.0
Radu Oprea,www.romaniatv.net,0,1,1,2,-0.5,0.5
Sorin Grindeanu,www.romaniatv.net,0,3,5,8,-0.375,0.375
Virgil Guran,www.romaniatv.net,0,0,1,1,0.0,0.0
europarlamentară,www.romaniatv.net,0,1,0,1,-1.0,1.0
interimar,www.romaniatv.net,0,2,1,3,-0.6666666666666666,0.6666666666666666
oficial,www.romaniatv.net,0,4,2,6,-0.6666666666666666,0.6666666666666666
parlamentar,www.romaniatv.net,2,27,15,44,-0.5681818181818182,0.5681818181818182
Florin Cîțu,www.romaniatv.net,0,1,1,2,-0.5,0.5
secretar general,www.romaniatv.net,0,1,1,2,-0.5,0.5
Costel Fotea,recorder.ro,0,0,1,1,0.0,0.0
Daniela Ancuța Șarpe,recorder.ro,0,0,1,1,0.0,0.0
Doru Căstăian,recorder.ro,1,0,4,5,0.2,0.2
Galați,recorder.ro,0,3,11,14,-0.21428571428571427,0.21428571428571427
inspector,recorder.ro,0,8,16,24,-0.3333333333333333,0.3333333333333333
Ionuț Pucheanu,recorder.ro,0,1,0,1,-1.0,1.0
Marius Stan,recorder.ro,0,1,1,2,-0.5,0.5
Onuț Valeriu Atanasiu,recorder.ro,0,0,2,2,0.0,0.0
Petrișor Potec,recorder.ro,0,0,1,1,0.0,0.0
cadru didactic,recorder.ro,3,5,18,26,-0.07692307692307693,0.07692307692307693
de,recorder.ro,0,0,2,2,0.0,0.0
decan,recorder.ro,0,1,3,4,-0.25,0.25
formator,recorder.ro,1,1,1,3,0.0,0.0
muncipiu,recorder.ro,0,0,1,1,0.0,0.0
prorector,recorder.ro,0,0,3,3,0.0,0.0
publicist,recorder.ro,0,0,1,1,0.0,0.0
George Stângă,recorder.ro,0,0,1,1,0.0,0.0
vicepreședinte,recorder.ro,1,6,42,49,-0.10204081632653061,0.10204081632653061
Franklin D. Roosevelt,www.gandul.ro,0,0,1,1,0.0,0.0
George Simion,www.gandul.ro,1,5,26,32,-0.125,0.125
Simion,www.gandul.ro,0,4,8,12,-0.3333333333333333,0.3333333333333333
conducător,www.gandul.ro,0,2,0,2,-1.0,1.0
copil,www.gandul.ro,4,4,6,14,0.0,0.0
persoană,www.gandul.ro,3,4,38,45,-0.022222222222222223,0.022222222222222223
proprietar,www.gandul.ro,0,4,0,4,-1.0,1.0
tătic,www.gandul.ro,0,0,1,1,0.0,0.0
,www.luju.ro,0,3,4,7,-0.42857142857142855,0.42857142857142855
BA,www.luju.ro,0,0,1,1,0.0,0.0
Cătălina,www.luju.ro,0,1,0,1,-1.0,1.0
Ciorba Vladimir Răzvan,www.luju.ro,0,0,1,1,0.0,0.0
Ciorba,www.luju.ro,0,0,1,1,0.0,0.0
Ciorba Vladimir Razvan,www.luju.ro,0,0,1,1,0.0,0.0
Dan Moraru,www.luju.ro,0,1,1,2,-0.5,0.5
Dimir Razvan,www.luju.ro,0,0,1,1,0.0,0.0
Elena Barbu,www.luju.ro,0,1,2,3,-0.3333333333333333,0.3333333333333333
Ivan George Marian,www.luju.ro,0,1,0,1,-1.0,1.0
Mihail Udroiu,www.luju.ro,0,0,2,2,0.0,0.0
Oana Oprea,www.luju.ro,0,1,0,1,-1.0,1.0
Florin Alexandru Postoaca,www.luju.ro,0,0,1,1,0.0,0.0
Gheorghe Emanuel Postoacă,www.luju.ro,0,1,0,1,-1.0,1.0
Nicolae Cristian Postoaca,www.luju.ro,0,0,1,1,0.0,0.0
Sanda Raileanu,www.luju.ro,0,0,2,2,0.0,0.0
Răzvan,www.luju.ro,0,1,0,1,-1.0,1.0
Saitos Bogdan Adalbert,www.luju.ro,0,1,0,1,-1.0,1.0
Toaca Gheorghe Emanuel,www.luju.ro,0,1,0,1,-1.0,1.0
VAN,www.luju.ro,0,0,1,1,0.0,0.0
VI,www.luju.ro,0,0,1,1,0.0,0.0
Vicol Ciorbă Laura-Catalina,www.luju.ro,0,0,1,1,0.0,0.0
acestia,www.luju.ro,0,2,7,9,-0.2222222222222222,0.2222222222222222
beneficiar,www.luju.ro,0,6,6,12,-0.5,0.5
client,www.luju.ro,0,1,1,2,-0.5,0.5
contribuabil,www.luju.ro,0,5,5,10,-0.5,0.5
hot,www.luju.ro,0,2,0,2,-1.0,1.0
Ciorba Vladimir,www.luju.ro,0,1,0,1,-1.0,1.0
Ciorba Razvan Vladimir,www.luju.ro,0,1,0,1,-1.0,1.0
Manuela Manu,www.luju.ro,0,1,0,1,-1.0,1.0
oară,www.luju.ro,0,0,1,1,0.0,0.0
persoană,www.luju.ro,2,25,57,84,-0.27380952380952384,0.27380952380952384
reprezentant,www.luju.ro,5,10,11,26,-0.19230769230769232,0.19230769230769232
Cosmin Muntean,a1.ro,0,0,1,1,0.0,0.0
Petrosani,a1.ro,0,0,1,1,0.0,0.0
purtător de cuvânt,a1.ro,0,0,8,8,0.0,0.0
Teo Trandafir,a1.ro,0,1,2,3,-0.3333333333333333,0.3333333333333333
Valentin Popescu,a1.ro,0,2,0,2,-1.0,1.0
judecător,a1.ro,0,7,14,21,-0.3333333333333333,0.3333333333333333
Albania,stirileprotv.ro,0,0,1,1,0.0,0.0
Bosnia și Herțegovina,stirileprotv.ro,0,1,1,2,-0.5,0.5
Dubrovnik,stirileprotv.ro,0,0,1,1,0.0,0.0
Federația Rusă,stirileprotv.ro,0,3,0,3,-1.0,1.0
Franța,stirileprotv.ro,1,0,2,3,0.3333333333333333,0.3333333333333333
Japonia,stirileprotv.ro,0,0,3,3,0.0,0.0
Ljubljana,stirileprotv.ro,0,0,1,1,0.0,0.0
Macedonia de Nord,stirileprotv.ro,0,0,1,1,0.0,0.0
Regatul Unit,stirileprotv.ro,0,0,1,1,0.0,0.0
Republica Austria,stirileprotv.ro,0,0,1,1,0.0,0.0
Republica Bulgaria,stirileprotv.ro,0,0,1,1,0.0,0.0
Republica Croația,stirileprotv.ro,0,0,1,1,0.0,0.0
Republica Elenă,stirileprotv.ro,1,0,0,1,1.0,1.0
Germania,stirileprotv.ro,0,0,7,7,0.0,0.0
Letonia,stirileprotv.ro,0,0,1,1,0.0,0.0
Republica Polonă,stirileprotv.ro,0,0,1,1,0.0,0.0
Slovacia,stirileprotv.ro,0,0,1,1,0.0,0.0
Republica Slovenia,stirileprotv.ro,0,0,1,1,0.0,0.0
Turcia,stirileprotv.ro,0,1,2,3,-0.3333333333333333,0.3333333333333333
Riga,stirileprotv.ro,0,0,1,1,0.0,0.0
Rusia,stirileprotv.ro,0,11,3,14,-0.7857142857142857,0.7857142857142857
Sofia,stirileprotv.ro,0,0,2,2,0.0,0.0
Statele Unite ale Americii,stirileprotv.ro,0,0,5,5,0.0,0.0
Statele Unite,stirileprotv.ro,1,1,6,8,0.0,0.0
Tallinn,stirileprotv.ro,0,0,1,1,0.0,0.0
Ungaria,stirileprotv.ro,0,0,3,3,0.0,0.0
Veneția,stirileprotv.ro,0,0,1,1,0.0,0.0
angajat,stirileprotv.ro,0,2,3,5,-0.4,0.4
aspirant,stirileprotv.ro,1,0,0,1,1.0,1.0
invitat,stirileprotv.ro,0,0,3,3,0.0,0.0
lider de stat,stirileprotv.ro,0,0,1,1,0.0,0.0
participanț,stirileprotv.ro,1,0,1,2,0.5,0.5
popor,stirileprotv.ro,1,3,1,5,-0.4,0.4
sponsor,stirileprotv.ro,0,0,1,1,0.0,0.0
vecin,stirileprotv.ro,1,1,1,3,0.0,0.0
Ciucă,www.euronews.ro,0,3,17,20,-0.15,0.15
Nicolae Ciucă,www.euronews.ro,0,10,36,46,-0.21739130434782608,0.21739130434782608
premier,www.euronews.ro,0,10,90,100,-0.1,0.1
vicepremier,www.euronews.ro,0,1,5,6,-0.16666666666666666,0.16666666666666666
Danie Funeriu,www.news.ro,0,0,1,1,0.0,0.0
Republica Moldova,www.news.ro,3,2,7,12,0.08333333333333333,0.08333333333333333
Alexandra Pandrea,www.gandul.ro,0,0,4,4,0.0,0.0
Serb,www.gandul.ro,0,0,3,3,0.0,0.0
Victor Ponta,www.gandul.ro,1,12,17,30,-0.36666666666666664,0.36666666666666664
Vlad Gheorghe,www.gandul.ro,0,0,1,1,0.0,0.0
Adrian Marius Dobre,recorder.ro,0,0,1,1,0.0,0.0
Alin Bogdan Drăgulin,recorder.ro,0,0,1,1,0.0,0.0
Ciprian Pandea,recorder.ro,0,0,1,1,0.0,0.0
Constantin Bîrcă,recorder.ro,0,0,1,1,0.0,0.0
Costin Mirescu,recorder.ro,0,0,1,1,0.0,0.0
Covid,recorder.ro,0,3,2,5,-0.6,0.6
Cristian Eremia,recorder.ro,0,0,1,1,0.0,0.0
Călărași,recorder.ro,0,1,4,5,-0.2,0.2
călăraș,recorder.ro,0,1,1,2,-0.5,0.5
Dumitru Coarnă,recorder.ro,0,0,1,1,0.0,0.0
Florian Emil Dumitru,recorder.ro,0,0,1,1,0.0,0.0
India,recorder.ro,0,0,1,1,0.0,0.0
Jon Kalman Stefansson,recorder.ro,0,0,1,1,0.0,0.0
Nicolae Pandea,recorder.ro,0,0,1,1,0.0,0.0
Nicușor Cionoiu,recorder.ro,0,0,1,1,0.0,0.0
Oltenița,recorder.ro,0,0,1,1,0.0,0.0
Panayotis,recorder.ro,0,0,1,1,0.0,0.0
Petru Popescu,recorder.ro,0,0,2,2,0.0,0.0
Președintele,recorder.ro,0,0,1,1,0.0,0.0
Spania,recorder.ro,0,1,7,8,-0.125,0.125
Sun Tzu,recorder.ro,0,0,5,5,0.0,0.0
unchi,recorder.ro,0,4,1,5,-0.8,0.8
absolvent,recorder.ro,0,1,16,17,-0.058823529411764705,0.058823529411764705
bugetari,recorder.ro,0,5,0,5,-1.0,1.0
cadru medical,recorder.ro,4,4,1,9,0.0,0.0
colaborator,recorder.ro,0,7,2,9,-0.7777777777777778,0.7777777777777778
condamnat,recorder.ro,0,5,0,5,-1.0,1.0
consumator,recorder.ro,1,4,3,8,-0.375,0.375
doctorand,recorder.ro,0,0,2,2,0.0,0.0
dânș,recorder.ro,0,1,0,1,-1.0,1.0
fan,recorder.ro,0,2,0,2,-1.0,1.0
fost,recorder.ro,0,1,1,2,-0.5,0.5
ia,recorder.ro,0,2,3,5,-0.4,0.4
juriști,recorder.ro,0,2,4,6,-0.3333333333333333,0.3333333333333333
las,recorder.ro,0,0,1,1,0.0,0.0
lume,recorder.ro,0,12,3,15,-0.8,0.8
medic veterinar,recorder.ro,1,0,1,2,0.5,0.5
muncitor,recorder.ro,2,4,10,16,-0.125,0.125
nepot,recorder.ro,0,5,2,7,-0.7142857142857143,0.7142857142857143
tată,recorder.ro,0,9,15,24,-0.375,0.375
turișt,recorder.ro,0,2,0,2,-1.0,1.0
victimă,recorder.ro,1,9,9,19,-0.42105263157894735,0.42105263157894735
Ștefan cel Mare,recorder.ro,0,0,1,1,0.0,0.0
Victor Ponta,primanews.ro,0,8,7,15,-0.5333333333333333,0.5333333333333333
Alexandru Dobtre,www.gandul.ro,0,0,1,1,0.0,0.0
Elena Lasconi,www.gandul.ro,4,19,38,61,-0.2459016393442623,0.2459016393442623
Matei Păun,www.gandul.ro,0,0,3,3,0.0,0.0
Nicușor Dan,www.gandul.ro,0,12,46,58,-0.20689655172413793,0.20689655172413793
finanțator,www.gandul.ro,0,2,0,2,-1.0,1.0
reporter,www.gandul.ro,0,4,6,10,-0.4,0.4
Kelemen Hunor,www.b1tv.ro,0,0,3,3,0.0,0.0
Rusia,www.b1tv.ro,0,6,0,6,-1.0,1.0
Siria,www.b1tv.ro,0,0,1,1,0.0,0.0
Tudor Mușat,www.b1tv.ro,0,0,4,4,0.0,0.0
refugiat,www.b1tv.ro,0,1,2,3,-0.3333333333333333,0.3333333333333333
vicepremier,www.b1tv.ro,0,1,2,3,-0.3333333333333333,0.3333333333333333
avocat,www.realitatea.net,0,2,6,8,-0.25,0.25
simpatizant,www.realitatea.net,0,1,1,2,-0.5,0.5
susținător,www.realitatea.net,1,1,9,11,0.0,0.0
suveranist,www.realitatea.net,1,5,0,6,-0.6666666666666666,0.6666666666666666
Kaplan,www.digi24.ro,0,0,1,1,0.0,0.0
analist,www.digi24.ro,0,0,5,5,0.0,0.0
Fechet,agerpres.ro,0,1,2,3,-0.3333333333333333,0.3333333333333333
Gabriel Apetrii,agerpres.ro,0,0,6,6,0.0,0.0
Mircea Fechet,agerpres.ro,0,1,4,5,-0.2,0.2
Botond Csoma,recorder.ro,0,0,1,1,0.0,0.0
Ludovic Orban,recorder.ro,0,10,7,17,-0.5882352941176471,0.5882352941176471
colaboratoare,recorder.ro,0,1,0,1,-1.0,1.0
Brăila,www.cotidianul.ro,0,0,1,1,0.0,0.0
Iernut,www.cotidianul.ro,0,0,1,1,0.0,0.0
Lăpuștești,www.cotidianul.ro,0,0,1,1,0.0,0.0
Mintia,www.cotidianul.ro,0,0,1,1,0.0,0.0
Tarnița,www.cotidianul.ro,0,0,2,2,0.0,0.0
magistrat,www.cotidianul.ro,0,3,0,3,-1.0,1.0
populație,www.cotidianul.ro,0,6,3,9,-0.6666666666666666,0.6666666666666666
Allen Coliban,www.gandul.ro,0,1,0,1,-1.0,1.0
Brașov,www.gandul.ro,0,0,4,4,0.0,0.0
Coliban,www.gandul.ro,0,1,0,1,-1.0,1.0
Scripcaru,www.gandul.ro,0,2,0,2,-1.0,1.0
iba,www.gandul.ro,0,1,0,1,-1.0,1.0
ai,adevarul.ro,0,1,0,1,-1.0,1.0
Belgrad,adevarul.ro,1,3,16,20,-0.1,0.1
Dan Ioan Popescu,adevarul.ro,0,0,1,1,0.0,0.0
Iugoslavia,adevarul.ro,0,1,2,3,-0.3333333333333333,0.3333333333333333
Miron Mitrea,adevarul.ro,0,2,2,4,-0.5,0.5
Orsova,adevarul.ro,0,0,1,1,0.0,0.0
Sarah Maria,adevarul.ro,0,0,1,1,0.0,0.0
Voislav Kostunica,adevarul.ro,0,0,1,1,0.0,0.0
agent,adevarul.ro,0,3,1,4,-0.75,0.75
colaborator,adevarul.ro,0,1,4,5,-0.2,0.2
fete,adevarul.ro,0,0,2,2,0.0,0.0
muncitor,adevarul.ro,1,2,3,6,-0.16666666666666666,0.16666666666666666
organizator,adevarul.ro,0,0,4,4,0.0,0.0
tehnician,adevarul.ro,1,0,0,1,1.0,1.0
Eforie Nord,www.mediafax.ro,0,0,1,1,0.0,0.0
Flutur,www.mediafax.ro,0,0,1,1,0.0,0.0
tineret,www.mediafax.ro,0,0,3,3,0.0,0.0
Liviu Pop,www.mediafax.ro,0,1,1,2,-0.5,0.5
Marius Andruh,www.mediafax.ro,0,0,1,1,0.0,0.0
Austria,recorder.ro,0,0,7,7,0.0,0.0
Ciprian Ciucu,recorder.ro,0,1,3,4,-0.25,0.25
Claudiu Manda,recorder.ro,0,1,3,4,-0.25,0.25
Claudiu Târziu,recorder.ro,0,2,4,6,-0.3333333333333333,0.3333333333333333
Clotilde Armand,recorder.ro,0,4,4,8,-0.5,0.5
Cristian Terheș,recorder.ro,0,2,4,6,-0.3333333333333333,0.3333333333333333
Câmpulung,recorder.ro,0,0,3,3,0.0,0.0
Daniel Băluță,recorder.ro,0,3,1,4,-0.75,0.75
Diana Șoșoacă,recorder.ro,0,7,4,11,-0.6363636363636364,0.6363636363636364
Dominic Fritz,recorder.ro,0,0,4,4,0.0,0.0
Emil Boc,recorder.ro,0,0,6,6,0.0,0.0
Gheorghe Flutur,recorder.ro,1,2,2,5,-0.2,0.2
Gheorghe Piperea,recorder.ro,0,0,3,3,0.0,0.0
Giorgia Meloni,recorder.ro,0,0,2,2,0.0,0.0
istoric,recorder.ro,1,0,8,9,0.1111111111111111,0.1111111111111111
Italia,recorder.ro,0,0,19,19,0.0,0.0
Iulian Dumitrescu,recorder.ro,0,5,1,6,-0.8333333333333334,0.8333333333333334
Luis Lazarus,recorder.ro,0,0,2,2,0.0,0.0
Maria Grapini,recorder.ro,0,1,3,4,-0.25,0.25
Marine Le Pen,recorder.ro,0,1,1,2,-0.5,0.5
Mihai Polițeanu,recorder.ro,0,0,2,2,0.0,0.0
Nicușor Dan,recorder.ro,1,8,27,36,-0.19444444444444445,0.19444444444444445
Olguța Vasilescu,recorder.ro,0,0,3,3,0.0,0.0
Ploieștiu,recorder.ro,0,0,2,2,0.0,0.0
popular,recorder.ro,0,1,0,1,-1.0,1.0
Prahova,recorder.ro,0,1,5,6,-0.16666666666666666,0.16666666666666666
Radu Mihaiu,recorder.ro,0,1,2,3,-0.3333333333333333,0.3333333333333333
Robert Negoiță,recorder.ro,0,1,1,2,-0.5,0.5
Vasile Dâncu,recorder.ro,0,0,3,3,0.0,0.0
Virgil Nanu,recorder.ro,0,1,0,1,-1.0,1.0
Vlad Popescu,recorder.ro,0,0,2,2,0.0,0.0
er,recorder.ro,0,1,0,1,-1.0,1.0
George Tuță,recorder.ro,0,1,3,4,-0.25,0.25
politolog,recorder.ro,0,1,3,4,-0.25,0.25
Rareș Hopincă,recorder.ro,0,1,0,1,-1.0,1.0
primăriță,recorder.ro,0,3,1,4,-0.75,0.75
Ungureanu,stirileprotv.ro,0,1,3,4,-0.25,0.25
Ciolacu,www.realitatea.net,0,7,5,12,-0.5833333333333334,0.5833333333333334
prim-ministru,www.realitatea.net,0,3,4,7,-0.42857142857142855,0.42857142857142855
Franța,www.activenews.ro,0,2,6,8,-0.25,0.25
Radu Anton Câmpeanu,www.activenews.ro,0,0,1,1,0.0,0.0
Radu Câmpeanu,www.activenews.ro,0,0,1,1,0.0,0.0
Daniel Fenechiu,www.luju.ro,0,0,3,3,0.0,0.0
Ionuț Neagu,www.luju.ro,0,0,1,1,0.0,0.0
Robert Cazanciuc,www.luju.ro,1,0,3,4,0.25,0.25
creditor,www.luju.ro,0,0,5,5,0.0,0.0
debitor,www.luju.ro,0,4,2,6,-0.6666666666666666,0.6666666666666666
executor,www.luju.ro,0,1,9,10,-0.1,0.1
executor judecătoresc,www.luju.ro,0,0,5,5,0.0,0.0
familie,www.luju.ro,5,0,3,8,0.625,0.625
lor,www.luju.ro,0,0,1,1,0.0,0.0
oresc,www.luju.ro,0,0,1,1,0.0,0.0
parte,www.luju.ro,0,1,7,8,-0.125,0.125
ul,www.luju.ro,0,1,1,2,-0.5,0.5
Amuza,www.aktual24.ro,0,1,0,1,-1.0,1.0
Elveția,www.aktual24.ro,0,0,2,2,0.0,0.0
Franta,www.aktual24.ro,1,2,14,17,-0.058823529411764705,0.058823529411764705
Italia,www.aktual24.ro,0,1,4,5,-0.2,0.2
Marea Britanie,www.aktual24.ro,0,1,11,12,-0.08333333333333333,0.08333333333333333
Olanda,www.aktual24.ro,0,0,2,2,0.0,0.0
Republica Moldova,www.aktual24.ro,1,2,5,8,-0.125,0.125
Spania,www.aktual24.ro,1,1,3,5,0.0,0.0
Antonio Amuza,www.aktual24.ro,0,0,1,1,0.0,0.0
Călin Georgescu,www.luju.ro,3,12,15,30,-0.3,0.3
Dumnezeu,www.luju.ro,2,1,3,6,0.16666666666666666,0.16666666666666666
Elvetia,www.luju.ro,1,0,1,2,0.5,0.5
Georgescu,www.luju.ro,2,8,7,17,-0.35294117647058826,0.35294117647058826
popor,www.luju.ro,10,8,8,26,0.07692307692307693,0.07692307692307693
Putini,www.luju.ro,0,1,0,1,-1.0,1.0
SUA,www.luju.ro,2,6,6,14,-0.2857142857142857,0.2857142857142857
Statele Unite ale Americii,www.luju.ro,0,3,7,10,-0.3,0.3
voi,www.luju.ro,0,1,2,3,-0.3333333333333333,0.3333333333333333
alții,www.luju.ro,0,5,3,8,-0.625,0.625
demon,www.luju.ro,0,1,0,1,-1.0,1.0
diavol,www.luju.ro,0,1,0,1,-1.0,1.0
fiecare,www.luju.ro,0,1,0,1,-1.0,1.0
salahor,www.luju.ro,0,1,0,1,-1.0,1.0
supus,www.luju.ro,0,1,0,1,-1.0,1.0
Adrian Paul Dumitru,www.activenews.ro,0,0,2,2,0.0,0.0
Adrian Vigheciu,www.activenews.ro,0,0,2,2,0.0,0.0
Alexandru Maco Nita,www.activenews.ro,0,0,2,2,0.0,0.0
Alexandru Pânișoară,www.activenews.ro,0,0,2,2,0.0,0.0
Ana Cicena,www.activenews.ro,0,0,2,2,0.0,0.0
Ana Ștefan,www.activenews.ro,0,0,2,2,0.0,0.0
Andrei Golgotiu,www.activenews.ro,0,0,2,2,0.0,0.0
Michael Ujeuca,www.activenews.ro,0,0,2,2,0.0,0.0
Bucureștean,www.activenews.ro,0,1,2,3,-0.3333333333333333,0.3333333333333333
Ciucu,www.activenews.ro,0,0,2,2,0.0,0.0
Clothilde Armand,www.activenews.ro,0,0,2,2,0.0,0.0
Clotilde Armand,www.activenews.ro,0,0,2,2,0.0,0.0
Constantin State,www.activenews.ro,0,0,2,2,0.0,0.0
Cristian Popescu Piedon,www.activenews.ro,0,0,1,1,0.0,0.0
Cristian Popescu Piedone,www.activenews.ro,0,0,2,2,0.0,0.0
Dan Nicolae Podaru,www.activenews.ro,0,0,2,2,0.0,0.0
Daniel Baluta,www.activenews.ro,0,0,2,2,0.0,0.0
Daniel Tudorache,www.activenews.ro,0,0,2,2,0.0,0.0
Diana Șoșoacă Iovanovici,www.activenews.ro,0,0,2,2,0.0,0.0
Dorin Iacob,www.activenews.ro,0,0,2,2,0.0,0.0
Dragoș Cătălin Teniță,www.activenews.ro,0,0,2,2,0.0,0.0
Europa,www.activenews.ro,0,1,1,2,-0.5,0.5
Filip Constantin Titian,www.activenews.ro,0,0,2,2,0.0,0.0
Florin Ghidănac,www.activenews.ro,0,0,2,2,0.0,0.0
Gabriel Golgoțiu,www.activenews.ro,0,0,2,2,0.0,0.0
George Ramona Ioana Bruynseels,www.activenews.ro,0,0,2,2,0.0,0.0
George Tuta,www.activenews.ro,0,0,2,2,0.0,0.0
Gheorghe Tuta,www.activenews.ro,0,1,1,2,-0.5,0.5
Iolanda Bughiu,www.activenews.ro,0,0,2,2,0.0,0.0
Lidia Vadim,www.activenews.ro,0,0,2,2,0.0,0.0
Liviu Negoiță,www.activenews.ro,0,0,2,2,0.0,0.0
Luana Tîrziu,www.activenews.ro,0,0,2,2,0.0,0.0
Luminița Bughiu,www.activenews.ro,0,0,2,2,0.0,0.0
Marian Vanghelie,www.activenews.ro,0,1,2,3,-0.3333333333333333,0.3333333333333333
Mariana Manole,www.activenews.ro,0,0,2,2,0.0,0.0
Mario,www.activenews.ro,0,0,2,2,0.0,0.0
Matei Ștefănescu,www.activenews.ro,0,0,2,2,0.0,0.0
Mihai Adrian Enache,www.activenews.ro,0,0,2,2,0.0,0.0
Mihai Enache,www.activenews.ro,0,0,2,2,0.0,0.0
Mihaiu,www.activenews.ro,0,0,2,2,0.0,0.0
Mircea Florin Andrei,www.activenews.ro,0,0,2,2,0.0,0.0
Paul Dumitriu,www.activenews.ro,0,1,1,2,-0.5,0.5
Paul Ene,www.activenews.ro,0,0,2,2,0.0,0.0
primar,www.activenews.ro,0,17,11,28,-0.6071428571428571,0.6071428571428571
R,www.activenews.ro,0,0,2,2,0.0,0.0
REPER,www.activenews.ro,0,0,2,2,0.0,0.0
Gheorghe Daniel Paul Romeo,www.activenews.ro,0,0,2,2,0.0,0.0
Radu Mihaiu,www.activenews.ro,0,0,2,2,0.0,0.0
Rafael Ilie,www.activenews.ro,0,0,2,2,0.0,0.0
Ramona Ioana Bruynseels,www.activenews.ro,0,0,2,2,0.0,0.0
Rares Hopinca,www.activenews.ro,0,0,2,2,0.0,0.0
Rareș Hopincă,www.activenews.ro,0,0,2,2,0.0,0.0
Robert Negoita,www.activenews.ro,0,0,2,2,0.0,0.0
Savel Adrian Albu,www.activenews.ro,0,0,2,2,0.0,0.0
Sebastian Burduja,www.activenews.ro,0,0,3,3,0.0,0.0
Simion Dan Călina,www.activenews.ro,0,0,2,2,0.0,0.0
Stefan Judele,www.activenews.ro,0,0,2,2,0.0,0.0
Stefan Luchian Judele,www.activenews.ro,0,0,2,2,0.0,0.0
Vasile Negrile,www.activenews.ro,0,0,2,2,0.0,0.0
Vlad Popescu,www.activenews.ro,0,0,2,2,0.0,0.0
Vlad Popescu Piedone,www.activenews.ro,0,0,2,2,0.0,0.0
candidați,www.activenews.ro,0,4,4,8,-0.5,0.5
Ulian Hatmanu,www.activenews.ro,0,0,1,1,0.0,0.0
Ștefănel Dan Marin,www.activenews.ro,0,0,2,2,0.0,0.0
Matteo Salvini,adevarul.ro,0,0,1,1,0.0,0.0
crit,www.antena3.ro,0,1,0,1,-1.0,1.0
europarlamentar,www.antena3.ro,1,3,16,20,-0.1,0.1
Simion,www.antena3.ro,0,4,15,19,-0.21052631578947367,0.21052631578947367
Adrian Veștea,www.cotidianul.ro,0,0,1,1,0.0,0.0
Adrian Ioan Vestea,www.cotidianul.ro,0,0,1,1,0.0,0.0
Marcel Boloș,www.cotidianul.ro,0,0,2,2,0.0,0.0
Claudiu Târziu,adevarul.ro,0,4,8,12,-0.3333333333333333,0.3333333333333333
Cristian Diaconescu,www.realitatea.net,0,0,5,5,0.0,0.0
Miron Cozma,www.realitatea.net,0,1,0,1,-1.0,1.0
Cristian Tudor Popescu,adevarul.ro,0,7,10,17,-0.4117647058823529,0.4117647058823529
Florin Negruțiu,adevarul.ro,0,1,1,2,-0.5,0.5
gazetar,adevarul.ro,0,1,9,10,-0.1,0.1
Laura Vicol,adevarul.ro,0,1,1,2,-0.5,0.5
Nisa,adevarul.ro,0,1,0,1,-1.0,1.0
câștigător,adevarul.ro,2,1,3,6,0.16666666666666666,0.16666666666666666
dâns,adevarul.ro,0,1,0,1,-1.0,1.0
patron,adevarul.ro,0,7,0,7,-1.0,1.0
Ciolacu,www.mediafax.ro,0,6,8,14,-0.42857142857142855,0.42857142857142855
Marcel Ciolacu,www.mediafax.ro,0,3,25,28,-0.10714285714285714,0.10714285714285714
ales,www.mediafax.ro,0,1,2,3,-0.3333333333333333,0.3333333333333333
specialist,www.mediafax.ro,0,2,4,6,-0.3333333333333333,0.3333333333333333
Australia,stirileprotv.ro,0,0,3,3,0.0,0.0
Coreea de Sud,stirileprotv.ro,0,0,2,2,0.0,0.0
Finlanda,stirileprotv.ro,0,0,1,1,0.0,0.0
Madrid,stirileprotv.ro,0,0,1,1,0.0,0.0
Noua Zeelandă,stirileprotv.ro,0,0,3,3,0.0,0.0
Olanda,stirileprotv.ro,0,0,1,1,0.0,0.0
Suedia,stirileprotv.ro,0,0,2,2,0.0,0.0
Vilnius,stirileprotv.ro,0,0,1,1,0.0,0.0
ministru,stirileprotv.ro,1,38,45,84,-0.44047619047619047,0.44047619047619047
partener,stirileprotv.ro,1,4,4,9,-0.3333333333333333,0.3333333333333333
pilot,stirileprotv.ro,0,0,1,1,0.0,0.0
stat,stirileprotv.ro,0,2,2,4,-0.5,0.5
Ciolacu,www.antena3.ro,1,6,7,14,-0.35714285714285715,0.35714285714285715
Marcel Ciolacu,www.antena3.ro,4,15,43,62,-0.1774193548387097,0.1774193548387097
deputat,www.antena3.ro,1,6,19,26,-0.19230769230769232,0.19230769230769232
premier,www.antena3.ro,1,13,37,51,-0.23529411764705882,0.23529411764705882
șef,www.antena3.ro,1,15,12,28,-0.5,0.5
Ciolacu,www.comisarul.ro,1,18,15,34,-0.5,0.5
Victor Ponta,observatornews.ro,0,10,10,20,-0.5,0.5
deminatar,observatornews.ro,0,1,0,1,-1.0,1.0
parlamentar,observatornews.ro,0,29,19,48,-0.6041666666666666,0.6041666666666666
magistrat,adevarul.ro,1,9,5,15,-0.5333333333333333,0.5333333333333333
capitală,www.antena3.ro,0,1,4,5,-0.2,0.2
Focșani,www.antena3.ro,0,0,2,2,0.0,0.0
Iași,www.antena3.ro,0,0,3,3,0.0,0.0
Japonia,www.euronews.ro,0,0,2,2,0.0,0.0
Octav Vasilescu,www.euronews.ro,0,0,3,3,0.0,0.0
Tanzania,www.euronews.ro,0,0,1,1,0.0,0.0
Traian Băsescu,www.euronews.ro,1,6,8,15,-0.3333333333333333,0.3333333333333333
Viorica Dăncilă,www.euronews.ro,0,0,4,4,0.0,0.0
critic,www.euronews.ro,0,3,0,3,-1.0,1.0
mediator,www.euronews.ro,0,1,0,1,-1.0,1.0
premiu,www.euronews.ro,0,0,1,1,0.0,0.0
șef de stat,www.euronews.ro,0,2,5,7,-0.2857142857142857,0.2857142857142857
Elena Lasconi,agerpres.ro,0,2,4,6,-0.3333333333333333,0.3333333333333333
Florian Coldea,agerpres.ro,0,0,3,3,0.0,0.0
Irinela Vișan,agerpres.ro,0,0,13,13,0.0,0.0
contracandidat,agerpres.ro,0,9,1,10,-0.9,0.9
Antonescu,stirileprotv.ro,1,4,5,10,-0.3,0.3
deputat,stirileprotv.ro,0,25,24,49,-0.5102040816326531,0.5102040816326531
Elena Udrea,stirileprotv.ro,0,1,5,6,-0.16666666666666666,0.16666666666666666
Elene Udrea,stirileprotv.ro,0,3,0,3,-1.0,1.0
Neamtu,stirileprotv.ro,0,2,0,2,-1.0,1.0
Sova,stirileprotv.ro,0,1,0,1,-1.0,1.0
Traian Băsescu,stirileprotv.ro,1,19,20,40,-0.45,0.45
Udrea,stirileprotv.ro,0,1,1,2,-0.5,0.5
Voiculescu,stirileprotv.ro,0,2,2,4,-0.5,0.5
actor,stirileprotv.ro,0,3,0,3,-1.0,1.0
adversar,stirileprotv.ro,0,7,0,7,-1.0,1.0
alții,stirileprotv.ro,0,2,0,2,-1.0,1.0
dumnealui,stirileprotv.ro,0,1,0,1,-1.0,1.0
mănunchi,stirileprotv.ro,0,1,0,1,-1.0,1.0
austriac,recorder.ro,0,0,2,2,0.0,0.0
Olanda,recorder.ro,0,1,3,4,-0.25,0.25
Ovidiu Nahoi,recorder.ro,0,0,1,1,0.0,0.0
Bode,recorder.ro,0,0,1,1,0.0,0.0
Lucian Bode,www.euronews.ro,0,0,2,2,0.0,0.0
Sebastian Burduja,www.euronews.ro,0,1,9,10,-0.1,0.1
miniștri,www.euronews.ro,0,7,15,22,-0.3181818181818182,0.3181818181818182
Chichirău,adevarul.ro,0,1,1,2,-0.5,0.5
Chirica,adevarul.ro,0,1,0,1,-1.0,1.0
Cosette Chichirău,adevarul.ro,0,2,1,3,-0.6666666666666666,0.6666666666666666
Iași,adevarul.ro,0,0,9,9,0.0,0.0
Marius Bodea,adevarul.ro,0,0,1,1,0.0,0.0
Mihai Chirica,adevarul.ro,0,1,0,1,-1.0,1.0
acesta,adevarul.ro,0,1,2,3,-0.3333333333333333,0.3333333333333333
Cornetu,pressone.ro,0,0,1,1,0.0,0.0
Călugăreni,pressone.ro,0,1,0,1,-1.0,1.0
Giurgiu,pressone.ro,0,1,10,11,-0.09090909090909091,0.09090909090909091
Râ,pressone.ro,0,1,0,1,-1.0,1.0
Sofia,pressone.ro,0,1,0,1,-1.0,1.0
Varșovia,pressone.ro,0,1,3,4,-0.25,0.25
Videanu,pressone.ro,0,1,0,1,-1.0,1.0
acționar,pressone.ro,0,8,5,13,-0.6153846153846154,0.6153846153846154
Mohammad Murad,pressone.ro,0,1,0,1,-1.0,1.0
artist,pressone.ro,3,3,6,12,0.0,0.0
curor,pressone.ro,0,0,1,1,0.0,0.0
cârcotaș,pressone.ro,0,1,0,1,-1.0,1.0
câștigător,pressone.ro,2,5,4,11,-0.2727272727272727,0.2727272727272727
Gianina Șerban,pressone.ro,0,1,1,2,-0.5,0.5
Murad,pressone.ro,0,0,1,1,0.0,0.0
investitor,pressone.ro,0,3,3,6,-0.5,0.5
protagonist,pressone.ro,0,0,3,3,0.0,0.0
Șerban,pressone.ro,0,0,2,2,0.0,0.0
Daniel Suciu,adevarul.ro,0,0,2,2,0.0,0.0
Suciu,adevarul.ro,0,1,1,2,-0.5,0.5
Grindeanu,www.aktual24.ro,0,3,10,13,-0.23076923076923078,0.23076923076923078
Ilie Bolojan,www.aktual24.ro,3,1,61,65,0.03076923076923077,0.03076923076923077
Sorin Grindeanu,www.aktual24.ro,0,5,15,20,-0.25,0.25
Dan,www.antena3.ro,0,4,4,8,-0.5,0.5
Alexandru Rafila,primanews.ro,0,1,1,2,-0.5,0.5
Angel Tîlvăr,primanews.ro,0,0,1,1,0.0,0.0
Bogdan Ivan,primanews.ro,0,1,2,3,-0.3333333333333333,0.3333333333333333
Attila Cseke,primanews.ro,0,0,1,1,0.0,0.0
Cătălin Predoiu,primanews.ro,0,0,8,8,0.0,0.0
Daniel David,primanews.ro,0,0,2,2,0.0,0.0
Emil Hurezeanu,primanews.ro,0,0,1,1,0.0,0.0
Florin Barbu,primanews.ro,0,0,1,1,0.0,0.0
Marcel Boloș,primanews.ro,0,1,4,5,-0.2,0.2
Marian Neacșu,primanews.ro,0,0,1,1,0.0,0.0
Natalia Intotero,primanews.ro,0,0,1,1,0.0,0.0
Radu Marinescu,primanews.ro,0,0,1,1,0.0,0.0
Simona Bucura-Oprescu,primanews.ro,0,0,1,1,0.0,0.0
Sorin Grindeanu,primanews.ro,0,2,4,6,-0.3333333333333333,0.3333333333333333
vicepremier,primanews.ro,0,0,2,2,0.0,0.0
avocat,primanews.ro,0,0,1,1,0.0,0.0
miniștri,primanews.ro,0,5,4,9,-0.5555555555555556,0.5555555555555556
vecin,www.antena3.ro,0,0,1,1,0.0,0.0
Strasbourg,observatornews.ro,0,0,1,1,0.0,0.0
independent,observatornews.ro,0,0,2,2,0.0,0.0
șef de stat,observatornews.ro,2,0,20,22,0.09090909090909091,0.09090909090909091
Elon Musk,adevarul.ro,0,1,5,6,-0.16666666666666666,0.16666666666666666
Georgescu,adevarul.ro,2,30,36,68,-0.4117647058823529,0.4117647058823529
miliardar,adevarul.ro,0,1,4,5,-0.2,0.2
necunoscut,adevarul.ro,0,3,0,3,-1.0,1.0
Donald Trump,adevarul.ro,3,22,17,42,-0.4523809523809524,0.4523809523809524
Diana Șosoacă,pressone.ro,1,0,0,1,1.0,1.0
Franța,pressone.ro,0,1,23,24,-0.041666666666666664,0.041666666666666664
Georgescu,pressone.ro,2,12,8,22,-0.45454545454545453,0.45454545454545453
militant,pressone.ro,0,3,1,4,-0.75,0.75
Mucușor,pressone.ro,0,1,0,1,-1.0,1.0
Norvegia,pressone.ro,0,0,3,3,0.0,0.0
român,pressone.ro,1,3,2,6,-0.3333333333333333,0.3333333333333333
bolnav,pressone.ro,0,1,2,3,-0.3333333333333333,0.3333333333333333
susținătoare,pressone.ro,0,1,1,2,-0.5,0.5
suveran,pressone.ro,0,4,0,4,-1.0,1.0
utilizator,pressone.ro,1,5,17,23,-0.17391304347826086,0.17391304347826086
șef de stat,www.romaniatv.net,0,2,2,4,-0.5,0.5
Crin Antonescu,www.activenews.ro,0,10,5,15,-0.6666666666666666,0.6666666666666666
Macron,www.activenews.ro,0,6,1,7,-0.8571428571428571,0.8571428571428571
Maia Sandu,www.activenews.ro,0,3,1,4,-0.75,0.75
Rareș Bogdan,www.activenews.ro,0,2,3,5,-0.4,0.4
Republica Moldova,www.activenews.ro,0,4,3,7,-0.5714285714285714,0.5714285714285714
domn,www.activenews.ro,4,3,2,9,0.1111111111111111,0.1111111111111111
europarlamentar,www.activenews.ro,0,3,1,4,-0.75,0.75
Cîțu,observatornews.ro,0,3,3,6,-0.5,0.5
partener,observatornews.ro,6,5,3,14,0.07142857142857142,0.07142857142857142
Ion Iliescu,www.gandul.ro,0,1,2,3,-0.3333333333333333,0.3333333333333333
Petre Roman,www.gandul.ro,0,0,1,1,0.0,0.0
Piatra Neamț,www.gandul.ro,0,0,1,1,0.0,0.0
Piatra Neamțul,www.gandul.ro,0,0,1,1,0.0,0.0
Stanford,www.gandul.ro,0,0,1,1,0.0,0.0
Teodor Stolojan,www.gandul.ro,0,0,1,1,0.0,0.0
bunic,www.gandul.ro,0,0,1,1,0.0,0.0
personaj,www.gandul.ro,0,4,2,6,-0.6666666666666666,0.6666666666666666
tată,www.gandul.ro,2,3,7,12,-0.08333333333333333,0.08333333333333333
vecin,www.gandul.ro,0,0,2,2,0.0,0.0
responsabil,www.cotidianul.ro,0,12,0,12,-1.0,1.0
Bota,recorder.ro,0,1,0,1,-1.0,1.0
Sorin Bota,recorder.ro,0,2,0,2,-1.0,1.0
George Tarata,www.luju.ro,0,1,6,7,-0.14285714285714285,0.14285714285714285
Robert Cazaniciuc,www.luju.ro,0,0,1,1,0.0,0.0
ministru,www.luju.ro,0,27,6,33,-0.8181818181818182,0.8181818181818182
victima,www.luju.ro,0,2,0,2,-1.0,1.0
Donald Trump,www.mediafax.ro,0,5,10,15,-0.3333333333333333,0.3333333333333333
Krivoi Rog,www.mediafax.ro,0,2,0,2,-1.0,1.0
Rusia,www.mediafax.ro,0,9,4,13,-0.6923076923076923,0.6923076923076923
SUA,www.mediafax.ro,0,4,10,14,-0.2857142857142857,0.2857142857142857
Sankt Petersburg,www.mediafax.ro,0,0,3,3,0.0,0.0
Steve Witkoff,www.mediafax.ro,0,0,3,3,0.0,0.0
Sumî,www.mediafax.ro,0,2,2,4,-0.5,0.5
Ucraina,www.mediafax.ro,3,1,8,12,0.16666666666666666,0.16666666666666666
Vladimir Putin,www.mediafax.ro,0,1,5,6,-0.16666666666666666,0.16666666666666666
adult,www.mediafax.ro,0,2,0,2,-1.0,1.0
cadavru,www.mediafax.ro,0,3,0,3,-1.0,1.0
copil,www.mediafax.ro,0,2,4,6,-0.3333333333333333,0.3333333333333333
locuitor,www.mediafax.ro,0,4,0,4,-1.0,1.0
pasager,www.mediafax.ro,0,2,0,2,-1.0,1.0
Volodimir Zelenski,www.mediafax.ro,0,0,5,5,0.0,0.0
salvator,www.mediafax.ro,0,0,2,2,0.0,0.0
supraviețuitor,www.mediafax.ro,0,1,1,2,-0.5,0.5
trimis,www.mediafax.ro,0,1,1,2,-0.5,0.5
victima,www.mediafax.ro,0,2,1,3,-0.6666666666666666,0.6666666666666666
Administrația Trump,www.activenews.ro,0,1,0,1,-1.0,1.0
Adrian Alexandrov,www.activenews.ro,0,0,1,1,0.0,0.0
Adrian Gurzău,www.activenews.ro,0,0,1,1,0.0,0.0
Adrian Zuckerman,www.activenews.ro,0,1,0,1,-1.0,1.0
Cancan,www.activenews.ro,0,1,0,1,-1.0,1.0
Cluj,www.activenews.ro,0,2,2,4,-0.5,0.5
Dan,www.activenews.ro,0,3,1,4,-0.75,0.75
Elena Lasconi,www.activenews.ro,0,6,4,10,-0.6,0.6
Elene Udrea,www.activenews.ro,0,0,1,1,0.0,0.0
Emil Boc,www.activenews.ro,0,1,4,5,-0.2,0.2
Ion Cristoiu,www.activenews.ro,0,1,5,6,-0.16666666666666666,0.16666666666666666
Maria Eftime,www.activenews.ro,0,0,1,1,0.0,0.0
SUA,www.activenews.ro,0,8,5,13,-0.6153846153846154,0.6153846153846154
Zuckerman,www.activenews.ro,0,1,0,1,-1.0,1.0
ambasador,www.activenews.ro,0,4,1,5,-0.8,0.8
atul,www.activenews.ro,0,1,0,1,-1.0,1.0
avocat,www.activenews.ro,0,2,7,9,-0.2222222222222222,0.2222222222222222
contracan,www.activenews.ro,0,1,0,1,-1.0,1.0
extremist,www.activenews.ro,0,2,0,2,-1.0,1.0
finiș,www.activenews.ro,0,1,0,1,-1.0,1.0
oficial,www.activenews.ro,0,5,0,5,-1.0,1.0
partener,www.activenews.ro,0,4,2,6,-0.6666666666666666,0.6666666666666666
Prima Doamnă,www.antena3.ro,0,0,1,1,0.0,0.0
soție,www.antena3.ro,1,1,12,14,0.0,0.0
Boloș,observatornews.ro,0,1,0,1,-1.0,1.0
George Orwell,observatornews.ro,0,0,1,1,0.0,0.0
Marcel,observatornews.ro,0,1,2,3,-0.3333333333333333,0.3333333333333333
Marcel Bolos,observatornews.ro,0,0,1,1,0.0,0.0
Marcel Boloș,observatornews.ro,0,0,5,5,0.0,0.0
Marius Gîrlașiu,observatornews.ro,0,0,4,4,0.0,0.0
Uniunea,observatornews.ro,0,4,0,4,-1.0,1.0
pensionar,observatornews.ro,0,0,4,4,0.0,0.0
scriitor,observatornews.ro,0,0,2,2,0.0,0.0
vârstnic,observatornews.ro,0,1,1,2,-0.5,0.5
Ciolacu,www.b1tv.ro,0,8,2,10,-0.8,0.8
Eu,www.b1tv.ro,0,0,1,1,0.0,0.0
Ionuț Moșteanu,www.b1tv.ro,0,0,5,5,0.0,0.0
Moșteanu,www.b1tv.ro,0,1,3,4,-0.25,0.25
deputat,www.b1tv.ro,0,13,11,24,-0.5416666666666666,0.5416666666666666
om,www.b1tv.ro,11,35,27,73,-0.3287671232876712,0.3287671232876712
premier,www.b1tv.ro,1,10,12,23,-0.391304347826087,0.391304347826087
Cristina Matei,agerpres.ro,0,0,4,4,0.0,0.0
Gigel Știrbu,agerpres.ro,0,2,4,6,-0.3333333333333333,0.3333333333333333
Mario De Mezzo,agerpres.ro,0,0,5,5,0.0,0.0
Olt,agerpres.ro,0,1,1,2,-0.5,0.5
Slatina,agerpres.ro,0,0,2,2,0.0,0.0
Slatinei,agerpres.ro,0,0,1,1,0.0,0.0
copil,agerpres.ro,5,0,2,7,0.7142857142857143,0.7142857142857143
Știrbu,agerpres.ro,0,1,0,1,-1.0,1.0
Călin Donca,adevarul.ro,0,0,1,1,0.0,0.0
Dumnezeu,adevarul.ro,9,1,1,11,0.7272727272727273,0.7272727272727273
influencer,adevarul.ro,0,6,4,10,-0.6,0.6
oamnă,adevarul.ro,0,1,0,1,-1.0,1.0
urmăritor,adevarul.ro,0,4,0,4,-1.0,1.0
Ana Birchall,a1.ro,0,0,9,9,0.0,0.0
Cristian Terheș,a1.ro,0,0,12,12,0.0,0.0
Ilinca,a1.ro,0,0,1,1,0.0,0.0
Ilinca Simion,a1.ro,0,1,6,7,-0.14285714285714285,0.14285714285714285
Italia,a1.ro,0,0,3,3,0.0,0.0
Kelemen Hunor,a1.ro,0,0,10,10,0.0,0.0
Ludovic Orban,a1.ro,0,1,12,13,-0.07692307692307693,0.07692307692307693
Mihaela Geoană,a1.ro,0,2,3,5,-0.4,0.4
Mircea Geoană,a1.ro,0,3,21,24,-0.125,0.125
Roma,a1.ro,0,0,1,1,0.0,0.0
Sebastian Constantin Popescu,a1.ro,0,0,8,8,0.0,0.0
Silviu Predoiu,a1.ro,0,0,11,11,0.0,0.0
Tânăra,a1.ro,0,1,1,2,-0.5,0.5
alegător,a1.ro,0,15,15,30,-0.5,0.5
candidați,a1.ro,1,0,14,15,0.06666666666666667,0.06666666666666667
Aleksandar Vucic,www.realitatea.net,0,0,1,1,0.0,0.0
America,www.realitatea.net,0,1,4,5,-0.2,0.2
Donald Trump Jr,www.realitatea.net,0,0,2,2,0.0,0.0
Donald Trump Jr.,www.realitatea.net,0,0,1,1,0.0,0.0
moderator,www.realitatea.net,0,1,2,3,-0.3333333333333333,0.3333333333333333
P,www.realitatea.net,0,0,1,1,0.0,0.0
Vucic,www.realitatea.net,0,2,1,3,-0.6666666666666666,0.6666666666666666
Serb,www.realitatea.net,0,1,2,3,-0.3333333333333333,0.3333333333333333
Lasconi,www.realitatea.net,0,3,10,13,-0.23076923076923078,0.23076923076923078
Radu Tiliță,www.antena3.ro,0,0,1,1,0.0,0.0
telespectator,www.antena3.ro,0,0,2,2,0.0,0.0
Siegfried Mureșan,www.euronews.ro,0,0,4,4,0.0,0.0
Manfred Weber,www.euronews.ro,0,0,1,1,0.0,0.0
Mihai Morar,adevarul.ro,0,0,1,1,0.0,0.0
prezentator,adevarul.ro,0,0,2,2,0.0,0.0
băiat,adevarul.ro,2,1,4,7,0.14285714285714285,0.14285714285714285
Liviu Dragnea,observatornews.ro,1,3,9,13,-0.15384615384615385,0.15384615384615385
noi,observatornews.ro,1,0,0,1,1.0,1.0
prieteni,observatornews.ro,1,0,1,2,0.5,0.5
Alex Florenta,www.luju.ro,0,2,2,4,-0.5,0.5
Kovesi,www.luju.ro,0,5,1,6,-0.8333333333333334,0.8333333333333334
Laura Codruța Kovesi,www.luju.ro,0,8,1,9,-0.8888888888888888,0.8888888888888888
Marius Voineag,www.luju.ro,0,2,2,4,-0.5,0.5
procuror general,www.luju.ro,0,2,0,2,-1.0,1.0
Alexandru Florenta,www.luju.ro,0,1,0,1,-1.0,1.0
primar general,www.luju.ro,0,1,0,1,-1.0,1.0
sefilor,www.luju.ro,0,2,0,2,-1.0,1.0
stăpânul,www.luju.ro,0,2,0,2,-1.0,1.0
Statele Unite,www.news.ro,1,1,10,12,0.0,0.0
europarlamentar,www.news.ro,2,1,12,15,0.06666666666666667,0.06666666666666667
Y,adevarul.ro,0,0,1,1,0.0,0.0
ambitiu,pressone.ro,0,1,0,1,-1.0,1.0
Bolojan,pressone.ro,0,5,2,7,-0.7142857142857143,0.7142857142857143
Brăila,pressone.ro,0,2,6,8,-0.25,0.25
Băsescu,pressone.ro,0,20,1,21,-0.9523809523809523,0.9523809523809523
Capitale,pressone.ro,1,3,8,12,-0.16666666666666666,0.16666666666666666
Covasna,pressone.ro,0,1,7,8,-0.125,0.125
Cîțu,pressone.ro,0,13,3,16,-0.8125,0.8125
Călărași,pressone.ro,0,1,2,3,-0.3333333333333333,0.3333333333333333
Dăncilă,pressone.ro,0,6,7,13,-0.46153846153846156,0.46153846153846156
Firea,pressone.ro,1,5,4,10,-0.4,0.4
Flutur,pressone.ro,1,0,1,2,0.5,0.5
Galați,pressone.ro,0,0,10,10,0.0,0.0
Geoană,pressone.ro,0,3,2,5,-0.6,0.6
Godzilla,pressone.ro,0,1,0,1,-1.0,1.0
Hava,pressone.ro,0,3,1,4,-0.75,0.75
King Kong,pressone.ro,0,0,1,1,0.0,0.0
Lia Olguța Vasilescu,pressone.ro,0,4,7,11,-0.36363636363636365,0.36363636363636365
Motreanu,pressone.ro,0,0,3,3,0.0,0.0
oltean,pressone.ro,1,1,1,3,0.0,0.0
SUA,pressone.ro,1,4,21,26,-0.11538461538461539,0.11538461538461539
Satu Mare,pressone.ro,0,0,6,6,0.0,0.0
Timișoara,pressone.ro,1,1,14,16,0.0,0.0
Târziu,pressone.ro,0,0,1,1,0.0,0.0
absolvent,pressone.ro,0,3,15,18,-0.16666666666666666,0.16666666666666666
ardelen,pressone.ro,0,1,0,1,-1.0,1.0
ardeleni,pressone.ro,0,1,0,1,-1.0,1.0
armăsar,pressone.ro,0,1,0,1,-1.0,1.0
bucovinean,pressone.ro,0,0,1,1,0.0,0.0
buzoian,pressone.ro,0,1,0,1,-1.0,1.0
bănățean,pressone.ro,1,2,0,3,-0.3333333333333333,0.3333333333333333
client,pressone.ro,1,7,5,13,-0.46153846153846156,0.46153846153846156
etnic,pressone.ro,0,2,1,3,-0.6666666666666666,0.6666666666666666
fotbalist,pressone.ro,0,0,3,3,0.0,0.0
gardian,pressone.ro,0,1,1,2,-0.5,0.5
ii,pressone.ro,0,0,1,1,0.0,0.0
portar,pressone.ro,0,1,3,4,-0.25,0.25
Ionel Ciucă,pressone.ro,0,5,0,5,-1.0,1.0
prezidențiabil,pressone.ro,0,3,1,4,-0.75,0.75
regățen,pressone.ro,0,1,0,1,-1.0,1.0
titan,pressone.ro,0,1,0,1,-1.0,1.0
Cozma,www.b1tv.ro,0,0,1,1,0.0,0.0
Felix Cozma,www.b1tv.ro,0,0,1,1,0.0,0.0
Victor Negrescu,www.b1tv.ro,0,0,1,1,0.0,0.0
comisar,www.b1tv.ro,0,0,2,2,0.0,0.0
Marcel Ciolacu,www.b1tv.ro,1,16,12,29,-0.5172413793103449,0.5172413793103449
vicepreședinte,www.b1tv.ro,0,0,6,6,0.0,0.0
Becali,www.realitatea.net,0,4,1,5,-0.8,0.8
George Becali,www.realitatea.net,0,4,0,4,-1.0,1.0
Gigi Becai,www.realitatea.net,0,1,0,1,-1.0,1.0
Gigi Becali,www.realitatea.net,0,2,2,4,-0.5,0.5
Hrebenciuc,www.realitatea.net,0,2,0,2,-1.0,1.0
Viorel Hrebenciuc,www.realitatea.net,0,1,0,1,-1.0,1.0
Viorel Hrebengiuc,www.realitatea.net,0,1,0,1,-1.0,1.0
baron,www.realitatea.net,0,1,0,1,-1.0,1.0
Ghigiu,www.aktual24.ro,0,1,0,1,-1.0,1.0
Mihai Ghigiu,www.aktual24.ro,0,0,1,1,0.0,0.0
Ponta,www.aktual24.ro,0,19,6,25,-0.76,0.76
Victor Ponta,www.aktual24.ro,0,17,21,38,-0.4473684210526316,0.4473684210526316
Radu Cristescu,www.aktual24.ro,0,1,0,1,-1.0,1.0
Auckland,www.g4media.ro,0,0,1,1,0.0,0.0
Bruxelles,www.g4media.ro,0,3,9,12,-0.25,0.25
Mureșan,www.g4media.ro,0,0,1,1,0.0,0.0
Noua Zeelandă,www.g4media.ro,0,0,1,1,0.0,0.0
Siegfried Mureșan,www.g4media.ro,0,0,1,1,0.0,0.0
respondent,observatornews.ro,0,0,3,3,0.0,0.0
Cătălin Predoiu,www.luju.ro,0,5,10,15,-0.3333333333333333,0.3333333333333333
Cluj,www.luju.ro,0,0,3,3,0.0,0.0
Predoiu,www.luju.ro,0,3,1,4,-0.75,0.75
bucureștean,www.luju.ro,0,1,0,1,-1.0,1.0
dans,www.luju.ro,0,2,1,3,-0.6666666666666666,0.6666666666666666
premier,www.luju.ro,1,6,7,14,-0.35714285714285715,0.35714285714285715
Alina Gorghiu,agerpres.ro,0,0,4,4,0.0,0.0
Băiculești,agerpres.ro,0,0,3,3,0.0,0.0
Cătălin Alexandru,agerpres.ro,0,0,7,7,0.0,0.0
George Onea,agerpres.ro,0,0,4,4,0.0,0.0
Gorghiu,agerpres.ro,0,1,2,3,-0.3333333333333333,0.3333333333333333
Valea lui Enache,agerpres.ro,0,0,3,3,0.0,0.0
Ceaușescu,www.digi24.ro,0,3,0,3,-1.0,1.0
Cătălin Rădulescu,www.digi24.ro,0,0,1,1,0.0,0.0
Liviu Drangea,www.digi24.ro,0,0,2,2,0.0,0.0
Rovana Plumb,www.digi24.ro,0,0,2,2,0.0,0.0
Târgoviște,www.digi24.ro,0,0,1,1,0.0,0.0
ai,www.digi24.ro,0,1,0,1,-1.0,1.0
candidați,www.digi24.ro,0,3,4,7,-0.42857142857142855,0.42857142857142855
mulțime,www.digi24.ro,0,2,0,2,-1.0,1.0
oier,www.digi24.ro,0,1,0,1,-1.0,1.0
popor,www.digi24.ro,4,11,4,19,-0.3684210526315789,0.3684210526315789
procuror,www.digi24.ro,0,4,3,7,-0.5714285714285714,0.5714285714285714
Mugur Isărescu,www.romaniatv.net,0,1,3,4,-0.25,0.25
Ponta,www.digi24.ro,0,15,3,18,-0.8333333333333334,0.8333333333333334
Victor,www.digi24.ro,0,3,0,3,-1.0,1.0
antreprenor,www.digi24.ro,0,1,1,2,-0.5,0.5
militar,www.digi24.ro,1,5,3,9,-0.4444444444444444,0.4444444444444444
pensionar,www.digi24.ro,0,4,1,5,-0.8,0.8
Lasconi,pressone.ro,0,4,4,8,-0.5,0.5
Lucian Harșovschi,pressone.ro,0,0,2,2,0.0,0.0
Nicolae Ciucă,pressone.ro,0,13,16,29,-0.4482758620689655,0.4482758620689655
Justin Pârvu,pressone.ro,0,0,4,4,0.0,0.0
Septimius Pârvu,pressone.ro,0,0,10,10,0.0,0.0
Sucevei,pressone.ro,0,0,2,2,0.0,0.0
fan,pressone.ro,1,14,1,16,-0.8125,0.8125
viceprimar,pressone.ro,0,2,10,12,-0.16666666666666666,0.16666666666666666
Harșovschi,pressone.ro,0,1,0,1,-1.0,1.0
Donald Trump,www.cotidianul.ro,0,7,14,21,-0.3333333333333333,0.3333333333333333
muzician,www.cotidianul.ro,0,5,0,5,-1.0,1.0
Orban,www.cotidianul.ro,0,6,1,7,-0.8571428571428571,0.8571428571428571
Vladimir Putin,www.cotidianul.ro,0,2,12,14,-0.14285714285714285,0.14285714285714285
Viktor Orban,www.cotidianul.ro,0,2,7,9,-0.2222222222222222,0.2222222222222222
omolog,www.cotidianul.ro,0,0,6,6,0.0,0.0
traseist,www.cotidianul.ro,0,1,0,1,-1.0,1.0
Dumnezeu,stirileprotv.ro,0,0,1,1,0.0,0.0
Iliescu,stirileprotv.ro,0,2,4,6,-0.3333333333333333,0.3333333333333333
Iohannis,stirileprotv.ro,0,1,0,1,-1.0,1.0
independent,stirileprotv.ro,1,2,0,3,-0.3333333333333333,0.3333333333333333
sinucigaș,stirileprotv.ro,0,1,0,1,-1.0,1.0
Giorgia Meloni,agerpres.ro,0,0,1,1,0.0,0.0
Meloni,agerpres.ro,0,0,1,1,0.0,0.0
public,recorder.ro,0,5,5,10,-0.5,0.5
Cernavodă,www.b1tv.ro,0,1,0,1,-1.0,1.0
Nicușor Dan,www.b1tv.ro,6,5,24,35,0.02857142857142857,0.02857142857142857
Radu Buzăianu,www.b1tv.ro,0,0,11,11,0.0,0.0
Răzvan Zamfir,www.b1tv.ro,0,0,11,11,0.0,0.0
Victor Ponta,www.b1tv.ro,0,11,4,15,-0.7333333333333333,0.7333333333333333
Eduard Vînătoru,www.gandul.ro,0,0,1,1,0.0,0.0
contribuabil,www.gandul.ro,1,5,0,6,-0.6666666666666666,0.6666666666666666
participant,www.gandul.ro,0,0,1,1,0.0,0.0
reprezentanți,www.gandul.ro,0,0,2,2,0.0,0.0
salariaț,www.gandul.ro,1,0,1,2,0.5,0.5
Elena Lasconi,www.b1tv.ro,1,6,14,21,-0.23809523809523808,0.23809523809523808
Gabriela Mihai,www.b1tv.ro,0,0,5,5,0.0,0.0
Georgescu,www.b1tv.ro,0,7,4,11,-0.6363636363636364,0.6363636363636364
Lasconi,www.b1tv.ro,0,1,3,4,-0.25,0.25
bodyguard,www.b1tv.ro,0,1,0,1,-1.0,1.0
lor,www.b1tv.ro,0,2,0,2,-1.0,1.0
parlamentar,www.b1tv.ro,0,4,2,6,-0.6666666666666666,0.6666666666666666
politician,www.b1tv.ro,0,20,1,21,-0.9523809523809523,0.9523809523809523
securist,www.b1tv.ro,0,1,0,1,-1.0,1.0
Dan,www.mediafax.ro,0,0,11,11,0.0,0.0
Nicușor Dan,www.mediafax.ro,2,6,31,39,-0.10256410256410256,0.10256410256410256
Băsescu,www.news.ro,0,7,0,7,-1.0,1.0
emisar,www.news.ro,0,5,5,10,-0.5,0.5
Marcel Colacu,www.news.ro,0,1,0,1,-1.0,1.0
reprezentant,www.news.ro,3,13,20,36,-0.2777777777777778,0.2777777777777778
trimis,www.news.ro,0,0,2,2,0.0,0.0
Adrian Zuckerman,www.news.ro,0,0,2,2,0.0,0.0
Nicolae Ciucă,www.news.ro,2,6,20,28,-0.14285714285714285,0.14285714285714285
Amara,recorder.ro,0,1,0,1,-1.0,1.0
Avram Fițiu,recorder.ro,0,0,1,1,0.0,0.0
Dragnea,recorder.ro,1,25,3,29,-0.8275862068965517,0.8275862068965517
Feteștiu,recorder.ro,0,0,1,1,0.0,0.0
Ialomița,recorder.ro,0,0,4,4,0.0,0.0
Iordache,recorder.ro,0,1,0,1,-1.0,1.0
Irina Binder,recorder.ro,0,0,1,1,0.0,0.0
Luminița Barcari,recorder.ro,0,0,1,1,0.0,0.0
Marian Neacșu,recorder.ro,0,0,2,2,0.0,0.0
Robert Chioveanu,recorder.ro,0,0,1,1,0.0,0.0
Slobozia,recorder.ro,0,0,2,2,0.0,0.0
Tulcea,recorder.ro,0,1,3,4,-0.25,0.25
Târgoviște,recorder.ro,0,1,4,5,-0.2,0.2
Urziceni,recorder.ro,0,0,1,1,0.0,0.0
Victor Moraru,recorder.ro,0,0,1,1,0.0,0.0
Yuval Noah Harari,recorder.ro,0,1,13,14,-0.07142857142857142,0.07142857142857142
autor,recorder.ro,1,14,19,34,-0.38235294117647056,0.38235294117647056
factor,recorder.ro,0,1,0,1,-1.0,1.0
ialomițean,recorder.ro,0,0,1,1,0.0,0.0
jna,recorder.ro,0,1,0,1,-1.0,1.0
personaj,recorder.ro,1,10,4,15,-0.6,0.6
politruc,recorder.ro,0,9,0,9,-1.0,1.0
prestator,recorder.ro,0,1,0,1,-1.0,1.0
rudă,recorder.ro,0,6,1,7,-0.8571428571428571,0.8571428571428571
sclav,recorder.ro,0,2,0,2,-1.0,1.0
secretar,recorder.ro,0,11,37,48,-0.22916666666666666,0.22916666666666666
tehnician,recorder.ro,0,0,5,5,0.0,0.0
ui,recorder.ro,0,0,1,1,0.0,0.0
zeu,recorder.ro,0,2,0,2,-1.0,1.0
întreprinzător,recorder.ro,6,1,2,9,0.5555555555555556,0.5555555555555556
Ștefan Mușoiu,recorder.ro,0,0,1,1,0.0,0.0
Ștefan Țin,recorder.ro,0,0,1,1,0.0,0.0
Robert Jordan,recorder.ro,0,0,1,1,0.0,0.0
Ciolacu,www.romaniatv.net,1,23,24,48,-0.4583333333333333,0.4583333333333333
Dan Șucu,www.gandul.ro,0,0,2,2,0.0,0.0
domn,www.gandul.ro,0,1,6,7,-0.14285714285714285,0.14285714285714285
Gabriela Firea,www.gandul.ro,4,7,15,26,-0.11538461538461539,0.11538461538461539
Ionuț,www.gandul.ro,0,1,0,1,-1.0,1.0
Ionuț Lupescu,www.gandul.ro,0,0,1,1,0.0,0.0
Rareș Bogdan,www.gandul.ro,0,1,5,6,-0.16666666666666666,0.16666666666666666
Sebastian,www.gandul.ro,1,0,0,1,1.0,1.0
cineva,www.gandul.ro,0,1,0,1,-1.0,1.0
manager,www.gandul.ro,2,1,0,3,0.3333333333333333,0.3333333333333333
noi,www.gandul.ro,0,1,0,1,-1.0,1.0
membru,www.antena3.ro,3,5,36,44,-0.045454545454545456,0.045454545454545456
Georgiana Tănăsescu,agerpres.ro,0,0,22,22,0.0,0.0
Brad,www.digi24.ro,0,0,1,1,0.0,0.0
Brașov,www.digi24.ro,0,1,1,2,-0.5,0.5
Chiajna,www.digi24.ro,0,0,1,1,0.0,0.0
Corlățean,www.digi24.ro,0,1,0,1,-1.0,1.0
Călin Popescu Tăriceanu,www.digi24.ro,0,2,3,5,-0.4,0.4
Dinu Patriciu,www.digi24.ro,0,0,2,2,0.0,0.0
Hunedoara,www.digi24.ro,0,0,1,1,0.0,0.0
Ilfov,www.digi24.ro,0,0,2,2,0.0,0.0
Meleșcanu,www.digi24.ro,1,0,2,3,0.3333333333333333,0.3333333333333333
Nicolae Văcăroiu,www.digi24.ro,0,0,1,1,0.0,0.0
Norica Nicolai,www.digi24.ro,0,1,0,1,-1.0,1.0
Noricăi Nicolai,www.digi24.ro,0,1,0,1,-1.0,1.0
Paris,www.digi24.ro,0,0,1,1,0.0,0.0
Teodor Meleșcanu,www.digi24.ro,0,1,3,4,-0.25,0.25
Titus Corlățean,www.digi24.ro,0,1,0,1,-1.0,1.0
Tăriceanu,www.digi24.ro,0,2,2,4,-0.5,0.5
ambasador,www.digi24.ro,0,1,9,10,-0.1,0.1
angajat,www.digi24.ro,0,6,9,15,-0.4,0.4
consilier,www.digi24.ro,3,1,20,24,0.08333333333333333,0.08333333333333333
diplomat,www.digi24.ro,2,2,4,8,0.0,0.0
ea,www.digi24.ro,0,0,1,1,0.0,0.0
judecător,www.digi24.ro,0,4,4,8,-0.5,0.5
nepot,www.digi24.ro,0,4,1,5,-0.8,0.8
vicepreședinte,www.digi24.ro,0,3,13,16,-0.1875,0.1875
Cristian Pîrvulescu,adevarul.ro,0,1,24,25,-0.04,0.04
om politic,adevarul.ro,2,8,3,13,-0.46153846153846156,0.46153846153846156
rival,adevarul.ro,0,4,1,5,-0.8,0.8
susținător,adevarul.ro,7,18,26,51,-0.21568627450980393,0.21568627450980393
Atreju,www.euronews.ro,0,1,0,1,-1.0,1.0
europarlamentar,www.euronews.ro,0,2,10,12,-0.16666666666666666,0.16666666666666666
Giorgia Meloni,www.euronews.ro,0,0,1,1,0.0,0.0
Giorgio Meloni,www.euronews.ro,0,0,1,1,0.0,0.0
Italia,www.euronews.ro,1,0,11,12,0.08333333333333333,0.08333333333333333
Mateusz Morawiecki,www.euronews.ro,1,0,0,1,1.0,1.0
Pîrvulescu,www.euronews.ro,0,0,1,1,0.0,0.0
Republica Moldova,www.euronews.ro,1,0,12,13,0.07692307692307693,0.07692307692307693
Rusia,www.euronews.ro,0,26,14,40,-0.65,0.65
Ucraina,www.euronews.ro,4,5,38,47,-0.02127659574468085,0.02127659574468085
analist,www.euronews.ro,0,2,4,6,-0.3333333333333333,0.3333333333333333
angajat,www.euronews.ro,1,5,12,18,-0.2222222222222222,0.2222222222222222
polițist,www.euronews.ro,0,5,3,8,-0.625,0.625
tineret,www.euronews.ro,1,0,2,3,0.3333333333333333,0.3333333333333333
Alba,www.euronews.ro,0,0,4,4,0.0,0.0
Arad,www.euronews.ro,0,0,2,2,0.0,0.0
Argeș,www.euronews.ro,0,0,4,4,0.0,0.0
Bacău,www.euronews.ro,0,0,3,3,0.0,0.0
Bijor,www.euronews.ro,0,1,0,1,-1.0,1.0
Botoșanu,www.euronews.ro,0,0,1,1,0.0,0.0
Brașov,www.euronews.ro,0,0,4,4,0.0,0.0
Brăila,www.euronews.ro,0,0,2,2,0.0,0.0
Buzău,www.euronews.ro,0,1,4,5,-0.2,0.2
Canada,www.euronews.ro,0,1,3,4,-0.25,0.25
China,www.euronews.ro,0,2,5,7,-0.2857142857142857,0.2857142857142857
Dan,www.euronews.ro,2,0,4,6,0.3333333333333333,0.3333333333333333
Franța,www.euronews.ro,1,0,12,13,0.07692307692307693,0.07692307692307693
Galați,www.euronews.ro,0,0,2,2,0.0,0.0
Germania,www.euronews.ro,0,3,18,21,-0.14285714285714285,0.14285714285714285
Giurgiu,www.euronews.ro,0,1,4,5,-0.2,0.2
Ialomița,www.euronews.ro,0,0,2,2,0.0,0.0
Maramureș,www.euronews.ro,0,0,3,3,0.0,0.0
Marea Britanie,www.euronews.ro,0,0,5,5,0.0,0.0
Mehedinți,www.euronews.ro,0,0,2,2,0.0,0.0
Neamț,www.euronews.ro,0,1,3,4,-0.25,0.25
Olt,www.euronews.ro,0,0,3,3,0.0,0.0
Polonia,www.euronews.ro,0,1,12,13,-0.07692307692307693,0.07692307692307693
Prahova,www.euronews.ro,0,0,6,6,0.0,0.0
Satu Mare,www.euronews.ro,0,1,2,3,-0.3333333333333333,0.3333333333333333
Serbia,www.euronews.ro,1,1,2,4,0.0,0.0
Sibiu,www.euronews.ro,0,0,6,6,0.0,0.0
Spania,www.euronews.ro,0,0,7,7,0.0,0.0
Suceava,www.euronews.ro,0,0,4,4,0.0,0.0
Sălaj,www.euronews.ro,0,0,1,1,0.0,0.0
Teleorman,www.euronews.ro,0,0,2,2,0.0,0.0
Timișoara,www.euronews.ro,0,0,2,2,0.0,0.0
Tulcea,www.euronews.ro,0,0,3,3,0.0,0.0
Vrancea,www.euronews.ro,0,0,2,2,0.0,0.0
Vâlcea,www.euronews.ro,0,0,2,2,0.0,0.0
contracandidat,www.euronews.ro,0,6,6,12,-0.5,0.5
Elon Musk,www.news.ro,0,1,3,4,-0.25,0.25
Emil Hurezeanu,www.news.ro,0,1,2,3,-0.3333333333333333,0.3333333333333333
Germania,www.news.ro,0,0,4,4,0.0,0.0
JD Vance,www.news.ro,0,0,2,2,0.0,0.0
Munchen,www.news.ro,0,0,2,2,0.0,0.0
Musk,www.news.ro,0,0,1,1,0.0,0.0
München,www.news.ro,0,0,1,1,0.0,0.0
Vicepreședintele,www.news.ro,0,1,4,5,-0.2,0.2
apropiat,www.news.ro,0,1,2,3,-0.3333333333333333,0.3333333333333333
jurnalist,www.news.ro,1,4,4,9,-0.3333333333333333,0.3333333333333333
moderator,www.news.ro,0,2,0,2,-1.0,1.0
oficial,www.news.ro,0,4,4,8,-0.5,0.5
personaj,www.news.ro,0,3,2,5,-0.6,0.6
ziarist,www.news.ro,0,1,1,2,-0.5,0.5
Botond,www.g4media.ro,0,0,1,1,0.0,0.0
Csoma Botond,www.g4media.ro,0,0,3,3,0.0,0.0
Argeș,www.aktual24.ro,0,1,0,1,-1.0,1.0
Bob Wickers,www.aktual24.ro,0,1,0,1,-1.0,1.0
Bode,www.aktual24.ro,0,4,2,6,-0.6666666666666666,0.6666666666666666
Campulung,www.aktual24.ro,0,0,1,1,0.0,0.0
ceilalți,www.aktual24.ro,0,5,0,5,-1.0,1.0
Ciuca,www.aktual24.ro,2,12,9,23,-0.43478260869565216,0.43478260869565216
Constanța,www.aktual24.ro,0,0,4,4,0.0,0.0
Constantinescu,www.aktual24.ro,0,1,1,2,-0.5,0.5
Geoana,www.aktual24.ro,0,1,3,4,-0.25,0.25
domn,www.aktual24.ro,1,4,4,9,-0.3333333333333333,0.3333333333333333
dumneavoastră,www.aktual24.ro,2,1,10,13,0.07692307692307693,0.07692307692307693
Emil Constantinescu,www.aktual24.ro,0,1,3,4,-0.25,0.25
Recep Tayyip Erdogan,www.aktual24.ro,0,1,0,1,-1.0,1.0
fiecare,www.aktual24.ro,0,2,2,4,-0.5,0.5
frate,www.aktual24.ro,1,3,2,6,-0.3333333333333333,0.3333333333333333
Geoană,www.aktual24.ro,0,0,8,8,0.0,0.0
Klaus Iohannis,www.aktual24.ro,1,19,34,54,-0.3333333333333333,0.3333333333333333
Lucian Bode,www.aktual24.ro,0,1,3,4,-0.25,0.25
Matei Udrea,www.aktual24.ro,0,0,5,5,0.0,0.0
Platon,www.aktual24.ro,1,0,1,2,0.5,0.5
popor,www.aktual24.ro,15,5,6,26,0.38461538461538464,0.38461538461538464
Vladimir Putin,www.aktual24.ro,0,15,6,21,-0.7142857142857143,0.7142857142857143
Radu Timofte,www.aktual24.ro,0,0,1,1,0.0,0.0
Rareș Bogdan,www.aktual24.ro,0,1,9,10,-0.1,0.1
republică,www.aktual24.ro,0,0,2,2,0.0,0.0
țară,www.aktual24.ro,0,1,0,1,-1.0,1.0
Turcia,www.aktual24.ro,0,6,1,7,-0.8571428571428571,0.8571428571428571
Valeriu Nicolae,www.aktual24.ro,0,1,0,1,-1.0,1.0
Vaslui,www.aktual24.ro,0,0,4,4,0.0,0.0
Viena,www.aktual24.ro,0,0,1,1,0.0,0.0
actor,www.aktual24.ro,0,2,1,3,-0.6666666666666666,0.6666666666666666
ai,www.aktual24.ro,0,0,1,1,0.0,0.0
antreprenor,www.aktual24.ro,0,3,2,5,-0.6,0.6
asistent,www.aktual24.ro,1,0,1,2,0.5,0.5
at,www.aktual24.ro,0,1,0,1,-1.0,1.0
baron,www.aktual24.ro,0,4,1,5,-0.8,0.8
blondele,www.aktual24.ro,0,1,0,1,-1.0,1.0
consultant,www.aktual24.ro,1,2,2,5,-0.2,0.2
contracan,www.aktual24.ro,0,1,0,1,-1.0,1.0
contracandidat,www.aktual24.ro,0,12,2,14,-0.8571428571428571,0.8571428571428571
dans,www.aktual24.ro,0,4,3,7,-0.5714285714285714,0.5714285714285714
director,www.aktual24.ro,0,5,7,12,-0.4166666666666667,0.4166666666666667
domnie,www.aktual24.ro,1,4,1,6,-0.5,0.5
Mihai Maci,www.aktual24.ro,0,0,1,1,0.0,0.0
Timofte,www.aktual24.ro,0,1,0,1,-1.0,1.0
dușman,www.aktual24.ro,0,7,0,7,-1.0,1.0
extremist,www.aktual24.ro,0,7,0,7,-1.0,1.0
fete,www.aktual24.ro,0,0,1,1,0.0,0.0
general,www.aktual24.ro,0,4,1,5,-0.8,0.8
gospodar,www.aktual24.ro,1,0,0,1,1.0,1.0
individ,www.aktual24.ro,0,7,0,7,-1.0,1.0
inspector,www.aktual24.ro,0,1,1,2,-0.5,0.5
interlocutoare,www.aktual24.ro,0,0,1,1,0.0,0.0
interlocutor,www.aktual24.ro,1,2,1,4,-0.25,0.25
ist,www.aktual24.ro,0,1,0,1,-1.0,1.0
lume,www.aktual24.ro,0,6,1,7,-0.8571428571428571,0.8571428571428571
luptătoare,www.aktual24.ro,0,1,1,2,-0.5,0.5
medic,www.aktual24.ro,0,1,4,5,-0.2,0.2
minor,www.aktual24.ro,0,1,2,3,-0.3333333333333333,0.3333333333333333
pacient,www.aktual24.ro,0,1,0,1,-1.0,1.0
politist,www.aktual24.ro,0,3,1,4,-0.75,0.75
premiu,www.aktual24.ro,0,1,2,3,-0.3333333333333333,0.3333333333333333
prieteni,www.aktual24.ro,0,1,3,4,-0.25,0.25
profesor,www.aktual24.ro,2,3,6,11,-0.09090909090909091,0.09090909090909091
protagonist,www.aktual24.ro,0,1,0,1,-1.0,1.0
sefilor,www.aktual24.ro,0,5,1,6,-0.8333333333333334,0.8333333333333334
sociolog,www.aktual24.ro,0,0,4,4,0.0,0.0
votant,www.aktual24.ro,0,16,9,25,-0.64,0.64
ziarist,www.aktual24.ro,0,1,0,1,-1.0,1.0
Clotilde Armand,www.news.ro,0,3,1,4,-0.75,0.75
Ncușor Dan,www.news.ro,0,1,0,1,-1.0,1.0
Zuckermann,www.news.ro,0,1,0,1,-1.0,1.0
coleg,www.news.ro,8,1,18,27,0.25925925925925924,0.25925925925925924
independent,www.news.ro,0,4,3,7,-0.5714285714285714,0.5714285714285714
ș,www.news.ro,0,0,1,1,0.0,0.0
Mircea Geoană,www.euronews.ro,0,0,12,12,0.0,0.0
coleg,www.euronews.ro,7,2,11,20,0.25,0.25
Alexandru Rafila,agerpres.ro,0,4,3,7,-0.5714285714285714,0.5714285714285714
demnitar,agerpres.ro,0,5,0,5,-1.0,1.0
Ionuț Vulpescu,agerpres.ro,0,0,10,10,0.0,0.0
Mircea Abrudean,agerpres.ro,0,0,12,12,0.0,0.0
Ninel Peia,agerpres.ro,0,0,8,8,0.0,0.0
Oana Murariu,agerpres.ro,0,0,5,5,0.0,0.0
Rafila,agerpres.ro,0,7,0,7,-1.0,1.0
bărbat,agerpres.ro,0,0,6,6,0.0,0.0
cadru didactic,agerpres.ro,0,1,5,6,-0.16666666666666666,0.16666666666666666
Roberta Metsola,agerpres.ro,1,0,6,7,0.14285714285714285,0.14285714285714285
judecător,agerpres.ro,0,0,6,6,0.0,0.0
Dragnea,www.b1tv.ro,0,4,0,4,-1.0,1.0
Liviu Dragnea,www.b1tv.ro,0,1,0,1,-1.0,1.0
Nicolae Ciucă,www.b1tv.ro,0,0,8,8,0.0,0.0
Rusia,www.g4media.ro,0,23,2,25,-0.92,0.92
Teleorman,www.g4media.ro,0,0,2,2,0.0,0.0
grădinar,www.romaniatv.net,1,0,2,3,0.3333333333333333,0.3333333333333333
Marea Britanie,www.romaniatv.net,0,1,6,7,-0.14285714285714285,0.14285714285714285
specialist,www.romaniatv.net,3,0,4,7,0.42857142857142855,0.42857142857142855
Belgia,primanews.ro,0,0,2,2,0.0,0.0
Bola Ahmed Tinubu,primanews.ro,0,0,1,1,0.0,0.0
cancelar,primanews.ro,0,4,3,7,-0.5714285714285714,0.5714285714285714
Chicago,primanews.ro,0,0,2,2,0.0,0.0
credincios,primanews.ro,0,2,2,4,-0.5,0.5
Dina Boluarte,primanews.ro,0,0,1,1,0.0,0.0
Francisc,primanews.ro,0,0,1,1,0.0,0.0
François Bayrou,primanews.ro,0,0,1,1,0.0,0.0
Friedrich Merz,primanews.ro,0,1,6,7,-0.14285714285714285,0.14285714285714285
Giorgia Meloni,primanews.ro,1,0,2,3,0.3333333333333333,0.3333333333333333
Isaac Herzog,primanews.ro,0,0,1,1,0.0,0.0
Israel,primanews.ro,0,3,2,5,-0.6,0.6
JD Vance,primanews.ro,0,0,2,2,0.0,0.0
Jannik Sinner,primanews.ro,0,0,1,1,0.0,0.0
Letizia,primanews.ro,0,0,1,1,0.0,0.0
Mathilde,primanews.ro,0,0,1,1,0.0,0.0
Nigeria,primanews.ro,0,0,1,1,0.0,0.0
papă,primanews.ro,0,0,5,5,0.0,0.0
Papa Francisc,primanews.ro,0,0,1,1,0.0,0.0
Peru,primanews.ro,0,0,1,1,0.0,0.0
Robert Francis Prevost,primanews.ro,0,0,1,1,0.0,0.0
Roma,primanews.ro,0,0,2,2,0.0,0.0
Sfântul Petru,primanews.ro,0,0,1,1,0.0,0.0
Spania,primanews.ro,1,1,4,6,0.0,0.0
Statele Unite,primanews.ro,0,0,10,10,0.0,0.0
Donald Trump,primanews.ro,0,14,27,41,-0.34146341463414637,0.34146341463414637
Ucraina,primanews.ro,3,3,35,41,0.0,0.0
Ursula von der Leyen,primanews.ro,0,0,3,3,0.0,0.0
Vatican,primanews.ro,0,0,4,4,0.0,0.0
Vicepreședintele,primanews.ro,0,0,4,4,0.0,0.0
Volodimir Zelenski,primanews.ro,0,1,23,24,-0.041666666666666664,0.041666666666666664
arhitect,primanews.ro,1,0,1,2,0.5,0.5
beligerant,primanews.ro,0,1,0,1,-1.0,1.0
ilie,primanews.ro,0,0,1,1,0.0,0.0
jucător,primanews.ro,0,3,7,10,-0.3,0.3
jurnalist,primanews.ro,0,4,4,8,-0.5,0.5
lunetist,primanews.ro,0,1,0,1,-1.0,1.0
membru,primanews.ro,3,6,18,27,-0.1111111111111111,0.1111111111111111
mulțime,primanews.ro,0,1,0,1,-1.0,1.0
omolog,primanews.ro,0,1,9,10,-0.1,0.1
pescar,primanews.ro,0,0,1,1,0.0,0.0
predecesor,primanews.ro,0,2,0,2,-1.0,1.0
Edward de Edinburgh,primanews.ro,0,0,1,1,0.0,0.0
Philippe al Belgiei,primanews.ro,0,0,1,1,0.0,0.0
scafandru,primanews.ro,0,0,1,1,0.0,0.0
Marco Rubio,primanews.ro,0,0,6,6,0.0,0.0
vicepreședinte,primanews.ro,0,1,6,7,-0.14285714285714285,0.14285714285714285
vizitator,primanews.ro,0,0,3,3,0.0,0.0
voluntar,primanews.ro,0,0,1,1,0.0,0.0
Chirica,www.mediafax.ro,0,1,0,1,-1.0,1.0
Filip Havarneanu,www.mediafax.ro,0,1,0,1,-1.0,1.0
Filip Havârneanu,www.mediafax.ro,0,0,1,1,0.0,0.0
Gabriel Harabagiu,www.mediafax.ro,0,0,1,1,0.0,0.0
Iași,www.mediafax.ro,0,0,4,4,0.0,0.0
Mihai Chirica,www.mediafax.ro,0,3,0,3,-1.0,1.0
inculpat,www.mediafax.ro,0,3,0,3,-1.0,1.0
patron,www.mediafax.ro,0,1,0,1,-1.0,1.0
viceprimar,www.mediafax.ro,0,3,6,9,-0.3333333333333333,0.3333333333333333
Elmar Brok,stirileprotv.ro,0,0,1,1,0.0,0.0
Macovei,stirileprotv.ro,1,1,0,2,0.0,0.0
Monica Macovei,stirileprotv.ro,0,2,2,4,-0.5,0.5
Adrian Cozma,www.news.ro,0,0,2,2,0.0,0.0
Cozma,www.news.ro,0,0,1,1,0.0,0.0
Daniel Fenechiu,www.news.ro,0,0,2,2,0.0,0.0
Gabriel Andronache,www.news.ro,0,0,2,2,0.0,0.0
Corneliu Tudor,adevarul.ro,0,1,4,5,-0.2,0.2
Adolf Hitler,adevarul.ro,0,2,0,2,-1.0,1.0
Olanda,adevarul.ro,0,0,4,4,0.0,0.0
Veneția,adevarul.ro,0,0,1,1,0.0,0.0
Vladimir Putin,adevarul.ro,0,13,6,19,-0.6842105263157895,0.6842105263157895
dictator,adevarul.ro,0,5,0,5,-1.0,1.0
vinovat,adevarul.ro,0,5,0,5,-1.0,1.0
Burduja,www.news.ro,0,3,0,3,-1.0,1.0
Sebastian Burduja,www.news.ro,0,2,3,5,-0.4,0.4
Alina Patru,www.luju.ro,0,0,1,1,0.0,0.0
Craiova,www.luju.ro,0,0,2,2,0.0,0.0
videochatist,www.luju.ro,0,1,0,1,-1.0,1.0
investitor,www.digi24.ro,0,2,2,4,-0.5,0.5
Călin Donca,www.romaniatv.net,0,1,1,2,-0.5,0.5
Dan,www.realitatea.net,0,0,1,1,0.0,0.0
Ilfov,www.realitatea.net,0,0,7,7,0.0,0.0
M,www.realitatea.net,0,0,1,1,0.0,0.0
Marius Tucă,www.realitatea.net,0,1,2,3,-0.3333333333333333,0.3333333333333333
Nicușor Dan,www.realitatea.net,1,18,31,50,-0.34,0.34
T,www.realitatea.net,0,0,1,1,0.0,0.0
Tunari,www.realitatea.net,0,0,6,6,0.0,0.0
urmaș,www.realitatea.net,1,3,1,5,-0.4,0.4
Ăștia,www.realitatea.net,0,1,0,1,-1.0,1.0
Buzău,stirileprotv.ro,0,0,3,3,0.0,0.0
Caraș,stirileprotv.ro,0,0,1,1,0.0,0.0
Carmen Dan,stirileprotv.ro,0,0,3,3,0.0,0.0
Claudiu Manda,stirileprotv.ro,0,0,2,2,0.0,0.0
Codrin,stirileprotv.ro,0,0,1,1,0.0,0.0
Constanța,stirileprotv.ro,0,1,7,8,-0.125,0.125
corespondent,stirileprotv.ro,0,0,2,2,0.0,0.0
Cătălin Rădulescu,stirileprotv.ro,0,0,1,1,0.0,0.0
Dan,stirileprotv.ro,0,0,2,2,0.0,0.0
Dâmbovița,stirileprotv.ro,0,0,2,2,0.0,0.0
Felix Stroe,stirileprotv.ro,0,0,2,2,0.0,0.0
Gabriela Firea,stirileprotv.ro,0,2,5,7,-0.2857142857142857,0.2857142857142857
Giurgiu,stirileprotv.ro,0,0,4,4,0.0,0.0
Iași,stirileprotv.ro,0,0,4,4,0.0,0.0
Lia Olguța Vasilescu,stirileprotv.ro,0,0,2,2,0.0,0.0
Lucian Romascanu,stirileprotv.ro,0,0,1,1,0.0,0.0
Mihai Tudose,stirileprotv.ro,0,2,8,10,-0.2,0.2
Manda,stirileprotv.ro,0,1,0,1,-1.0,1.0
Marius Nica,stirileprotv.ro,0,0,2,2,0.0,0.0
Marius Tian,stirileprotv.ro,0,0,1,1,0.0,0.0
Mircea Dobre,stirileprotv.ro,0,1,2,3,-0.3333333333333333,0.3333333333333333
Negoiță,stirileprotv.ro,0,1,0,1,-1.0,1.0
Niculae Bădălău,stirileprotv.ro,0,0,1,1,0.0,0.0
Paul Stănescu,stirileprotv.ro,0,0,2,2,0.0,0.0
Robert Negoiță,stirileprotv.ro,0,0,1,1,0.0,0.0
Rădulescu,stirileprotv.ro,0,1,0,1,-1.0,1.0
Timiș,stirileprotv.ro,0,0,2,2,0.0,0.0
Tudose,stirileprotv.ro,0,2,1,3,-0.6666666666666666,0.6666666666666666
amândoi,stirileprotv.ro,0,1,0,1,-1.0,1.0
doamnă,stirileprotv.ro,0,0,1,1,0.0,0.0
dansator,stirileprotv.ro,0,0,1,1,0.0,0.0
factor,stirileprotv.ro,0,1,2,3,-0.3333333333333333,0.3333333333333333
mier,stirileprotv.ro,0,0,1,1,0.0,0.0
moldovean,stirileprotv.ro,0,1,0,1,-1.0,1.0
pedofil,stirileprotv.ro,0,1,0,1,-1.0,1.0
senator,stirileprotv.ro,0,8,13,21,-0.38095238095238093,0.38095238095238093
ul,stirileprotv.ro,0,2,1,3,-0.6666666666666666,0.6666666666666666
vicepreședinte,stirileprotv.ro,1,1,23,25,0.0,0.0
Diana Șoșoacă,observatornews.ro,0,6,10,16,-0.375,0.375
Elena Lasconi,observatornews.ro,1,9,45,55,-0.14545454545454545,0.14545454545454545
George Simion,observatornews.ro,1,1,21,23,0.0,0.0
Lasconi,observatornews.ro,0,4,12,16,-0.25,0.25
Arhiepiscop,www.comisarul.ro,0,0,1,1,0.0,0.0
Arhiepiscopul Tomisului,www.comisarul.ro,0,0,1,1,0.0,0.0
Constanța,www.comisarul.ro,0,0,7,7,0.0,0.0
Teodosie,www.comisarul.ro,0,0,3,3,0.0,0.0
ÎPS Teodosie,www.comisarul.ro,0,0,1,1,0.0,0.0
Donțu,pressone.ro,0,4,0,4,-1.0,1.0
Ecaterina Andronescu,pressone.ro,0,3,12,15,-0.2,0.2
Mircea Dumitru,pressone.ro,0,1,4,5,-0.2,0.2
Ovidiu Liviu Donțu,pressone.ro,0,1,2,3,-0.3333333333333333,0.3333333333333333
procuror,pressone.ro,0,41,6,47,-0.8723404255319149,0.8723404255319149
rector,pressone.ro,1,11,23,35,-0.2857142857142857,0.2857142857142857
Ovidiu Donțu,pressone.ro,0,0,1,1,0.0,0.0
Brașov,snoop.ro,0,0,14,14,0.0,0.0
Cătălin Mînzatu,snoop.ro,0,0,5,5,0.0,0.0
George Călin,snoop.ro,0,0,5,5,0.0,0.0
Ioan Daniel Cherecheș,snoop.ro,0,0,1,1,0.0,0.0
Marius Dunca,snoop.ro,0,0,1,1,0.0,0.0
politică,snoop.ro,0,4,1,5,-0.8,0.8
Roxana Mînzatu,snoop.ro,0,2,5,7,-0.2857142857142857,0.2857142857142857
a,snoop.ro,0,4,0,4,-1.0,1.0
comisar,snoop.ro,0,5,1,6,-0.8333333333333334,0.8333333333333334
familia Mînzatu,snoop.ro,0,2,1,3,-0.6666666666666666,0.6666666666666666
oo,snoop.ro,0,0,1,1,0.0,0.0
parlamentar,snoop.ro,0,13,3,16,-0.8125,0.8125
personal,snoop.ro,0,5,6,11,-0.45454545454545453,0.45454545454545453
soț,snoop.ro,0,5,24,29,-0.1724137931034483,0.1724137931034483
vicepreședinte,snoop.ro,0,1,12,13,-0.07692307692307693,0.07692307692307693
Attila Cseke,www.news.ro,0,1,2,3,-0.3333333333333333,0.3333333333333333
senator,www.news.ro,0,1,17,18,-0.05555555555555555,0.05555555555555555
Băsescu,stirileprotv.ro,0,10,6,16,-0.625,0.625
Ludovic Orban,stirileprotv.ro,0,3,9,12,-0.25,0.25
Burduja,www.gandul.ro,0,1,1,2,-0.5,0.5
bucureștean,www.gandul.ro,1,2,4,7,-0.14285714285714285,0.14285714285714285
Bucureștean,www.gandul.ro,2,1,1,4,0.25,0.25
liberal,www.gandul.ro,0,5,8,13,-0.38461538461538464,0.38461538461538464
populație,www.comisarul.ro,0,3,7,10,-0.3,0.3
colectiv,adevarul.ro,0,1,0,1,-1.0,1.0
Corneliu Coposu,adevarul.ro,0,1,3,4,-0.25,0.25
Cozmin Gușă,adevarul.ro,0,1,1,2,-0.5,0.5
Daniel Funeriu,adevarul.ro,0,0,19,19,0.0,0.0
Doina Cornea,adevarul.ro,0,0,2,2,0.0,0.0
liberal,adevarul.ro,0,9,7,16,-0.5625,0.5625
Neagu Djuvara,adevarul.ro,0,2,3,5,-0.4,0.4
Lucian Boia,adevarul.ro,0,0,1,1,0.0,0.0
istoric,adevarul.ro,0,3,7,10,-0.3,0.3
personalitate,adevarul.ro,2,2,12,16,0.0,0.0
soră,adevarul.ro,0,0,2,2,0.0,0.0
votant,adevarul.ro,0,18,21,39,-0.46153846153846156,0.46153846153846156
capitală,www.mediafax.ro,0,0,6,6,0.0,0.0
Colin Delany,www.mediafax.ro,0,0,1,1,0.0,0.0
fondator,www.mediafax.ro,0,1,2,3,-0.3333333333333333,0.3333333333333333
J. Edgar Hoover,www.mediafax.ro,0,1,0,1,-1.0,1.0
Kim Jong-un,www.mediafax.ro,0,0,1,1,0.0,0.0
reporter,www.mediafax.ro,0,0,2,2,0.0,0.0
Statele Unite,www.mediafax.ro,0,0,8,8,0.0,0.0
editor,www.mediafax.ro,0,0,1,1,0.0,0.0
popor,www.mediafax.ro,1,1,0,2,0.0,0.0
publicitar,www.mediafax.ro,0,1,0,1,-1.0,1.0
strateg,www.mediafax.ro,1,0,0,1,1.0,1.0
un,www.mediafax.ro,0,0,1,1,0.0,0.0
votant,www.mediafax.ro,0,0,1,1,0.0,0.0
Cătălin Zamfir,www.aktual24.ro,0,0,4,4,0.0,0.0
Mihai Tudose,www.aktual24.ro,0,1,9,10,-0.1,0.1
Oana Zamfir,www.aktual24.ro,0,1,3,4,-0.25,0.25
Zamfir,www.aktual24.ro,0,1,4,5,-0.2,0.2
Robert Sighiartau,www.aktual24.ro,0,0,4,4,0.0,0.0
senator,www.aktual24.ro,1,9,29,39,-0.20512820512820512,0.20512820512820512
Adrian Țuțuianu,www.comisarul.ro,0,0,1,1,0.0,0.0
Buzău,www.comisarul.ro,0,0,9,9,0.0,0.0
Constantin Toma,www.comisarul.ro,0,1,3,4,-0.25,0.25
Fifor,www.comisarul.ro,0,1,0,1,-1.0,1.0
Mihai Fifor,www.comisarul.ro,0,0,1,1,0.0,0.0
Mihai Tudose,www.comisarul.ro,0,1,9,10,-0.1,0.1
Romeo Lungu,www.comisarul.ro,0,0,2,2,0.0,0.0
elev,www.comisarul.ro,4,0,5,9,0.4444444444444444,0.4444444444444444
inițiator,www.comisarul.ro,0,0,3,3,0.0,0.0
observator,www.comisarul.ro,0,1,1,2,-0.5,0.5
secretar executiv,www.comisarul.ro,0,0,1,1,0.0,0.0
Andrei Cosmin,www.comisarul.ro,0,1,1,2,-0.5,0.5
Botoșani,www.comisarul.ro,0,0,1,1,0.0,0.0
Cosmin Andrei,www.comisarul.ro,0,1,1,2,-0.5,0.5
Doina Federovici,www.comisarul.ro,0,0,1,1,0.0,0.0
edil,www.comisarul.ro,0,6,2,8,-0.75,0.75
inculpat,www.comisarul.ro,0,6,2,8,-0.75,0.75
procuror,www.comisarul.ro,0,17,11,28,-0.6071428571428571,0.6071428571428571
amant,www.comisarul.ro,0,1,0,1,-1.0,1.0
anchetator,www.comisarul.ro,0,5,1,6,-0.8333333333333334,0.8333333333333334
beneficiar,www.comisarul.ro,0,2,0,2,-1.0,1.0
judecător,www.comisarul.ro,0,6,9,15,-0.4,0.4
ofițer,www.comisarul.ro,0,6,3,9,-0.6666666666666666,0.6666666666666666
Primarul Cosmin Andrei,www.comisarul.ro,0,1,0,1,-1.0,1.0
viceprimar,www.comisarul.ro,0,1,3,4,-0.25,0.25
șefă,www.comisarul.ro,0,2,7,9,-0.2222222222222222,0.2222222222222222
Madrid,www.romaniatv.net,0,0,2,2,0.0,0.0
Polonia,www.romaniatv.net,0,0,14,14,0.0,0.0
funcționar,www.romaniatv.net,0,3,3,6,-0.5,0.5
Alexandru Muraru,www.digi24.ro,0,1,0,1,-1.0,1.0
Muraru,www.digi24.ro,0,1,0,1,-1.0,1.0
civil,www.digi24.ro,0,2,4,6,-0.3333333333333333,0.3333333333333333
Crin Antonescu,www.luju.ro,2,10,5,17,-0.47058823529411764,0.47058823529411764
Simion,www.luju.ro,0,6,9,15,-0.4,0.4
Victor Ponta,www.luju.ro,0,7,3,10,-0.7,0.7
actor,www.luju.ro,0,2,3,5,-0.4,0.4
opozant,www.luju.ro,0,2,0,2,-1.0,1.0
prezidentabil,www.luju.ro,0,1,0,1,-1.0,1.0
sustinator,www.luju.ro,0,5,3,8,-0.625,0.625
utilizator,www.luju.ro,0,1,1,2,-0.5,0.5
Alfred Simonis,www.comisarul.ro,0,2,3,5,-0.4,0.4
Antonescu,www.comisarul.ro,0,8,13,21,-0.38095238095238093,0.38095238095238093
Sorin Grindeanu,www.comisarul.ro,0,3,6,9,-0.3333333333333333,0.3333333333333333
Cătălin Drulă,www.b1tv.ro,0,0,4,4,0.0,0.0
angajat,www.b1tv.ro,0,2,0,2,-1.0,1.0
guvernant,www.b1tv.ro,0,1,0,1,-1.0,1.0
ori,www.b1tv.ro,0,1,0,1,-1.0,1.0
zugrav,www.b1tv.ro,0,1,0,1,-1.0,1.0
Claudiu Târziu,primanews.ro,0,1,6,7,-0.14285714285714285,0.14285714285714285
Târziu,primanews.ro,0,2,0,2,-1.0,1.0
europarlamentar,primanews.ro,0,0,3,3,0.0,0.0
Băsescu,www.aktual24.ro,0,5,3,8,-0.625,0.625
Strugariu,www.aktual24.ro,0,1,0,1,-1.0,1.0
Nicolae Ciucă,www.aktual24.ro,3,5,16,24,-0.08333333333333333,0.08333333333333333
analfabet,www.aktual24.ro,0,1,0,1,-1.0,1.0
europarlamentar,www.aktual24.ro,3,4,9,16,-0.0625,0.0625
guvernant,www.aktual24.ro,0,1,0,1,-1.0,1.0
prezidentabil,www.aktual24.ro,0,0,1,1,0.0,0.0
Aurelian Pavelescu,www.b1tv.ro,0,0,1,1,0.0,0.0
capitală,www.b1tv.ro,0,0,3,3,0.0,0.0
Coposu,www.b1tv.ro,0,1,0,1,-1.0,1.0
Iliescu,www.b1tv.ro,0,2,0,2,-1.0,1.0
Pavelescu,www.b1tv.ro,0,1,0,1,-1.0,1.0
deținut,www.b1tv.ro,0,1,0,1,-1.0,1.0
minier,www.b1tv.ro,0,1,0,1,-1.0,1.0
utilizator,www.b1tv.ro,0,1,0,1,-1.0,1.0
Adrian Cioroianu,adevarul.ro,0,1,3,4,-0.25,0.25
Bulgaria,adevarul.ro,0,1,9,10,-0.1,0.1
Galab Donev,adevarul.ro,0,0,1,1,0.0,0.0
Natalia Gavrilița,adevarul.ro,0,0,1,1,0.0,0.0
Rumen Radev,adevarul.ro,0,0,1,1,0.0,0.0
Serb,adevarul.ro,0,0,8,8,0.0,0.0
Ungaria,adevarul.ro,0,5,6,11,-0.45454545454545453,0.45454545454545453
Ungarie,adevarul.ro,0,3,4,7,-0.42857142857142855,0.42857142857142855
secui,adevarul.ro,0,0,1,1,0.0,0.0
Alessandra Stoicescu,a1.ro,0,0,7,7,0.0,0.0
Antonescu,a1.ro,0,2,4,6,-0.3333333333333333,0.3333333333333333
Laura Codruța Kovesi,a1.ro,0,0,1,1,0.0,0.0
TU,a1.ro,8,0,2,10,0.8,0.8
tu ești,a1.ro,1,0,0,1,1.0,1.0
susținător,a1.ro,3,5,5,13,-0.15384615384615385,0.15384615384615385
Anca Alexandrescu,www.aktual24.ro,0,3,0,3,-1.0,1.0
Basist,www.aktual24.ro,0,1,0,1,-1.0,1.0
Bolojani,www.aktual24.ro,0,1,0,1,-1.0,1.0
Ciolaci,www.aktual24.ro,0,1,0,1,-1.0,1.0
Dragnea,www.aktual24.ro,0,6,2,8,-0.75,0.75
Frantei,www.aktual24.ro,0,3,10,13,-0.23076923076923078,0.23076923076923078
Grindeni,www.aktual24.ro,0,1,0,1,-1.0,1.0
Johannisti,www.aktual24.ro,0,1,0,1,-1.0,1.0
Liviu Dragnea,www.aktual24.ro,0,8,2,10,-0.8,0.8
Macron,www.aktual24.ro,0,2,7,9,-0.2222222222222222,0.2222222222222222
cantarete,www.aktual24.ro,0,1,0,1,-1.0,1.0
cantaret,www.aktual24.ro,0,1,0,1,-1.0,1.0
complic,www.aktual24.ro,0,1,0,1,-1.0,1.0
influencer,www.aktual24.ro,0,2,0,2,-1.0,1.0
marionetă,www.aktual24.ro,0,1,0,1,-1.0,1.0
prost,www.aktual24.ro,0,1,0,1,-1.0,1.0
simpatizant,www.aktual24.ro,0,2,1,3,-0.6666666666666666,0.6666666666666666
sportiv,www.aktual24.ro,0,1,2,3,-0.3333333333333333,0.3333333333333333
stăpân,www.aktual24.ro,0,3,0,3,-1.0,1.0
tu,www.aktual24.ro,0,1,0,1,-1.0,1.0
Bolsonaro,www.mediafax.ro,0,1,0,1,-1.0,1.0
Brazilia,www.mediafax.ro,0,0,2,2,0.0,0.0
Jair Bolsonaro,www.mediafax.ro,0,0,1,1,0.0,0.0
Manaus,www.mediafax.ro,0,0,1,1,0.0,0.0
politică,www.mediafax.ro,0,1,0,1,-1.0,1.0
Rio Grande do Norte,www.mediafax.ro,0,0,1,1,0.0,0.0
căpitan,www.mediafax.ro,0,1,0,1,-1.0,1.0
fiu,www.mediafax.ro,1,1,1,3,0.0,0.0
judecător,www.mediafax.ro,0,11,10,21,-0.5238095238095238,0.5238095238095238
Flavio Bolsonaro,www.mediafax.ro,0,0,1,1,0.0,0.0
Daniel Zamfir,www.gandul.ro,0,0,1,1,0.0,0.0
Zamfir,www.gandul.ro,0,0,1,1,0.0,0.0
parlamentar,www.gandul.ro,0,7,14,21,-0.3333333333333333,0.3333333333333333
senator,www.gandul.ro,0,3,16,19,-0.15789473684210525,0.15789473684210525
,recorder.ro,0,4,3,7,-0.5714285714285714,0.5714285714285714
Adrian Câciu,recorder.ro,0,0,2,2,0.0,0.0
Cătălin Predoiu,recorder.ro,0,1,4,5,-0.2,0.2
Friedrich Merz,recorder.ro,0,0,2,2,0.0,0.0
Ilie Bolojan,recorder.ro,0,2,7,9,-0.2222222222222222,0.2222222222222222
Merz,recorder.ro,0,0,1,1,0.0,0.0
Varșovia,recorder.ro,0,0,3,3,0.0,0.0
cancelar,recorder.ro,0,1,0,1,-1.0,1.0
cuplu,recorder.ro,0,0,2,2,0.0,0.0
interimar,recorder.ro,0,2,2,4,-0.5,0.5
salariaț,recorder.ro,1,3,0,4,-0.5,0.5
votant,recorder.ro,0,5,3,8,-0.625,0.625
z,recorder.ro,0,0,1,1,0.0,0.0
Antalya,www.mediafax.ro,0,0,1,1,0.0,0.0
Brădișteanu,www.mediafax.ro,0,0,1,1,0.0,0.0
Cioabă,www.mediafax.ro,0,1,0,1,-1.0,1.0
Florin Cioabă,www.mediafax.ro,0,1,0,1,-1.0,1.0
Șerban Brădișteanu,www.mediafax.ro,0,1,2,3,-0.3333333333333333,0.3333333333333333
Muntenegru,www.mediafax.ro,0,1,2,3,-0.3333333333333333,0.3333333333333333
Suceava,www.mediafax.ro,0,0,3,3,0.0,0.0
Turcia,www.mediafax.ro,0,0,1,1,0.0,0.0
familie,www.mediafax.ro,0,3,6,9,-0.3333333333333333,0.3333333333333333
rege,www.mediafax.ro,0,1,0,1,-1.0,1.0
Alexandria,recorder.ro,0,2,3,5,-0.4,0.4
Andreești,recorder.ro,0,0,1,1,0.0,0.0
Andreeștiu,recorder.ro,0,0,1,1,0.0,0.0
Balaur,recorder.ro,0,2,0,2,-1.0,1.0
Bârlad,recorder.ro,1,2,0,3,-0.3333333333333333,0.3333333333333333
Chevereșu Mare,recorder.ro,1,0,0,1,1.0,1.0
Christoph Daum,recorder.ro,0,1,0,1,-1.0,1.0
Constantin Rotaru,recorder.ro,0,0,1,1,0.0,0.0
Cubei,recorder.ro,0,1,0,1,-1.0,1.0
călător,recorder.ro,0,0,1,1,0.0,0.0
domnului,recorder.ro,1,2,1,4,-0.25,0.25
Dragoș Balauru,recorder.ro,0,0,1,1,0.0,0.0
Ion Ianăși,recorder.ro,0,1,0,1,-1.0,1.0
Liviu Pop,recorder.ro,0,1,2,3,-0.3333333333333333,0.3333333333333333
Lungești,recorder.ro,0,2,0,2,-1.0,1.0
Mangalia,recorder.ro,0,1,1,2,-0.5,0.5
Marius Vijulan,recorder.ro,0,1,0,1,-1.0,1.0
Muia,recorder.ro,1,1,0,2,0.0,0.0
Neamț,recorder.ro,0,5,2,7,-0.7142857142857143,0.7142857142857143
Oradea,recorder.ro,0,1,7,8,-0.125,0.125
polițist,recorder.ro,0,20,4,24,-0.8333333333333334,0.8333333333333334
Rotunda,recorder.ro,0,1,0,1,-1.0,1.0
Râmnicu Vâlcea,recorder.ro,0,0,2,2,0.0,0.0
Shhaideh,recorder.ro,0,0,1,1,0.0,0.0
Sibiul Moldovei,recorder.ro,1,0,0,1,1.0,1.0
Tiberiu Costea,recorder.ro,1,0,0,1,1.0,1.0
Timiș,recorder.ro,2,0,6,8,0.25,0.25
Vladimir,recorder.ro,0,1,0,1,-1.0,1.0
Vâlcea,recorder.ro,0,0,3,3,0.0,0.0
adversar,recorder.ro,0,12,0,12,-1.0,1.0
Denis Zmeu,recorder.ro,0,0,1,1,0.0,0.0
Silviu Balaure,recorder.ro,0,1,0,1,-1.0,1.0
cen,recorder.ro,0,1,0,1,-1.0,1.0
consătenitor,recorder.ro,0,1,0,1,-1.0,1.0
credincios,recorder.ro,0,0,2,2,0.0,0.0
doamnă,recorder.ro,0,3,3,6,-0.5,0.5
enoriaș,recorder.ro,0,2,0,2,-1.0,1.0
Ionuț Balaur,recorder.ro,0,0,1,1,0.0,0.0
gorjen,recorder.ro,0,1,1,2,-0.5,0.5
jucător,recorder.ro,0,3,2,5,-0.6,0.6
microbist,recorder.ro,0,1,0,1,-1.0,1.0
neisprăvit,recorder.ro,0,1,0,1,-1.0,1.0
oficial,recorder.ro,0,5,2,7,-0.7142857142857143,0.7142857142857143
oltean,recorder.ro,0,3,2,5,-0.6,0.6
omul legii,recorder.ro,0,1,0,1,-1.0,1.0
popă,recorder.ro,0,5,0,5,-1.0,1.0
portar,recorder.ro,0,1,2,3,-0.3333333333333333,0.3333333333333333
Marcel Muia,recorder.ro,1,0,0,1,1.0,1.0
părintele Duma,recorder.ro,0,1,0,1,-1.0,1.0
selecționer,recorder.ro,0,1,0,1,-1.0,1.0
slujitor,recorder.ro,0,2,0,2,-1.0,1.0
șmecher,recorder.ro,0,1,0,1,-1.0,1.0
șofer,recorder.ro,0,14,6,20,-0.7,0.7
Aurelian Pilcă,www.comisarul.ro,0,1,0,1,-1.0,1.0
Cei,www.comisarul.ro,0,1,0,1,-1.0,1.0
Chițac,www.comisarul.ro,0,1,0,1,-1.0,1.0
Cristina Dumitrache,www.comisarul.ro,0,0,1,1,0.0,0.0
Decebal Făgădău,www.comisarul.ro,0,1,1,2,-0.5,0.5
Dumitrache,www.comisarul.ro,0,0,1,1,0.0,0.0
Eugen Bogatu,www.comisarul.ro,0,1,0,1,-1.0,1.0
Felix Stroe,www.comisarul.ro,0,1,1,2,-0.5,0.5
fiică,www.comisarul.ro,1,2,2,5,-0.2,0.2
Ion Dumitrache,www.comisarul.ro,0,0,2,2,0.0,0.0
Italia,www.comisarul.ro,1,1,10,12,0.0,0.0
Jean Paul Tucan,www.comisarul.ro,0,0,1,1,0.0,0.0
Marea Britanie,www.comisarul.ro,0,1,12,13,-0.07692307692307693,0.07692307692307693
Mazăre,www.comisarul.ro,0,0,1,1,0.0,0.0
Mihai Stanciu,www.comisarul.ro,0,1,0,1,-1.0,1.0
Nicolae Stanciu,www.comisarul.ro,0,1,1,2,-0.5,0.5
Nicușor Constantinescu,www.comisarul.ro,0,0,1,1,0.0,0.0
Pilcă,www.comisarul.ro,0,1,0,1,-1.0,1.0
Radu Mazăre,www.comisarul.ro,0,2,0,2,-1.0,1.0
Sorin Strutinsky,www.comisarul.ro,0,1,0,1,-1.0,1.0
Stroe,www.comisarul.ro,0,0,1,1,0.0,0.0
Vasile Costea,www.comisarul.ro,0,1,0,1,-1.0,1.0
Vergil Chițac,www.comisarul.ro,0,1,0,1,-1.0,1.0
om de afaceri,www.comisarul.ro,0,5,6,11,-0.45454545454545453,0.45454545454545453
partener,www.comisarul.ro,2,0,9,11,0.18181818181818182,0.18181818181818182
vameș,www.comisarul.ro,0,2,0,2,-1.0,1.0
Albania,www.mediafax.ro,0,0,1,1,0.0,0.0
Cristina Pocora,www.mediafax.ro,0,1,0,1,-1.0,1.0
Călin Popescu Tăriceanu,www.mediafax.ro,0,3,7,10,-0.3,0.3
Grecia,www.mediafax.ro,0,0,1,1,0.0,0.0
purtător de cuvânt,www.mediafax.ro,0,2,5,7,-0.2857142857142857,0.2857142857142857
domnul Ponta,www.mediafax.ro,0,1,0,1,-1.0,1.0
psiholog,www.mediafax.ro,0,1,0,1,-1.0,1.0
Dumnezeu,www.g4media.ro,2,0,2,4,0.5,0.5
Moldova,www.g4media.ro,2,1,2,5,0.2,0.2
SUA,www.g4media.ro,4,7,9,20,-0.15,0.15
frate,www.g4media.ro,2,4,1,7,-0.2857142857142857,0.2857142857142857
mort,www.g4media.ro,1,1,0,2,0.0,0.0
oficial,www.g4media.ro,0,2,1,3,-0.6666666666666666,0.6666666666666666
popor,www.g4media.ro,2,2,1,5,0.0,0.0
Argeș,www.gandul.ro,0,0,2,2,0.0,0.0
Marius Budăi,www.gandul.ro,0,1,0,1,-1.0,1.0
prim-ministru,www.gandul.ro,2,3,23,28,-0.03571428571428571,0.03571428571428571
Adrian Oros,recorder.ro,0,0,3,3,0.0,0.0
Alin Tișe,recorder.ro,0,0,1,1,0.0,0.0
Anglia,recorder.ro,0,1,7,8,-0.125,0.125
Aurelia Cristea,recorder.ro,0,0,1,1,0.0,0.0
Belgia,recorder.ro,0,0,4,4,0.0,0.0
Boc,recorder.ro,0,3,0,3,-1.0,1.0
Băsescu,recorder.ro,0,7,3,10,-0.7,0.7
Cîțu,recorder.ro,0,1,3,4,-0.25,0.25
Din,recorder.ro,0,0,1,1,0.0,0.0
Orban,recorder.ro,1,4,3,8,-0.375,0.375
Sabin Sărmaș,recorder.ro,0,0,2,2,0.0,0.0
at,recorder.ro,0,0,1,1,0.0,0.0
contracan,recorder.ro,0,1,0,1,-1.0,1.0
Emanuel Ungureanu,recorder.ro,0,1,1,2,-0.5,0.5
independent,recorder.ro,1,2,3,6,-0.16666666666666666,0.16666666666666666
inițiat,recorder.ro,1,0,0,1,1.0,1.0
naș,recorder.ro,0,3,0,3,-1.0,1.0
oponent,recorder.ro,0,2,0,2,-1.0,1.0
Ariadna Cîrligeanu,www.euronews.ro,0,1,0,1,-1.0,1.0
Boboci,www.euronews.ro,0,1,0,1,-1.0,1.0
Corneliu Tudor,www.euronews.ro,0,1,0,1,-1.0,1.0
Silvia Mihalcea,www.euronews.ro,0,0,1,1,0.0,0.0
fiu,www.euronews.ro,0,2,1,3,-0.6666666666666666,0.6666666666666666
fiică,www.euronews.ro,0,2,0,2,-1.0,1.0
Lidia,www.euronews.ro,0,1,0,1,-1.0,1.0
aleș,www.euronews.ro,0,1,2,3,-0.3333333333333333,0.3333333333333333
jurnalist,www.euronews.ro,0,9,15,24,-0.375,0.375
nepoată,www.euronews.ro,0,1,0,1,-1.0,1.0
secretar,www.euronews.ro,0,1,13,14,-0.07142857142857142,0.07142857142857142
tată,www.euronews.ro,0,0,1,1,0.0,0.0
Andy Ogles,adevarul.ro,0,0,6,6,0.0,0.0
Anna Paulina Luna,adevarul.ro,0,0,6,6,0.0,0.0
Bolojan,adevarul.ro,2,7,11,20,-0.25,0.25
Brian Hughes,adevarul.ro,0,0,1,1,0.0,0.0
Cazanciuc,adevarul.ro,0,0,1,1,0.0,0.0
Cotroceni,adevarul.ro,0,1,20,21,-0.047619047619047616,0.047619047619047616
Dina Titus,adevarul.ro,0,0,5,5,0.0,0.0
Ilhan Omar,adevarul.ro,0,0,5,5,0.0,0.0
Kathleen Kavalec,adevarul.ro,0,0,1,1,0.0,0.0
Lloyd Doggett,adevarul.ro,0,0,5,5,0.0,0.0
Neal Dunn,adevarul.ro,0,0,5,5,0.0,0.0
Robert Cazanciuc,adevarul.ro,0,0,1,1,0.0,0.0
Ted Lieu,adevarul.ro,0,0,5,5,0.0,0.0
Vern Buchanan,adevarul.ro,0,0,6,6,0.0,0.0
Washington,adevarul.ro,0,1,13,14,-0.07142857142857142,0.07142857142857142
cetățean,adevarul.ro,20,21,66,107,-0.009345794392523364,0.009345794392523364
congresman,adevarul.ro,0,0,7,7,0.0,0.0
purtător,adevarul.ro,0,1,0,1,-1.0,1.0
Ștefan Poepescu,adevarul.ro,0,0,1,1,0.0,0.0
Ștefan Popescu,adevarul.ro,0,0,1,1,0.0,0.0
secretar de stat,stirileprotv.ro,0,1,8,9,-0.1111111111111111,0.1111111111111111
,pressone.ro,0,10,3,13,-0.7692307692307693,0.7692307692307693
Ana Moldovan,pressone.ro,0,0,3,3,0.0,0.0
Cătălin Teniță,pressone.ro,0,0,1,1,0.0,0.0
Bihor,pressone.ro,0,1,11,12,-0.08333333333333333,0.08333333333333333
Bobora,pressone.ro,0,0,2,2,0.0,0.0
Cherecheș,pressone.ro,0,2,0,2,-1.0,1.0
Dale,pressone.ro,0,1,0,1,-1.0,1.0
Daniel Cherecheș,pressone.ro,0,0,1,1,0.0,0.0
Dinainte,pressone.ro,0,1,0,1,-1.0,1.0
dirigintă,pressone.ro,0,2,0,2,-1.0,1.0
Io,pressone.ro,0,0,1,1,0.0,0.0
Lucian Muntean,pressone.ro,0,1,38,39,-0.02564102564102564,0.02564102564102564
Maramureș,pressone.ro,1,2,9,12,-0.08333333333333333,0.08333333333333333
Mehedinți,pressone.ro,0,0,5,5,0.0,0.0
Mircea Bobora,pressone.ro,0,0,1,1,0.0,0.0
Nașul,pressone.ro,0,1,3,4,-0.25,0.25
Raluca Pancu,pressone.ro,0,0,1,1,0.0,0.0
sector,pressone.ro,0,2,1,3,-0.6666666666666666,0.6666666666666666
Simeria,pressone.ro,0,0,1,1,0.0,0.0
anonim,pressone.ro,0,1,0,1,-1.0,1.0
călător,pressone.ro,0,1,1,2,-0.5,0.5
Jusztinusz,pressone.ro,0,1,0,1,-1.0,1.0
fiu,pressone.ro,1,6,15,22,-0.22727272727272727,0.22727272727272727
fotoreporter,pressone.ro,0,0,1,1,0.0,0.0
io,pressone.ro,0,1,1,2,-0.5,0.5
naș,pressone.ro,0,7,0,7,-1.0,1.0
paznic,pressone.ro,0,1,5,6,-0.16666666666666666,0.16666666666666666
Robu,pressone.ro,1,1,3,5,0.0,0.0
Nicolae Gheorghe,pressone.ro,0,0,1,1,0.0,0.0
părinte,pressone.ro,3,10,10,23,-0.30434782608695654,0.30434782608695654
sportiv,pressone.ro,3,1,3,7,0.2857142857142857,0.2857142857142857
învățător,pressone.ro,0,1,2,3,-0.3333333333333333,0.3333333333333333
ăsta,pressone.ro,0,1,0,1,-1.0,1.0
șefă,pressone.ro,0,6,8,14,-0.42857142857142855,0.42857142857142855
Dușa,www.euronews.ro,0,0,1,1,0.0,0.0
Mircea Dușa,www.euronews.ro,0,0,1,1,0.0,0.0
Romeo Focșa,www.euronews.ro,0,0,1,1,0.0,0.0
Târgu Mureș,www.euronews.ro,0,0,3,3,0.0,0.0
Voctor Ponta,www.euronews.ro,0,0,1,1,0.0,0.0
prefect,www.euronews.ro,0,2,2,4,-0.5,0.5
secretar general,www.euronews.ro,0,0,7,7,0.0,0.0
Mathias Cormann,www.gandul.ro,0,0,1,1,0.0,0.0
Secretar General,www.gandul.ro,0,0,1,1,0.0,0.0
expert,www.gandul.ro,0,2,4,6,-0.3333333333333333,0.3333333333333333
funcționar public,www.gandul.ro,0,1,0,1,-1.0,1.0
Becali,www.b1tv.ro,0,2,3,5,-0.4,0.4
Gigi Becali,www.b1tv.ro,0,4,1,5,-0.8,0.8
Ioan Olteanu,www.b1tv.ro,0,0,1,1,0.0,0.0
Ionuț Luțu,www.b1tv.ro,0,0,1,1,0.0,0.0
Laurențiu Ionescu,www.b1tv.ro,0,0,1,1,0.0,0.0
patron,www.b1tv.ro,0,3,0,3,-1.0,1.0
petenților,www.b1tv.ro,0,1,0,1,-1.0,1.0
roșu,www.b1tv.ro,0,0,1,1,0.0,0.0
șofer,www.b1tv.ro,0,0,1,1,0.0,0.0
Adrian Cozma,www.euronews.ro,0,0,2,2,0.0,0.0
Modrogan,www.euronews.ro,0,0,1,1,0.0,0.0
Robert Sighiartău,www.euronews.ro,0,0,2,2,0.0,0.0
etnic,www.euronews.ro,0,1,1,2,-0.5,0.5
liberal,www.euronews.ro,1,2,0,3,-0.3333333333333333,0.3333333333333333
Antonescu,www.b1tv.ro,0,4,10,14,-0.2857142857142857,0.2857142857142857
Ucraina,www.b1tv.ro,1,2,4,7,-0.14285714285714285,0.14285714285714285
Ianukovici,www.aktual24.ro,0,1,0,1,-1.0,1.0
Kiev,www.aktual24.ro,0,3,4,7,-0.42857142857142855,0.42857142857142855
Kostiantin Kobzar,www.aktual24.ro,0,1,0,1,-1.0,1.0
Rubliovka,www.aktual24.ro,0,0,1,1,0.0,0.0
Viktor Ianukovici,www.aktual24.ro,0,1,0,1,-1.0,1.0
asociat,www.aktual24.ro,0,1,2,3,-0.3333333333333333,0.3333333333333333
personal,www.aktual24.ro,0,2,3,5,-0.4,0.4
capitală,www.gandul.ro,0,0,7,7,0.0,0.0
Constanța,www.gandul.ro,0,0,3,3,0.0,0.0
Dominic Fritz,www.gandul.ro,0,2,13,15,-0.13333333333333333,0.13333333333333333
Gabriel Zetea,www.gandul.ro,0,0,1,1,0.0,0.0
George Tuță,www.gandul.ro,0,1,2,3,-0.3333333333333333,0.3333333333333333
Ionel Bogdan,www.gandul.ro,0,0,2,2,0.0,0.0
Iulian Dumitrescu,www.gandul.ro,0,1,1,2,-0.5,0.5
Maramureș,www.gandul.ro,0,0,1,1,0.0,0.0
Ploiești,www.gandul.ro,0,0,1,1,0.0,0.0
Timișoara,www.gandul.ro,1,0,5,6,0.16666666666666666,0.16666666666666666
Vește,www.gandul.ro,0,1,0,1,-1.0,1.0
Veștea,www.gandul.ro,0,0,1,1,0.0,0.0
Voloșevici,www.gandul.ro,0,1,0,1,-1.0,1.0
Adrian Veștea,www.gandul.ro,0,0,1,1,0.0,0.0
Nicolae Robu,www.gandul.ro,0,0,1,1,0.0,0.0
Rareș Hopincă,www.gandul.ro,0,0,2,2,0.0,0.0
Andrei Voloșevici,www.gandul.ro,0,0,1,1,0.0,0.0
Decebal Făgădău,www.gandul.ro,0,0,1,1,0.0,0.0
Adrian Năstase,www.b1tv.ro,0,2,5,7,-0.2857142857142857,0.2857142857142857
Bolojan,www.b1tv.ro,1,2,2,5,-0.2,0.2
Năstase,www.b1tv.ro,1,2,0,3,-0.3333333333333333,0.3333333333333333
candidați,www.b1tv.ro,1,4,2,7,-0.42857142857142855,0.42857142857142855
cetățean,www.b1tv.ro,3,8,6,17,-0.29411764705882354,0.29411764705882354
Cîțu,www.g4media.ro,0,1,1,2,-0.5,0.5
Dan Vîlceanu,www.g4media.ro,0,0,2,2,0.0,0.0
Eduard Hellvig,www.g4media.ro,0,0,2,2,0.0,0.0
Florin Cîțu,www.g4media.ro,0,0,1,1,0.0,0.0
Hellvig,www.g4media.ro,0,0,1,1,0.0,0.0
Vîlceanu,www.g4media.ro,0,0,1,1,0.0,0.0
Biden,www.realitatea.net,0,2,1,3,-0.6666666666666666,0.6666666666666666
Blinken,www.realitatea.net,0,1,0,1,-1.0,1.0
Elon,www.realitatea.net,0,0,1,1,0.0,0.0
Germania,www.realitatea.net,0,2,3,5,-0.4,0.4
Mario Nawfal,www.realitatea.net,0,1,1,2,-0.5,0.5
New York,www.realitatea.net,0,0,1,1,0.0,0.0
Soroș,www.realitatea.net,0,2,0,2,-1.0,1.0
Thierry Breton,www.realitatea.net,0,0,1,1,0.0,0.0
comisar,www.realitatea.net,0,0,1,1,0.0,0.0
den,www.realitatea.net,0,1,0,1,-1.0,1.0
străin,www.realitatea.net,0,1,0,1,-1.0,1.0
Ciucă,www.cotidianul.ro,0,7,4,11,-0.6363636363636364,0.6363636363636364
Dan,www.cotidianul.ro,1,2,1,4,-0.25,0.25
Ianțu,www.cotidianul.ro,0,1,0,1,-1.0,1.0
Mirabela Grădinaru,www.cotidianul.ro,0,0,1,1,0.0,0.0
băiețel,www.cotidianul.ro,0,0,1,1,0.0,0.0
concubin,www.cotidianul.ro,0,1,0,1,-1.0,1.0
copil,www.cotidianul.ro,1,2,3,6,-0.16666666666666666,0.16666666666666666
fetiță,www.cotidianul.ro,0,0,1,1,0.0,0.0
partener,www.cotidianul.ro,1,3,3,7,-0.2857142857142857,0.2857142857142857
Cristi Diaconescu,adevarul.ro,0,0,2,2,0.0,0.0
Kelemen Hunor,adevarul.ro,0,1,20,21,-0.047619047619047616,0.047619047619047616
Adrian Copilul Minune,recorder.ro,0,0,1,1,0.0,0.0
Câmpia Română,recorder.ro,0,0,1,1,0.0,0.0
Eduard Popica,recorder.ro,0,0,1,1,0.0,0.0
Emil Savin,recorder.ro,0,0,2,2,0.0,0.0
Florian Belu,recorder.ro,1,0,0,1,1.0,1.0
Gabriel Cârjan,recorder.ro,2,0,1,3,0.6666666666666666,0.6666666666666666
Iulian Iacomi,recorder.ro,1,0,0,1,1.0,1.0
Lehliu,recorder.ro,0,0,1,1,0.0,0.0
Marian Pîrloagă,recorder.ro,0,1,0,1,-1.0,1.0
OM,recorder.ro,0,0,1,1,0.0,0.0
Popica,recorder.ro,0,3,1,4,-0.75,0.75
Saelele,recorder.ro,1,0,0,1,1.0,1.0
Teleorman,recorder.ro,2,5,9,16,-0.1875,0.1875
Unirea,recorder.ro,0,0,1,1,0.0,0.0
Vaslui,recorder.ro,1,3,7,11,-0.18181818181818182,0.18181818181818182
ațel,recorder.ro,1,0,0,1,1.0,1.0
bărbat,recorder.ro,0,14,19,33,-0.42424242424242425,0.42424242424242425
interlocutor,recorder.ro,0,1,0,1,-1.0,1.0
Virgil Elisei,recorder.ro,1,0,0,1,1.0,1.0
reporter,recorder.ro,0,6,8,14,-0.42857142857142855,0.42857142857142855
soție,recorder.ro,0,4,13,17,-0.23529411764705882,0.23529411764705882
țăran,recorder.ro,2,7,2,11,-0.45454545454545453,0.45454545454545453
Horia Ioan Marinescu,www.b1tv.ro,0,0,1,1,0.0,0.0
Adrian Țuțuianu,www.g4media.ro,0,1,1,2,-0.5,0.5
Fifor,www.g4media.ro,0,1,0,1,-1.0,1.0
Mihai Fifor,www.g4media.ro,0,0,5,5,0.0,0.0
om politic,www.g4media.ro,0,2,0,2,-1.0,1.0
susținător,www.g4media.ro,3,12,8,23,-0.391304347826087,0.391304347826087
Sorin Ioniță,www.g4media.ro,0,0,2,2,0.0,0.0
moderator,primanews.ro,0,0,2,2,0.0,0.0
Anamaria Gavrila,stirileprotv.ro,0,1,0,1,-1.0,1.0
Becali,stirileprotv.ro,0,2,0,2,-1.0,1.0
George Becali,stirileprotv.ro,0,2,3,5,-0.4,0.4
Claudiu Sandu,www.luju.ro,0,2,0,2,-1.0,1.0
Daniel Gradinaru,www.luju.ro,0,0,1,1,0.0,0.0
Daniel Horodniceanu,www.luju.ro,0,0,1,1,0.0,0.0
Denisa Stanisor,www.luju.ro,0,0,2,2,0.0,0.0
Emilia,www.luju.ro,0,0,1,1,0.0,0.0
Emilia Ion,www.luju.ro,0,0,1,1,0.0,0.0
Gradinaru,www.luju.ro,0,1,2,3,-0.3333333333333333,0.3333333333333333
Horo,www.luju.ro,0,0,1,1,0.0,0.0
Horodniceanu,www.luju.ro,0,0,1,1,0.0,0.0
Liviu Odagiu,www.luju.ro,0,0,1,1,0.0,0.0
Sandu,www.luju.ro,0,2,0,2,-1.0,1.0
activist,www.luju.ro,0,2,1,3,-0.6666666666666666,0.6666666666666666
ceilalți,www.luju.ro,1,3,0,4,-0.5,0.5
cuiva,www.luju.ro,0,1,0,1,-1.0,1.0
Odagiu,www.luju.ro,0,2,0,2,-1.0,1.0
procuror Sandu,www.luju.ro,0,1,0,1,-1.0,1.0
procuror Horodniceanu,www.luju.ro,0,1,0,1,-1.0,1.0
gentleman,www.luju.ro,0,0,1,1,0.0,0.0
infractor,www.luju.ro,0,5,0,5,-1.0,1.0
Stanisor,www.luju.ro,0,1,0,1,-1.0,1.0
suporter,www.luju.ro,0,1,0,1,-1.0,1.0
Alin Stoica,observatornews.ro,0,0,2,2,0.0,0.0
Anca Dragu,observatornews.ro,0,0,2,2,0.0,0.0
cioloș,observatornews.ro,0,2,2,4,-0.5,0.5
Claudiu Năsui,observatornews.ro,0,0,2,2,0.0,0.0
Corina Atanasiu,observatornews.ro,0,0,1,1,0.0,0.0
Cosette Chichirău,observatornews.ro,0,0,3,3,0.0,0.0
Cristian Ghinea,observatornews.ro,0,2,4,6,-0.3333333333333333,0.3333333333333333
Cristina Prună,observatornews.ro,0,0,4,4,0.0,0.0
Cătălin Drulă,observatornews.ro,2,1,9,12,0.08333333333333333,0.08333333333333333
Dan Barna,observatornews.ro,0,0,6,6,0.0,0.0
Dragoș Pîslaru,observatornews.ro,0,0,2,2,0.0,0.0
George Cățean,observatornews.ro,0,0,1,1,0.0,0.0
Ioana Mihăilă,observatornews.ro,0,0,2,2,0.0,0.0
Ionuț Moșteanu,observatornews.ro,0,1,7,8,-0.125,0.125
Iulia Popovici,observatornews.ro,0,0,2,2,0.0,0.0
Marius Manole,observatornews.ro,0,0,2,2,0.0,0.0
Mihai Goțiu,observatornews.ro,0,0,1,1,0.0,0.0
Monica Berescu,observatornews.ro,0,0,2,2,0.0,0.0
Nicu Fălcoi,observatornews.ro,0,0,1,1,0.0,0.0
Oana Țoiu,observatornews.ro,0,0,3,3,0.0,0.0
Stelian Ion,observatornews.ro,0,0,3,3,0.0,0.0
Tudor Pop,observatornews.ro,0,0,1,1,0.0,0.0
europarlamentar,observatornews.ro,2,0,6,8,0.25,0.25
miniștri,observatornews.ro,0,4,16,20,-0.2,0.2
prefect,observatornews.ro,0,1,2,3,-0.3333333333333333,0.3333333333333333
țu,observatornews.ro,0,0,1,1,0.0,0.0
minister,primanews.ro,0,1,0,1,-1.0,1.0
guvernant,primanews.ro,0,1,0,1,-1.0,1.0
reprezentant,primanews.ro,0,9,14,23,-0.391304347826087,0.391304347826087
Danilet,www.aktual24.ro,0,1,0,1,-1.0,1.0
Cristi Danilet,www.aktual24.ro,0,1,0,1,-1.0,1.0
public,www.aktual24.ro,0,4,2,6,-0.6666666666666666,0.6666666666666666
vinovat,www.aktual24.ro,0,1,0,1,-1.0,1.0
semnatar,www.mediafax.ro,2,1,0,3,0.3333333333333333,0.3333333333333333
Geoană,www.realitatea.net,0,1,2,3,-0.3333333333333333,0.3333333333333333
oficial,www.realitatea.net,0,4,0,4,-1.0,1.0
actor,www.realitatea.net,0,2,1,3,-0.6666666666666666,0.6666666666666666
bogat,www.realitatea.net,0,2,0,2,-1.0,1.0
comentator,www.realitatea.net,0,2,0,2,-1.0,1.0
secretar general adjunct,www.realitatea.net,0,0,1,1,0.0,0.0
sărac,www.realitatea.net,0,1,0,1,-1.0,1.0
Antonio Costa,www.aktual24.ro,0,0,3,3,0.0,0.0
Costa,www.aktual24.ro,0,0,2,2,0.0,0.0
Metsola,www.aktual24.ro,0,0,1,1,0.0,0.0
Roberta Metsola,www.aktual24.ro,0,0,1,1,0.0,0.0
Ursula von der Leyen,www.aktual24.ro,0,0,6,6,0.0,0.0
X,www.aktual24.ro,0,0,3,3,0.0,0.0
von der Leyen,www.aktual24.ro,0,0,2,2,0.0,0.0
Bucureștean,adevarul.ro,1,1,4,6,0.0,0.0
Bolojan,a1.ro,0,0,2,2,0.0,0.0
Bulgaria,a1.ro,0,0,1,1,0.0,0.0
Canada,a1.ro,0,0,2,2,0.0,0.0
Croația,a1.ro,0,0,1,1,0.0,0.0
Emil Hurezeanu,a1.ro,0,0,1,1,0.0,0.0
Emmanuel Macron,a1.ro,0,0,1,1,0.0,0.0
Externe,a1.ro,0,0,1,1,0.0,0.0
Grecia,a1.ro,1,0,4,5,0.2,0.2
Laura Vicol,a1.ro,0,0,3,3,0.0,0.0
Lucia Maria,a1.ro,0,0,1,1,0.0,0.0
Luminița Odobescu,a1.ro,0,0,1,1,0.0,0.0
ministru de externe,a1.ro,0,0,1,1,0.0,0.0
Polonia,a1.ro,0,0,2,2,0.0,0.0
președinte interimar,a1.ro,0,0,2,2,0.0,0.0
Secretar General,a1.ro,0,0,1,1,0.0,0.0
Ucraina,a1.ro,1,1,1,3,0.0,0.0
aliat,a1.ro,0,1,1,2,-0.5,0.5
client,a1.ro,0,1,5,6,-0.16666666666666666,0.16666666666666666
sprijinitor,a1.ro,1,0,0,1,1.0,1.0
șef de stat,a1.ro,0,0,3,3,0.0,0.0
Austria,www.romaniatv.net,0,0,6,6,0.0,0.0
Barcelona,www.romaniatv.net,0,0,1,1,0.0,0.0
Basarabia,www.romaniatv.net,0,1,0,1,-1.0,1.0
Cipru,www.romaniatv.net,0,1,2,3,-0.3333333333333333,0.3333333333333333
Corneliu Zelea Codreanu,www.romaniatv.net,0,1,4,5,-0.2,0.2
Căușeni,www.romaniatv.net,0,0,1,1,0.0,0.0
Dublin,www.romaniatv.net,0,0,2,2,0.0,0.0
Elche,www.romaniatv.net,0,0,1,1,0.0,0.0
Hâncești,www.romaniatv.net,0,1,0,1,-1.0,1.0
Ialoveni,www.romaniatv.net,0,0,1,1,0.0,0.0
Innsbruck,www.romaniatv.net,0,0,1,1,0.0,0.0
Irlanda,www.romaniatv.net,0,0,4,4,0.0,0.0
Liverpool,www.romaniatv.net,0,0,1,1,0.0,0.0
Palmas de Gran Canaria,www.romaniatv.net,0,0,1,1,0.0,0.0
Statele Unite,www.romaniatv.net,1,0,5,6,0.16666666666666666,0.16666666666666666
jurnalist,www.romaniatv.net,1,11,19,31,-0.3225806451612903,0.3225806451612903
procuror,www.romaniatv.net,0,7,2,9,-0.7777777777777778,0.7777777777777778
turișt,www.romaniatv.net,0,1,1,2,-0.5,0.5
Pisaroglu,adevarul.ro,0,3,3,6,-0.5,0.5
SUA,www.gandul.ro,1,3,27,31,-0.06451612903225806,0.06451612903225806
Sankt Petersburg,www.gandul.ro,0,0,1,1,0.0,0.0
Steve Witkoff,www.gandul.ro,0,0,1,1,0.0,0.0
Sumî,www.gandul.ro,0,1,0,1,-1.0,1.0
Vadim Ghirda,www.gandul.ro,0,0,1,1,0.0,0.0
Vladimir Putin,www.gandul.ro,0,6,1,7,-0.8571428571428571,0.8571428571428571
Volodimir Zelenski,www.gandul.ro,0,0,3,3,0.0,0.0
trimis,www.gandul.ro,0,1,1,2,-0.5,0.5
Alexandru Muraru,www.g4media.ro,1,1,8,10,0.0,0.0
Corneliu Zelea Codreanu,www.g4media.ro,0,5,0,5,-1.0,1.0
Horia Sima,www.g4media.ro,0,1,2,3,-0.3333333333333333,0.3333333333333333
Muraru,www.g4media.ro,0,1,3,4,-0.25,0.25
fondator,www.g4media.ro,1,3,6,10,-0.2,0.2
premiu,www.g4media.ro,0,3,1,4,-0.75,0.75
urmaș,www.g4media.ro,0,2,2,4,-0.5,0.5
Vasile Blaga,observatornews.ro,0,1,4,5,-0.2,0.2
coleg,observatornews.ro,9,5,11,25,0.16,0.16
Bruxelles,www.euronews.ro,0,1,7,8,-0.125,0.125
candidați,www.euronews.ro,0,3,18,21,-0.14285714285714285,0.14285714285714285
Mihai Tudose,www.euronews.ro,0,0,6,6,0.0,0.0
Gordon,adevarul.ro,0,0,1,1,0.0,0.0
Hillary Clinton,adevarul.ro,0,0,1,1,0.0,0.0
Philip Gordon,adevarul.ro,0,0,2,2,0.0,0.0
Philip H. Gordon,adevarul.ro,0,0,1,1,0.0,0.0
secretar de stat,adevarul.ro,0,1,5,6,-0.16666666666666666,0.16666666666666666
Anamaria Gavrilă,www.cotidianul.ro,1,2,5,8,-0.125,0.125
Emanuel Ungureanu,www.cotidianul.ro,0,0,1,1,0.0,0.0
Donald Trump,www.antena3.ro,5,11,23,39,-0.15384615384615385,0.15384615384615385
Giorgia Meloni,www.antena3.ro,0,1,3,4,-0.25,0.25
Italia,www.antena3.ro,0,0,4,4,0.0,0.0
JD Vance,www.antena3.ro,0,3,3,6,-0.5,0.5
Matteo Salvini,www.antena3.ro,0,0,1,1,0.0,0.0
prim-ministru,www.antena3.ro,0,1,6,7,-0.14285714285714285,0.14285714285714285
Roma,www.antena3.ro,0,0,1,1,0.0,0.0
Vatican,www.antena3.ro,0,0,1,1,0.0,0.0
Washington,www.antena3.ro,0,3,6,9,-0.3333333333333333,0.3333333333333333
vicepremier,www.antena3.ro,0,0,3,3,0.0,0.0
femeie,www.gandul.ro,7,3,19,29,0.13793103448275862,0.13793103448275862
Adrian Mihălțianu,pressone.ro,0,0,2,2,0.0,0.0
Bratislava,pressone.ro,0,0,2,2,0.0,0.0
Budapesta,pressone.ro,0,1,8,9,-0.1111111111111111,0.1111111111111111
Cehia,pressone.ro,0,0,5,5,0.0,0.0
Dominic Fritz,pressone.ro,0,0,2,2,0.0,0.0
Edoardo Bortoli,pressone.ro,0,0,1,1,0.0,0.0
Katalin Cseh,pressone.ro,0,0,1,1,0.0,0.0
Munchen,pressone.ro,0,0,1,1,0.0,0.0
Oana Preda,pressone.ro,1,0,0,1,1.0,1.0
Peete,pressone.ro,0,1,0,1,-1.0,1.0
Praga,pressone.ro,0,0,2,2,0.0,0.0
Slovacia,pressone.ro,0,1,7,8,-0.125,0.125
Virgil Simonescu,pressone.ro,0,0,2,2,0.0,0.0
Zagreb,pressone.ro,0,0,1,1,0.0,0.0
comunitate,pressone.ro,1,0,0,1,1.0,1.0
extremist,pressone.ro,0,5,0,5,-1.0,1.0
inginer constructor,pressone.ro,0,0,1,1,0.0,0.0
popul,pressone.ro,0,1,0,1,-1.0,1.0
populist,pressone.ro,0,2,0,2,-1.0,1.0
Adela Ioana Grăjdeanu Târziu,www.gandul.ro,0,0,1,1,0.0,0.0
Andrei Țăranu,www.gandul.ro,0,0,2,2,0.0,0.0
Claudiu Târziu,www.gandul.ro,0,0,8,8,0.0,0.0
Coldea,www.gandul.ro,0,4,1,5,-0.8,0.8
Dîncu,www.gandul.ro,0,1,0,1,-1.0,1.0
Florian Codea,www.gandul.ro,0,0,1,1,0.0,0.0
Târziu,www.gandul.ro,0,0,2,2,0.0,0.0
Vasile Dîncu,www.gandul.ro,0,0,3,3,0.0,0.0
adjunct,www.gandul.ro,0,1,0,1,-1.0,1.0
doamnă,www.gandul.ro,1,2,4,7,-0.14285714285714285,0.14285714285714285
elector,www.gandul.ro,0,0,1,1,0.0,0.0
finuțul Popică,www.gandul.ro,0,1,0,1,-1.0,1.0
Iosif Buble,www.gandul.ro,0,0,1,1,0.0,0.0
lector,www.gandul.ro,0,0,1,1,0.0,0.0
prodecan,www.gandul.ro,0,0,1,1,0.0,0.0
profesor universitar,www.gandul.ro,0,0,1,1,0.0,0.0
vizitator,www.gandul.ro,0,1,0,1,-1.0,1.0
Daniel David,www.activenews.ro,0,1,1,2,-0.5,0.5
Dominic Fritz,www.activenews.ro,0,2,0,2,-1.0,1.0
Predoiu,www.activenews.ro,0,3,3,6,-0.5,0.5
public,www.cotidianul.ro,0,5,2,7,-0.7142857142857143,0.7142857142857143
Corina Corbu,www.luju.ro,0,0,3,3,0.0,0.0
personal,www.luju.ro,2,3,11,16,-0.0625,0.0625
Ciprian Șerban,www.digi24.ro,0,0,1,1,0.0,0.0
Csoma Botond,www.digi24.ro,0,0,1,1,0.0,0.0
Gabriel Andronache,www.digi24.ro,0,1,1,2,-0.5,0.5
Ovidiu Ganț,www.digi24.ro,0,0,1,1,0.0,0.0
administrator,www.digi24.ro,0,3,1,4,-0.75,0.75
inițiator,www.digi24.ro,0,1,3,4,-0.25,0.25
Barbu,www.aktual24.ro,0,1,0,1,-1.0,1.0
Florin Barbu,www.aktual24.ro,0,1,2,3,-0.3333333333333333,0.3333333333333333
Radu Burnete,www.aktual24.ro,0,1,0,1,-1.0,1.0
analist,www.aktual24.ro,0,3,4,7,-0.42857142857142855,0.42857142857142855
consumator,www.aktual24.ro,0,1,2,3,-0.3333333333333333,0.3333333333333333
specialist,www.aktual24.ro,0,2,5,7,-0.2857142857142857,0.2857142857142857
Austria,pressone.ro,0,0,11,11,0.0,0.0
Italia,pressone.ro,0,2,14,16,-0.125,0.125
Vadim,pressone.ro,0,1,3,4,-0.25,0.25
Vadim Tudor,pressone.ro,0,0,1,1,0.0,0.0
corifeu,pressone.ro,0,2,0,2,-1.0,1.0
dant,pressone.ro,0,1,0,1,-1.0,1.0
Mandachi,pressone.ro,0,1,0,1,-1.0,1.0
necunoscut,pressone.ro,0,3,0,3,-1.0,1.0
outsider,pressone.ro,1,0,0,1,1.0,1.0
perdant,pressone.ro,0,1,0,1,-1.0,1.0
vinovat,pressone.ro,0,7,0,7,-1.0,1.0
Ștefan Mandachi,pressone.ro,0,0,1,1,0.0,0.0
Germania,adevarul.ro,0,1,12,13,-0.07692307692307693,0.07692307692307693
Italia,adevarul.ro,0,0,8,8,0.0,0.0
Marea Britanie,adevarul.ro,2,1,5,8,0.125,0.125
Orban,adevarul.ro,0,4,5,9,-0.4444444444444444,0.4444444444444444
Salvini,adevarul.ro,0,1,0,1,-1.0,1.0
Varșovia,adevarul.ro,0,1,2,3,-0.3333333333333333,0.3333333333333333
Adina Vălean,www.mediafax.ro,0,0,1,1,0.0,0.0
Alexandru Muraru,www.mediafax.ro,0,0,1,1,0.0,0.0
Ciucă,www.mediafax.ro,0,3,1,4,-0.75,0.75
Cătălin Cîrstoiu,www.mediafax.ro,0,0,3,3,0.0,0.0
Dan Motreanu,www.mediafax.ro,0,0,2,2,0.0,0.0
Daniel Buda,www.mediafax.ro,0,0,1,1,0.0,0.0
Gheorghe Falcă,www.mediafax.ro,0,0,1,1,0.0,0.0
Mara Mareș,www.mediafax.ro,0,0,1,1,0.0,0.0
Mircea Hava,www.mediafax.ro,0,0,1,1,0.0,0.0
Nicolae Ciucă,www.mediafax.ro,0,1,7,8,-0.125,0.125
Rareș Bogdan,www.mediafax.ro,0,1,3,4,-0.25,0.25
Siegfried Mureșan,www.mediafax.ro,0,0,1,1,0.0,0.0
Virgil Popescu,www.mediafax.ro,0,0,1,1,0.0,0.0
Amândoi,recorder.ro,0,0,2,2,0.0,0.0
Cutean,recorder.ro,0,1,0,1,-1.0,1.0
Emil,recorder.ro,1,0,0,1,1.0,1.0
Emile,recorder.ro,1,0,0,1,1.0,1.0
Emilian Vasile Cutean,recorder.ro,0,0,1,1,0.0,0.0
Jilava,recorder.ro,0,2,0,2,-1.0,1.0
deschizător,recorder.ro,0,1,0,1,-1.0,1.0
infractor,recorder.ro,0,3,0,3,-1.0,1.0
revoluționar,recorder.ro,0,8,2,10,-0.8,0.8
tovarăș,recorder.ro,0,1,0,1,-1.0,1.0
Bogdan,adevarul.ro,0,1,2,3,-0.3333333333333333,0.3333333333333333
Rareș Bogdan,adevarul.ro,1,1,12,14,0.0,0.0
Belgia,www.antena3.ro,0,0,1,1,0.0,0.0
Canada,www.antena3.ro,0,0,5,5,0.0,0.0
Cehia,www.antena3.ro,0,0,2,2,0.0,0.0
Emmanuel Macron,www.antena3.ro,0,0,3,3,0.0,0.0
Finlanda,www.antena3.ro,0,0,1,1,0.0,0.0
Franța,www.antena3.ro,1,3,6,10,-0.2,0.2
Grecia,www.antena3.ro,0,0,2,2,0.0,0.0
Ionel Bogdan,www.antena3.ro,0,0,1,1,0.0,0.0
Norvegia,www.antena3.ro,0,0,1,1,0.0,0.0
Paris,www.antena3.ro,0,0,2,2,0.0,0.0
Suedia,www.antena3.ro,0,0,1,1,0.0,0.0
Vicepreședintele,www.antena3.ro,0,0,6,6,0.0,0.0
omolog,www.antena3.ro,0,1,1,2,-0.5,0.5
Țările Baltice,www.antena3.ro,0,0,1,1,0.0,0.0
Buzău,www.romaniatv.net,0,0,14,14,0.0,0.0
Constantin Toma,www.romaniatv.net,0,4,7,11,-0.36363636363636365,0.36363636363636365
Daniel Băluță,www.romaniatv.net,0,1,3,4,-0.25,0.25
Mihai Tudose,www.romaniatv.net,0,1,6,7,-0.14285714285714285,0.14285714285714285
Paul Stănescu,www.romaniatv.net,0,5,0,5,-1.0,1.0
Toma,www.romaniatv.net,0,0,3,3,0.0,0.0
vicepreședinte,www.romaniatv.net,0,1,9,10,-0.1,0.1
candidat,www.b1tv.ro,2,11,45,58,-0.15517241379310345,0.15517241379310345
George Simion,www.b1tv.ro,1,6,9,16,-0.3125,0.3125
judecător,primanews.ro,0,3,3,6,-0.5,0.5
secretar general,primanews.ro,1,1,3,5,0.0,0.0
Cosmin Prelipceanu,www.g4media.ro,0,0,1,1,0.0,0.0
Tudose,www.g4media.ro,0,0,2,2,0.0,0.0
Andrzej Duda,www.digi24.ro,0,0,1,1,0.0,0.0
Austria,www.digi24.ro,0,0,3,3,0.0,0.0
Bronislaw Komorowski,www.digi24.ro,0,0,1,1,0.0,0.0
Germania,www.digi24.ro,0,0,7,7,0.0,0.0
Imperiul Otoman,www.digi24.ro,0,0,2,2,0.0,0.0
Polonia,www.digi24.ro,0,1,9,10,-0.1,0.1
Prusia,www.digi24.ro,0,1,0,1,-1.0,1.0
Rus,www.digi24.ro,0,0,1,1,0.0,0.0
Rusia,www.digi24.ro,0,16,1,17,-0.9411764705882353,0.9411764705882353
fermier,www.digi24.ro,2,0,1,3,0.6666666666666666,0.6666666666666666
ice,www.digi24.ro,0,0,1,1,0.0,0.0
imperiu,www.digi24.ro,0,1,0,1,-1.0,1.0
locuitor,www.digi24.ro,0,1,3,4,-0.25,0.25
ungar,www.digi24.ro,0,0,1,1,0.0,0.0
Belgrad,www.antena3.ro,0,1,12,13,-0.07692307692307693,0.07692307692307693
Ponta,www.antena3.ro,0,16,6,22,-0.7272727272727273,0.7272727272727273
Vlad Gheorghe,www.antena3.ro,0,1,1,2,-0.5,0.5
complici,www.antena3.ro,0,2,0,2,-1.0,1.0
ministru,www.antena3.ro,0,15,27,42,-0.35714285714285715,0.35714285714285715
respondent,www.antena3.ro,0,0,11,11,0.0,0.0
Dan,www.gandul.ro,0,0,3,3,0.0,0.0
Adela,snoop.ro,0,0,1,1,0.0,0.0
Adela Alexandru,snoop.ro,0,0,1,1,0.0,0.0
Adelei,snoop.ro,0,1,0,1,-1.0,1.0
Adriana,snoop.ro,0,0,2,2,0.0,0.0
Alexandra,snoop.ro,0,1,1,2,-0.5,0.5
Alexandra Costa,snoop.ro,0,1,0,1,-1.0,1.0
Alexandru Costa,snoop.ro,0,0,1,1,0.0,0.0
Alfred Bulai,snoop.ro,1,5,0,6,-0.6666666666666666,0.6666666666666666
Ana Bulai,snoop.ro,0,0,1,1,0.0,0.0
Andrei,snoop.ro,0,0,2,2,0.0,0.0
Aurora,snoop.ro,0,0,1,1,0.0,0.0
Aurora Sandu,snoop.ro,0,0,1,1,0.0,0.0
batâr,snoop.ro,0,1,0,1,-1.0,1.0
Bechet,snoop.ro,0,0,1,1,0.0,0.0
Bulai,snoop.ro,0,3,0,3,-1.0,1.0
Cristina Suliman,snoop.ro,0,0,2,2,0.0,0.0
Călin Popescu Tăriceanu,snoop.ro,0,1,1,2,-0.5,0.5
Dolj,snoop.ro,0,1,2,3,-0.3333333333333333,0.3333333333333333
Elena,snoop.ro,0,1,1,2,-0.5,0.5
Elena Trifan,snoop.ro,0,0,4,4,0.0,0.0
Ioana,snoop.ro,0,0,1,1,0.0,0.0
Ioana Pelehatăi,snoop.ro,0,0,1,1,0.0,0.0
Mirela,snoop.ro,0,1,1,2,-0.5,0.5
Pricopie,snoop.ro,0,0,2,2,0.0,0.0
prieten,snoop.ro,0,4,10,14,-0.2857142857142857,0.2857142857142857
prodecan,snoop.ro,0,2,2,4,-0.5,0.5
Sofia,snoop.ro,0,0,2,2,0.0,0.0
Stanciugelu,snoop.ro,0,1,0,1,-1.0,1.0
Teodora,snoop.ro,0,1,0,1,-1.0,1.0
Teodora Batâr,snoop.ro,0,0,2,2,0.0,0.0
Teodora Urse,snoop.ro,0,0,1,1,0.0,0.0
Teodorei,snoop.ro,0,1,1,2,-0.5,0.5
Urse,snoop.ro,0,0,1,1,0.0,0.0
Victoria,snoop.ro,0,1,3,4,-0.25,0.25
victorie,snoop.ro,0,0,1,1,0.0,0.0
Vladimir Ignat,snoop.ro,0,0,1,1,0.0,0.0
abuzator,snoop.ro,0,2,0,2,-1.0,1.0
activist,snoop.ro,0,8,3,11,-0.7272727272727273,0.7272727272727273
adult,snoop.ro,0,2,7,9,-0.2222222222222222,0.2222222222222222
bunic,snoop.ro,0,0,1,1,0.0,0.0
băiat,snoop.ro,1,2,5,8,-0.125,0.125
cadru didactic,snoop.ro,0,1,1,2,-0.5,0.5
colegă,snoop.ro,0,1,3,4,-0.25,0.25
consilier,snoop.ro,0,9,27,36,-0.25,0.25
dascăl,snoop.ro,1,0,0,1,1.0,1.0
fată,snoop.ro,1,3,10,14,-0.14285714285714285,0.14285714285714285
fesor,snoop.ro,0,1,0,1,-1.0,1.0
fiică,snoop.ro,0,4,6,10,-0.4,0.4
gagicomi,snoop.ro,0,1,0,1,-1.0,1.0
gardian,snoop.ro,0,1,0,1,-1.0,1.0
iubit,snoop.ro,0,0,1,1,0.0,0.0
localnic,snoop.ro,0,1,5,6,-0.16666666666666666,0.16666666666666666
lume,snoop.ro,0,2,2,4,-0.5,0.5
maică,snoop.ro,0,0,1,1,0.0,0.0
mamă,snoop.ro,6,3,9,18,0.16666666666666666,0.16666666666666666
mort,snoop.ro,0,0,1,1,0.0,0.0
mentor,snoop.ro,1,0,3,4,0.25,0.25
nebun,snoop.ro,0,1,0,1,-1.0,1.0
prietene,snoop.ro,0,1,0,1,-1.0,1.0
profesoară,snoop.ro,0,3,2,5,-0.6,0.6
profesor universitar,snoop.ro,1,0,1,2,0.5,0.5
Bogdan Morar,snoop.ro,0,0,2,2,0.0,0.0
Remus Pricopie,snoop.ro,0,0,2,2,0.0,0.0
secretar de stat,snoop.ro,0,0,4,4,0.0,0.0
specialist,snoop.ro,3,5,32,40,-0.05,0.05
studentă,snoop.ro,0,2,3,5,-0.4,0.4
Teodorei Batâr,snoop.ro,0,1,0,1,-1.0,1.0
tipă,snoop.ro,0,1,0,1,-1.0,1.0
udenț,snoop.ro,0,1,0,1,-1.0,1.0
va,snoop.ro,0,1,0,1,-1.0,1.0
victima,snoop.ro,0,2,3,5,-0.4,0.4
victimă,snoop.ro,0,8,3,11,-0.7272727272727273,0.7272727272727273
îndrumător,snoop.ro,1,0,0,1,1.0,1.0
șefă,snoop.ro,0,4,3,7,-0.5714285714285714,0.5714285714285714
Ciprian Șerban,adevarul.ro,0,1,0,1,-1.0,1.0
Neamț,adevarul.ro,0,1,1,2,-0.5,0.5
Claudiu Târziu,www.b1tv.ro,0,3,3,6,-0.5,0.5
Nadia Ciurlin,www.b1tv.ro,0,0,1,1,0.0,0.0
Simion,www.b1tv.ro,0,11,3,14,-0.7857142857142857,0.7857142857142857
Târziu,www.b1tv.ro,0,1,1,2,-0.5,0.5
cadru,www.b1tv.ro,0,1,0,1,-1.0,1.0
copreședinte,www.b1tv.ro,0,0,1,1,0.0,0.0
frate,www.b1tv.ro,1,2,0,3,-0.3333333333333333,0.3333333333333333
public,www.b1tv.ro,0,3,2,5,-0.6,0.6
tip,www.b1tv.ro,0,1,0,1,-1.0,1.0
Kelemen Hunor,www.romaniatv.net,1,2,13,16,-0.0625,0.0625
Adrian Severin,www.mediafax.ro,0,1,0,1,-1.0,1.0
Andronic,www.mediafax.ro,0,0,1,1,0.0,0.0
Boda,www.mediafax.ro,0,0,1,1,0.0,0.0
Corina Crețu,www.mediafax.ro,0,0,1,1,0.0,0.0
Iosif Boda,www.mediafax.ro,0,0,1,1,0.0,0.0
Octavian Andronic,www.mediafax.ro,0,0,1,1,0.0,0.0
Petre Roman,www.mediafax.ro,0,0,1,1,0.0,0.0
Roman,www.mediafax.ro,0,1,1,2,-0.5,0.5
cei,www.mediafax.ro,0,0,1,1,0.0,0.0
participant,www.mediafax.ro,0,0,2,2,0.0,0.0
Alin Văcaru,recorder.ro,0,1,0,1,-1.0,1.0
Claudiu Manta,recorder.ro,0,0,1,1,0.0,0.0
Dan Vîlceanu,recorder.ro,0,0,2,2,0.0,0.0
David Eagleman,recorder.ro,0,0,1,1,0.0,0.0
Gheorghe Pecingină,recorder.ro,0,0,1,1,0.0,0.0
Ilie Șerbanescu,recorder.ro,0,0,1,1,0.0,0.0
Ion Cristinel Rujan,recorder.ro,0,0,1,1,0.0,0.0
Ion Iordache,recorder.ro,0,0,1,1,0.0,0.0
John le Carré,recorder.ro,1,0,0,1,1.0,1.0
Michel Houellebecq,recorder.ro,0,0,2,2,0.0,0.0
Mihai Weber,recorder.ro,0,0,3,3,0.0,0.0
Nicolae Davițoiu,recorder.ro,0,0,1,1,0.0,0.0
Winston Churchill,recorder.ro,0,0,2,2,0.0,0.0
cadru,recorder.ro,0,2,6,8,-0.25,0.25
conferențiar,recorder.ro,1,0,4,5,0.2,0.2
energetician,recorder.ro,0,0,1,1,0.0,0.0
minier,recorder.ro,1,1,1,3,0.0,0.0
notar,recorder.ro,0,0,5,5,0.0,0.0
pompier,recorder.ro,0,0,3,3,0.0,0.0
profan,recorder.ro,0,1,0,1,-1.0,1.0
Adrian Antoche,www.g4media.ro,0,0,1,1,0.0,0.0
Adriana Matiasciuc,www.g4media.ro,0,0,1,1,0.0,0.0
arbitru,www.g4media.ro,0,0,1,1,0.0,0.0
Darius Cioară,www.g4media.ro,0,0,1,1,0.0,0.0
Eugenia Groșan,www.g4media.ro,0,0,1,1,0.0,0.0
Eusebiu Pistru,www.g4media.ro,0,0,2,2,0.0,0.0
Irina Danchici,www.g4media.ro,0,0,1,1,0.0,0.0
Laszlo Melinda,www.g4media.ro,0,0,1,1,0.0,0.0
Laurențiu Andea,www.g4media.ro,0,0,1,1,0.0,0.0
Mircea Pele,www.g4media.ro,0,0,1,1,0.0,0.0
Ovidiu Hațegan,www.g4media.ro,0,0,1,1,0.0,0.0
Petru Moț,www.g4media.ro,0,0,1,1,0.0,0.0
Roxana Momeu,www.g4media.ro,0,0,1,1,0.0,0.0
Samuel Dragoș,www.g4media.ro,0,0,1,1,0.0,0.0
candidați,www.g4media.ro,0,9,8,17,-0.5294117647058824,0.5294117647058824
,adevarul.ro,0,5,7,12,-0.4166666666666667,0.4166666666666667
Bolivia,www.comisarul.ro,0,2,0,2,-1.0,1.0
Dl. Georgescu,www.comisarul.ro,0,1,0,1,-1.0,1.0
Dumnezeu,www.comisarul.ro,5,0,3,8,0.625,0.625
Ioana Ene Dogioiu,www.comisarul.ro,0,0,5,5,0.0,0.0
Ion Cristoiu,www.comisarul.ro,0,0,2,2,0.0,0.0
Mendeleev,www.comisarul.ro,0,0,1,1,0.0,0.0
Pacifistul Georgescu,www.comisarul.ro,0,1,0,1,-1.0,1.0
agresor,www.comisarul.ro,0,3,0,3,-1.0,1.0
chimist,www.comisarul.ro,0,1,0,1,-1.0,1.0
dlui Georgescu,www.comisarul.ro,0,1,0,1,-1.0,1.0
domnie,www.comisarul.ro,0,5,1,6,-0.8333333333333334,0.8333333333333334
ființă,www.comisarul.ro,0,1,0,1,-1.0,1.0
istoric,www.comisarul.ro,0,2,5,7,-0.2857142857142857,0.2857142857142857
lup,www.comisarul.ro,0,1,0,1,-1.0,1.0
mesian,www.comisarul.ro,0,1,0,1,-1.0,1.0
pră,www.comisarul.ro,0,1,0,1,-1.0,1.0
ul,www.comisarul.ro,0,1,0,1,-1.0,1.0
înaintaș,www.comisarul.ro,0,1,0,1,-1.0,1.0
Diaconescu,www.digi24.ro,0,1,3,4,-0.25,0.25
traficant,adevarul.ro,0,1,0,1,-1.0,1.0
victimă,adevarul.ro,1,7,2,10,-0.6,0.6
Mugur Isărescu,primanews.ro,0,0,2,2,0.0,0.0
guvernator,primanews.ro,0,1,2,3,-0.3333333333333333,0.3333333333333333
James Bond,www.b1tv.ro,0,1,0,1,-1.0,1.0
magistrat,www.b1tv.ro,0,5,4,9,-0.5555555555555556,0.5555555555555556
militar,www.b1tv.ro,1,1,0,2,0.0,0.0
cunoștință,www.b1tv.ro,1,0,0,1,1.0,1.0
hoț,www.b1tv.ro,0,2,0,2,-1.0,1.0
milițian,www.b1tv.ro,0,1,0,1,-1.0,1.0
soldat,www.b1tv.ro,0,1,1,2,-0.5,0.5
Daniel Constantin,www.digi24.ro,0,0,1,1,0.0,0.0
Gabriel Oprea,www.digi24.ro,0,1,1,2,-0.5,0.5
ător,www.digi24.ro,0,1,0,1,-1.0,1.0
Șerban Mihăilescu,www.digi24.ro,0,0,1,1,0.0,0.0
Oprea,www.aktual24.ro,0,1,1,2,-0.5,0.5
Ștefan Radu Oprea,www.aktual24.ro,0,0,2,2,0.0,0.0
elector,www.aktual24.ro,0,0,1,1,0.0,0.0
Radu Oprea,www.aktual24.ro,0,0,1,1,0.0,0.0
Moșteanu,www.realitatea.net,0,0,2,2,0.0,0.0
parlamentar,www.realitatea.net,0,10,1,11,-0.9090909090909091,0.9090909090909091
Grădiștea,www.g4media.ro,0,1,0,1,-1.0,1.0
polițist,www.g4media.ro,0,3,4,7,-0.42857142857142855,0.42857142857142855
alegător,www.g4media.ro,0,19,13,32,-0.59375,0.59375
bărbat,www.g4media.ro,0,5,7,12,-0.4166666666666667,0.4166666666666667
Dan Mușetoiu,www.antena3.ro,0,0,1,1,0.0,0.0
fondator,www.antena3.ro,1,0,5,6,0.16666666666666666,0.16666666666666666
invitat,www.antena3.ro,0,0,3,3,0.0,0.0
președinte interimar,www.romaniatv.net,0,0,5,5,0.0,0.0
Elena,www.b1tv.ro,0,1,2,3,-0.3333333333333333,0.3333333333333333
contracandidat,www.b1tv.ro,0,1,1,2,-0.5,0.5
doamna Lasconi,www.b1tv.ro,1,0,0,1,1.0,1.0
votant,www.b1tv.ro,0,1,4,5,-0.2,0.2
JD Vance,observatornews.ro,0,1,2,3,-0.3333333333333333,0.3333333333333333
Negrescu,observatornews.ro,0,1,2,3,-0.3333333333333333,0.3333333333333333
Vance,observatornews.ro,0,1,0,1,-1.0,1.0
Victor Negrescu,observatornews.ro,0,0,6,6,0.0,0.0
vicepreședinte,observatornews.ro,0,2,16,18,-0.1111111111111111,0.1111111111111111
Burhan,www.romaniatv.net,0,0,1,1,0.0,0.0
Ibrahim,www.romaniatv.net,0,0,1,1,0.0,0.0
Israel,www.romaniatv.net,0,1,0,1,-1.0,1.0
Juba,www.romaniatv.net,0,0,1,1,0.0,0.0
Sudan,www.romaniatv.net,0,0,1,1,0.0,0.0
Sudanul de Sud,www.romaniatv.net,0,0,2,2,0.0,0.0
destinatar,www.mediafax.ro,0,1,0,1,-1.0,1.0
public,www.mediafax.ro,1,1,0,2,0.0,0.0
Ana Maria Păcuraru,www.realitatea.net,0,0,3,3,0.0,0.0
Balcescu,www.realitatea.net,0,0,1,1,0.0,0.0
agricultor,www.realitatea.net,0,1,0,1,-1.0,1.0
copil,www.realitatea.net,5,2,0,7,0.42857142857142855,0.42857142857142855
dvs,www.realitatea.net,0,0,1,1,0.0,0.0
femeie,www.realitatea.net,0,4,1,5,-0.8,0.8
neam,www.realitatea.net,0,1,0,1,-1.0,1.0
toți,www.realitatea.net,0,1,1,2,-0.5,0.5
câștigător,www.aktual24.ro,0,2,0,2,-1.0,1.0
Daniel Fenechiu,www.gandul.ro,0,0,2,2,0.0,0.0
Fenechiu,www.gandul.ro,0,0,1,1,0.0,0.0
Ilie Bolojan,www.gandul.ro,2,2,18,22,0.0,0.0
Ciprian Dobre,agerpres.ro,0,2,2,4,-0.5,0.5
Dorina Matiș,agerpres.ro,0,0,3,3,0.0,0.0
Buda,www.luju.ro,0,0,1,1,0.0,0.0
Famil,www.luju.ro,1,0,0,1,1.0,1.0
Hunedoara,www.luju.ro,0,0,1,1,0.0,0.0
Marian Buda,www.luju.ro,0,0,1,1,0.0,0.0
Mureș,www.luju.ro,0,0,1,1,0.0,0.0
Popoiag,www.luju.ro,0,0,1,1,0.0,0.0
Ramnicu,www.luju.ro,0,0,1,1,0.0,0.0
competitor,www.luju.ro,0,1,0,1,-1.0,1.0
concurent,www.luju.ro,0,1,0,1,-1.0,1.0
Emmanuel Macron,www.romaniatv.net,1,5,3,9,-0.4444444444444444,0.4444444444444444
Eric,www.romaniatv.net,0,1,0,1,-1.0,1.0
Iran,www.romaniatv.net,0,2,1,3,-0.6666666666666666,0.6666666666666666
aliaț,www.romaniatv.net,0,2,2,4,-0.5,0.5
finalist,www.romaniatv.net,1,2,0,3,-0.3333333333333333,0.3333333333333333
moderator,www.romaniatv.net,0,1,0,1,-1.0,1.0
profiler,www.romaniatv.net,0,2,0,2,-1.0,1.0
traducător,www.romaniatv.net,0,1,0,1,-1.0,1.0
Antonescu,www.antena3.ro,1,6,30,37,-0.13513513513513514,0.13513513513513514
partener,www.antena3.ro,4,2,3,9,0.2222222222222222,0.2222222222222222
Amazoana,observatornews.ro,0,0,1,1,0.0,0.0
Blaga,observatornews.ro,0,0,1,1,0.0,0.0
Blonda,observatornews.ro,0,1,0,1,-1.0,1.0
Elena Udrea,observatornews.ro,0,1,1,2,-0.5,0.5
Vlad Voiculescu,observatornews.ro,0,3,4,7,-0.42857142857142855,0.42857142857142855
Voiculescu,observatornews.ro,0,0,1,1,0.0,0.0
Alfred Simonis,primanews.ro,0,1,2,3,-0.3333333333333333,0.3333333333333333
Elena Andrei,primanews.ro,0,0,8,8,0.0,0.0
Simonis,primanews.ro,0,0,2,2,0.0,0.0
Adrian Dobre,pressone.ro,0,0,2,2,0.0,0.0
Mihai Fifor,pressone.ro,0,2,1,3,-0.6666666666666666,0.6666666666666666
Nicolae,pressone.ro,1,2,3,6,-0.16666666666666666,0.16666666666666666
Nicolae Bădălău,pressone.ro,0,1,1,2,-0.5,0.5
Paul Stănescu,pressone.ro,0,0,5,5,0.0,0.0
Robert Cazanciuc,pressone.ro,0,0,3,3,0.0,0.0
corupt,pressone.ro,0,2,0,2,-1.0,1.0
vicepreședinte,pressone.ro,0,5,51,56,-0.08928571428571429,0.08928571428571429
Șerban Nicolae,pressone.ro,0,3,5,8,-0.375,0.375
Georgescu,www.realitatea.net,2,8,10,20,-0.3,0.3
Magdin,www.realitatea.net,0,1,0,1,-1.0,1.0
Radu Magdin,www.realitatea.net,0,0,1,1,0.0,0.0
Craiova,www.activenews.ro,0,1,0,1,-1.0,1.0
deputat,www.activenews.ro,1,10,3,14,-0.6428571428571429,0.6428571428571429
Radu Cristescu,www.activenews.ro,0,1,1,2,-0.5,0.5
slujitor,www.activenews.ro,0,3,1,4,-0.75,0.75
Adriean Videanu,a1.ro,0,1,1,2,-0.5,0.5
Boc,a1.ro,1,9,4,14,-0.5714285714285714,0.5714285714285714
raționare,a1.ro,0,1,0,1,-1.0,1.0
edil,a1.ro,0,9,4,13,-0.6923076923076923,0.6923076923076923
familie,a1.ro,11,4,12,27,0.25925925925925924,0.25925925925925924
Videanu,a1.ro,0,2,4,6,-0.3333333333333333,0.3333333333333333
investitor,a1.ro,1,1,1,3,0.0,0.0
competitor,www.realitatea.net,0,1,1,2,-0.5,0.5
Chișinău,observatornews.ro,1,0,3,4,0.25,0.25
Mihai Tudose,observatornews.ro,0,1,15,16,-0.0625,0.0625
Tudose,observatornews.ro,0,0,2,2,0.0,0.0
ambasador,observatornews.ro,0,2,3,5,-0.4,0.4
consul,observatornews.ro,0,0,1,1,0.0,0.0
A,snoop.ro,0,1,0,1,-1.0,1.0
Alecsa,snoop.ro,0,1,0,1,-1.0,1.0
Ana Postolachi,snoop.ro,0,1,0,1,-1.0,1.0
Anei Postolachi,snoop.ro,0,0,1,1,0.0,0.0
Anamaria,snoop.ro,0,1,0,1,-1.0,1.0
Anișoara,snoop.ro,0,0,1,1,0.0,0.0
Anișoara Postolachi,snoop.ro,0,0,1,1,0.0,0.0
Anișoarei,snoop.ro,0,1,0,1,-1.0,1.0
Austria,snoop.ro,0,0,8,8,0.0,0.0
Bobea,snoop.ro,0,0,1,1,0.0,0.0
Bobeanu,snoop.ro,0,0,1,1,0.0,0.0
Botoșani,snoop.ro,0,0,7,7,0.0,0.0
băiețel,snoop.ro,0,0,3,3,0.0,0.0
Cahul,snoop.ro,0,0,1,1,0.0,0.0
Constantin,snoop.ro,0,0,3,3,0.0,0.0
Constantin Alecsa,snoop.ro,0,0,2,2,0.0,0.0
Constanța,snoop.ro,0,1,12,13,-0.07692307692307693,0.07692307692307693
Cumnat,snoop.ro,0,1,0,1,-1.0,1.0
Dolhăscu,snoop.ro,0,1,0,1,-1.0,1.0
Edineț,snoop.ro,0,0,1,1,0.0,0.0
fetiță,snoop.ro,0,0,4,4,0.0,0.0
Grozești,snoop.ro,0,0,1,1,0.0,0.0
Iași,snoop.ro,0,0,10,10,0.0,0.0
Iolanda Dolhăscu,snoop.ro,0,0,2,2,0.0,0.0
Ionuț,snoop.ro,0,0,2,2,0.0,0.0
Ionuț Miron,snoop.ro,0,0,1,1,0.0,0.0
Italia,snoop.ro,1,0,7,8,0.125,0.125
Iulia P,snoop.ro,0,1,0,1,-1.0,1.0
Iulia Postolachi,snoop.ro,0,0,1,1,0.0,0.0
Iulie,snoop.ro,0,1,0,1,-1.0,1.0
Lidia Miron,snoop.ro,0,0,1,1,0.0,0.0
Lucian,snoop.ro,0,1,2,3,-0.3333333333333333,0.3333333333333333
Miron,snoop.ro,0,0,2,2,0.0,0.0
Postolachi,snoop.ro,0,1,0,1,-1.0,1.0
Teodora Bobeanu,snoop.ro,0,0,1,1,0.0,0.0
Teodorei Bobeanu,snoop.ro,0,0,1,1,0.0,0.0
Turcia,snoop.ro,0,0,2,2,0.0,0.0
Veronica,snoop.ro,0,1,1,2,-0.5,0.5
Veronica Șova,snoop.ro,0,0,1,1,0.0,0.0
William,snoop.ro,0,0,1,1,0.0,0.0
Maia Morgenstern,snoop.ro,0,0,1,1,0.0,0.0
bebeluș,snoop.ro,0,1,2,3,-0.3333333333333333,0.3333333333333333
bătrân,snoop.ro,0,1,1,2,-0.5,0.5
deținător,snoop.ro,0,2,2,4,-0.5,0.5
enior,snoop.ro,0,1,0,1,-1.0,1.0
filantrop,snoop.ro,0,0,1,1,0.0,0.0
fondatoare,snoop.ro,0,1,1,2,-0.5,0.5
ieșean,snoop.ro,0,0,1,1,0.0,0.0
mame,snoop.ro,0,1,3,4,-0.25,0.25
moș,snoop.ro,0,1,0,1,-1.0,1.0
moș Alecsa,snoop.ro,0,1,0,1,-1.0,1.0
prezentator,snoop.ro,0,1,1,2,-0.5,0.5
Cătălin Măruță,snoop.ro,0,0,1,1,0.0,0.0
primar,snoop.ro,0,29,20,49,-0.5918367346938775,0.5918367346938775
purceluș,snoop.ro,0,0,1,1,0.0,0.0
refugiat,snoop.ro,1,0,0,1,1.0,1.0
rudă,snoop.ro,0,3,4,7,-0.42857142857142855,0.42857142857142855
vecin,snoop.ro,0,6,2,8,-0.75,0.75
vecină,snoop.ro,0,1,3,4,-0.25,0.25
vârstnic,snoop.ro,0,1,3,4,-0.25,0.25
Azerbaijan,www.euronews.ro,0,0,1,1,0.0,0.0
Emmanuel Macron,www.euronews.ro,0,0,6,6,0.0,0.0
Moscova,www.euronews.ro,0,11,5,16,-0.6875,0.6875
vameș,www.euronews.ro,0,1,0,1,-1.0,1.0
Alexandra Beatrice Bertala,www.euronews.ro,0,0,1,1,0.0,0.0
Alexandra Păcuraru,www.euronews.ro,0,0,1,1,0.0,0.0
Ana Birchall,www.euronews.ro,0,0,3,3,0.0,0.0
Cristian Diaconescu,www.euronews.ro,0,0,3,3,0.0,0.0
Ludovic Orban,www.euronews.ro,0,0,3,3,0.0,0.0
N,www.euronews.ro,0,0,1,1,0.0,0.0
Paul Păcuraru,www.euronews.ro,0,0,1,1,0.0,0.0
Sebastian Popescu,www.euronews.ro,0,0,4,4,0.0,0.0
Silviu Predoiu,www.euronews.ro,0,0,5,5,0.0,0.0
respondent,www.euronews.ro,0,1,15,16,-0.0625,0.0625
subiect,www.euronews.ro,0,0,1,1,0.0,0.0
Cotroceni,www.euronews.ro,0,1,9,10,-0.1,0.1
Grindeanu,www.euronews.ro,0,0,1,1,0.0,0.0
Stănescu,www.euronews.ro,0,0,1,1,0.0,0.0
Tudose,www.euronews.ro,0,0,2,2,0.0,0.0
Victoria Stoiciu,www.euronews.ro,0,1,1,2,-0.5,0.5
comunicator,www.euronews.ro,0,1,1,2,-0.5,0.5
interimar,www.euronews.ro,0,0,1,1,0.0,0.0
sfințit,www.euronews.ro,0,0,1,1,0.0,0.0
consilier,www.antena3.ro,0,2,16,18,-0.1111111111111111,0.1111111111111111
Albania,recorder.ro,0,0,1,1,0.0,0.0
Aurel Stoica,recorder.ro,0,0,1,1,0.0,0.0
Bianca Spătărelu,recorder.ro,0,1,0,1,-1.0,1.0
Bogdan Alin Stoica,recorder.ro,0,3,0,3,-1.0,1.0
Csokany,recorder.ro,0,2,0,2,-1.0,1.0
Cătălin Manea,recorder.ro,0,0,1,1,0.0,0.0
Daniel Vasile,recorder.ro,0,0,1,1,0.0,0.0
Stoica,recorder.ro,0,2,0,2,-1.0,1.0
Gheorghe Firczak,recorder.ro,0,0,1,1,0.0,0.0
Iliescu,recorder.ro,0,3,1,4,-0.75,0.75
Ion Iliescu,recorder.ro,0,4,4,8,-0.5,0.5
Iulian Firczak,recorder.ro,0,0,1,1,0.0,0.0
Lacziko,recorder.ro,0,0,1,1,0.0,0.0
Laura Ragobete,recorder.ro,0,0,1,1,0.0,0.0
Memish Hashim,recorder.ro,0,0,1,1,0.0,0.0
Mihaela Csokany,recorder.ro,0,2,1,3,-0.6666666666666666,0.6666666666666666
Mircea Istrate,recorder.ro,0,0,1,1,0.0,0.0
Nicolae Markov,recorder.ro,0,0,1,1,0.0,0.0
Nicolae Păun,recorder.ro,0,0,1,1,0.0,0.0
Oana Manolescu,recorder.ro,0,1,0,1,-1.0,1.0
Petronela Csokany,recorder.ro,0,0,1,1,0.0,0.0
Păun,recorder.ro,0,1,0,1,-1.0,1.0
Radu Săvulescu,recorder.ro,0,0,1,1,0.0,0.0
Sorin Grindeanu,recorder.ro,0,1,5,6,-0.16666666666666666,0.16666666666666666
Varujan Pambuccian,recorder.ro,0,0,2,2,0.0,0.0
Vasile,recorder.ro,0,1,0,1,-1.0,1.0
autorizare,recorder.ro,0,1,0,1,-1.0,1.0
fondator,recorder.ro,2,1,4,7,0.14285714285714285,0.14285714285714285
iubit,recorder.ro,0,3,0,3,-1.0,1.0
minoritate,recorder.ro,0,1,1,2,-0.5,0.5
Andrei Țăranu,recorder.ro,0,0,2,2,0.0,0.0
prieteni,recorder.ro,1,1,1,3,0.0,0.0
rude,recorder.ro,1,6,0,7,-0.7142857142857143,0.7142857142857143
Lacziko Eniko Katalin,recorder.ro,0,0,1,1,0.0,0.0
Capitale,primanews.ro,3,1,6,10,0.2,0.2
capitală,primanews.ro,1,1,8,10,0.0,0.0
Câmpia Turzii,primanews.ro,0,1,0,1,-1.0,1.0
Dumnezeu,primanews.ro,2,0,1,3,0.6666666666666666,0.6666666666666666
Monica Dajbog,primanews.ro,0,0,1,1,0.0,0.0
alegător,primanews.ro,0,6,11,17,-0.35294117647058826,0.35294117647058826
alien,primanews.ro,0,1,0,1,-1.0,1.0
debil,primanews.ro,0,1,0,1,-1.0,1.0
femeie,primanews.ro,2,2,4,8,0.0,0.0
Dan Tănasă,recorder.ro,0,1,1,2,-0.5,0.5
Daniel Ciornei,recorder.ro,0,0,1,1,0.0,0.0
Horațiu Potra,recorder.ro,0,2,1,3,-0.6666666666666666,0.6666666666666666
Laura Ștefan,recorder.ro,0,1,0,1,-1.0,1.0
Mihai Negoescu,recorder.ro,0,0,1,1,0.0,0.0
Potra,recorder.ro,0,3,0,3,-1.0,1.0
Strasbourg,recorder.ro,0,0,4,4,0.0,0.0
Tiberiu Bârstan,recorder.ro,0,1,0,1,-1.0,1.0
asociație,recorder.ro,0,1,3,4,-0.25,0.25
celor,recorder.ro,0,3,0,3,-1.0,1.0
familia Vance,recorder.ro,0,1,0,1,-1.0,1.0
Horia Potra,recorder.ro,0,1,0,1,-1.0,1.0
subordonat,recorder.ro,0,3,1,4,-0.75,0.75
Alba,www.g4media.ro,0,1,7,8,-0.125,0.125
Austria,www.g4media.ro,0,0,1,1,0.0,0.0
Cluj Napoca,www.g4media.ro,0,0,1,1,0.0,0.0
Henri Coandă,www.g4media.ro,0,0,1,1,0.0,0.0
Sibiu,www.g4media.ro,0,0,5,5,0.0,0.0
Vasile Pușcaș,www.g4media.ro,0,1,0,1,-1.0,1.0
Viena,www.g4media.ro,0,0,1,1,0.0,0.0
om de afaceri,www.g4media.ro,1,4,5,10,-0.3,0.3
Emil Boc,www.g4media.ro,0,1,3,4,-0.25,0.25
George Becali,www.g4media.ro,0,1,2,3,-0.3333333333333333,0.3333333333333333
Gorj,www.g4media.ro,0,0,2,2,0.0,0.0
Mihaela Pintilie,www.g4media.ro,0,0,1,1,0.0,0.0
Mircea Sandu,www.g4media.ro,0,1,0,1,-1.0,1.0
Pintilie,www.g4media.ro,0,1,0,1,-1.0,1.0
Sandu,www.g4media.ro,0,3,0,3,-1.0,1.0
Steluța Gemănaru,www.g4media.ro,0,0,1,1,0.0,0.0
Săcălaz,www.g4media.ro,0,0,1,1,0.0,0.0
Timiș,www.g4media.ro,0,0,6,6,0.0,0.0
Tunari,www.g4media.ro,0,0,3,3,0.0,0.0
angajat,www.g4media.ro,0,3,11,14,-0.21428571428571427,0.21428571428571427
familie,www.g4media.ro,5,2,9,16,0.1875,0.1875
profesor,www.g4media.ro,0,1,10,11,-0.09090909090909091,0.09090909090909091
reporter,www.g4media.ro,0,3,6,9,-0.3333333333333333,0.3333333333333333
soție,www.g4media.ro,1,2,16,19,-0.05263157894736842,0.05263157894736842
Cristian Tudor Popescu,www.digi24.ro,0,0,5,5,0.0,0.0
avocat,www.romaniatv.net,1,5,1,7,-0.5714285714285714,0.5714285714285714
Donald Trump,www.romaniatv.net,1,9,10,20,-0.4,0.4
martor,www.romaniatv.net,0,0,2,2,0.0,0.0
António Costa,www.gandul.ro,0,0,1,1,0.0,0.0
Borrell,www.gandul.ro,0,0,1,1,0.0,0.0
Costa,www.gandul.ro,0,0,1,1,0.0,0.0
Germania,www.gandul.ro,0,1,7,8,-0.125,0.125
Giorgia Meloni,www.gandul.ro,0,0,1,1,0.0,0.0
Italia,www.gandul.ro,0,1,4,5,-0.2,0.2
Juncker,www.gandul.ro,0,1,0,1,-1.0,1.0
Kaja Kallas,www.gandul.ro,0,0,1,1,0.0,0.0
Liberala Kallas,www.gandul.ro,0,0,1,1,0.0,0.0
Lisabona,www.gandul.ro,0,0,1,1,0.0,0.0
Luxemburg,www.gandul.ro,0,0,5,5,0.0,0.0
Macron,www.gandul.ro,1,0,1,2,0.5,0.5
Manfred Weber,www.gandul.ro,0,0,1,1,0.0,0.0
Michel,www.gandul.ro,0,0,1,1,0.0,0.0
Olaf Scholz,www.gandul.ro,0,1,2,3,-0.3333333333333333,0.3333333333333333
Roberta Metsola,www.gandul.ro,2,0,3,5,0.4,0.4
socialist,www.gandul.ro,0,1,0,1,-1.0,1.0
Thanasis Bakolas,www.gandul.ro,0,0,1,1,0.0,0.0
amândoi,www.gandul.ro,0,1,1,2,-0.5,0.5
cancelar,www.gandul.ro,0,4,2,6,-0.6666666666666666,0.6666666666666666
candidați,www.gandul.ro,0,6,9,15,-0.4,0.4
Siegfried Mureșan,www.gandul.ro,0,0,3,3,0.0,0.0
politician,www.gandul.ro,0,30,2,32,-0.9375,0.9375
populație,www.gandul.ro,0,0,4,4,0.0,0.0
procuror,www.gandul.ro,0,5,5,10,-0.5,0.5
secretar general,www.gandul.ro,0,4,14,18,-0.2222222222222222,0.2222222222222222
titular,www.gandul.ro,0,2,3,5,-0.4,0.4
von der Leyen,www.gandul.ro,0,0,3,3,0.0,0.0
șefă,www.gandul.ro,0,2,8,10,-0.2,0.2
Capitale,www.gandul.ro,0,3,15,18,-0.16666666666666666,0.16666666666666666
Kovesi,www.realitatea.net,0,1,1,2,-0.5,0.5
cei,www.realitatea.net,0,0,1,1,0.0,0.0
prim ministru,www.realitatea.net,0,0,1,1,0.0,0.0
Bolojan,www.realitatea.net,0,4,6,10,-0.4,0.4
Bulgaria,www.realitatea.net,0,0,2,2,0.0,0.0
Volodimir Zelenski,www.realitatea.net,0,3,2,5,-0.6,0.6
militar,www.realitatea.net,1,0,2,3,0.3333333333333333,0.3333333333333333
Andrii Sybiha,www.digi24.ro,0,0,1,1,0.0,0.0
Armenia,www.digi24.ro,0,0,1,1,0.0,0.0
Azerbaidjan,www.digi24.ro,0,0,1,1,0.0,0.0
Emil Hurezeanu,www.digi24.ro,0,0,7,7,0.0,0.0
Gaza,www.digi24.ro,0,0,1,1,0.0,0.0
Israel,www.digi24.ro,0,1,4,5,-0.2,0.2
Liban,www.digi24.ro,0,0,1,1,0.0,0.0
Londra,www.digi24.ro,0,0,2,2,0.0,0.0
Luxemburg,www.digi24.ro,0,0,2,2,0.0,0.0
Marea Britanie,www.digi24.ro,0,0,3,3,0.0,0.0
Siria,www.digi24.ro,0,0,1,1,0.0,0.0
Sudan,www.digi24.ro,0,0,2,2,0.0,0.0
miniștri,www.digi24.ro,0,4,6,10,-0.4,0.4
omolog,www.digi24.ro,0,1,6,7,-0.14285714285714285,0.14285714285714285
Gheorghe Asachi,www.news.ro,0,0,1,1,0.0,0.0
Diana Șoșoacă,www.b1tv.ro,0,3,4,7,-0.42857142857142855,0.42857142857142855
Lazarus,www.b1tv.ro,0,0,1,1,0.0,0.0
Luis Lazarus,www.b1tv.ro,0,0,1,1,0.0,0.0
Mircea Geoană,www.b1tv.ro,0,1,2,3,-0.3333333333333333,0.3333333333333333
Viena,www.b1tv.ro,0,0,2,2,0.0,0.0
copil,www.b1tv.ro,2,0,3,5,0.4,0.4
Luiz Lazarus,www.b1tv.ro,0,0,1,1,0.0,0.0
Ionuț Stroe,primanews.ro,1,1,6,8,0.0,0.0
partener,primanews.ro,0,3,5,8,-0.375,0.375
Italia,www.romaniatv.net,0,0,7,7,0.0,0.0
Maia Sandu,www.romaniatv.net,1,0,2,3,0.3333333333333333,0.3333333333333333
Meloni,www.romaniatv.net,0,0,2,2,0.0,0.0
Ursula von der Leyen,www.romaniatv.net,0,0,4,4,0.0,0.0
Volodimir Zelenski,www.romaniatv.net,0,1,2,3,-0.3333333333333333,0.3333333333333333
votant,www.romaniatv.net,0,10,5,15,-0.6666666666666666,0.6666666666666666
director,primanews.ro,0,1,2,3,-0.3333333333333333,0.3333333333333333
elev,primanews.ro,0,0,2,2,0.0,0.0
profesor,primanews.ro,0,1,2,3,-0.3333333333333333,0.3333333333333333
acesta,primanews.ro,1,0,1,2,0.5,0.5
beneficiar,primanews.ro,2,1,0,3,0.3333333333333333,0.3333333333333333
demnitar,primanews.ro,0,1,0,1,-1.0,1.0
Șandru,adevarul.ro,0,0,2,2,0.0,0.0
Adrian Năstase,www.activenews.ro,0,2,0,2,-1.0,1.0
Antonescu,www.activenews.ro,0,4,2,6,-0.6666666666666666,0.6666666666666666
Bogdan Tiberiu Iacob,www.activenews.ro,0,1,2,3,-0.3333333333333333,0.3333333333333333
Bolojan,www.activenews.ro,0,3,2,5,-0.6,0.6
Băsescu,www.activenews.ro,0,9,0,9,-1.0,1.0
Crin,www.activenews.ro,0,3,0,3,-1.0,1.0
Emil Constantinescu,www.activenews.ro,0,0,1,1,0.0,0.0
Geoană,www.activenews.ro,0,2,0,2,-1.0,1.0
Grindeanu,www.activenews.ro,0,0,1,1,0.0,0.0
Mihai Tîrnoveanu,www.activenews.ro,0,1,1,2,-0.5,0.5
Mircea Geoană,www.activenews.ro,0,3,2,5,-0.6,0.6
Viktor Orban,www.activenews.ro,0,6,1,7,-0.8571428571428571,0.8571428571428571
ardeleni,www.activenews.ro,0,1,0,1,-1.0,1.0
d,www.activenews.ro,0,0,1,1,0.0,0.0
etic,www.activenews.ro,0,1,0,1,-1.0,1.0
Diana Tusa,www.aktual24.ro,0,1,2,3,-0.3333333333333333,0.3333333333333333
Emmanuel Macron,www.aktual24.ro,0,1,11,12,-0.08333333333333333,0.08333333333333333
Iosif Buble,www.aktual24.ro,0,1,1,2,-0.5,0.5
Keir Starmer,www.aktual24.ro,0,0,9,9,0.0,0.0
Londra,www.aktual24.ro,0,0,4,4,0.0,0.0
Regatul Unit,www.aktual24.ro,0,0,8,8,0.0,0.0
Volodimir Zelenski,www.aktual24.ro,0,3,8,11,-0.2727272727272727,0.2727272727272727
omolog,www.aktual24.ro,1,0,1,2,0.5,0.5
Pîrvulescu,adevarul.ro,0,2,7,9,-0.2222222222222222,0.2222222222222222
senatoare,adevarul.ro,0,1,1,2,-0.5,0.5
Uniunea Sovietică,adevarul.ro,0,1,1,2,-0.5,0.5
Șoșoacă,adevarul.ro,0,8,5,13,-0.6153846153846154,0.6153846153846154
Andrei Ilie,primanews.ro,0,0,1,1,0.0,0.0
Bucureștean,primanews.ro,0,0,2,2,0.0,0.0
București,primanews.ro,2,3,18,23,-0.043478260869565216,0.043478260869565216
Comanda,primanews.ro,0,0,1,1,0.0,0.0
Cornel Lazia,primanews.ro,1,0,1,2,0.5,0.5
DJ,primanews.ro,0,0,1,1,0.0,0.0
Dan Byron,primanews.ro,1,0,0,1,1.0,1.0
Dany Serrano,primanews.ro,0,0,1,1,0.0,0.0
Laszlo Demeter,primanews.ro,0,0,1,1,0.0,0.0
participanți,primanews.ro,0,0,1,1,0.0,0.0
public,primanews.ro,2,2,4,8,0.0,0.0
Sergiu Mitrofan,primanews.ro,0,0,1,1,0.0,0.0
actor,primanews.ro,0,0,2,2,0.0,0.0
Mirel Leventer,primanews.ro,0,0,2,2,0.0,0.0
autoritate,primanews.ro,0,1,0,1,-1.0,1.0
creator,primanews.ro,1,0,0,1,1.0,1.0
locuitor,primanews.ro,0,0,4,4,0.0,0.0
participant,primanews.ro,1,1,3,5,0.0,0.0
turișt,primanews.ro,0,1,1,2,-0.5,0.5
Birchall,www.mediafax.ro,0,0,1,1,0.0,0.0
cadru didactic,www.mediafax.ro,1,0,0,1,1.0,1.0
personal didactic,www.mediafax.ro,0,0,1,1,0.0,0.0
Elena Udrea,www.mediafax.ro,0,6,4,10,-0.6,0.6
Elene Udrea,www.mediafax.ro,0,3,1,4,-0.75,0.75
Vicepreședintele,www.mediafax.ro,2,1,5,8,0.125,0.125
Audrey Azoulay,primanews.ro,0,0,1,1,0.0,0.0
autor,primanews.ro,1,0,5,6,0.16666666666666666,0.16666666666666666
bibliotecar,primanews.ro,1,0,1,2,0.5,0.5
Bogdan Crețu,primanews.ro,0,0,1,1,0.0,0.0
Brazilia,primanews.ro,0,0,1,1,0.0,0.0
Daniela Vizireanu,primanews.ro,0,0,1,1,0.0,0.0
Inca Garcilaso de la Vega,primanews.ro,0,0,1,1,0.0,0.0
Jordi,primanews.ro,0,0,1,1,0.0,0.0
Josep Pla,primanews.ro,0,0,1,1,0.0,0.0
K. Laxness,primanews.ro,0,0,1,1,0.0,0.0
Manuel Mejía Vallejo,primanews.ro,0,0,1,1,0.0,0.0
Marius Constantinescu,primanews.ro,0,0,1,1,0.0,0.0
Maurice Druon,primanews.ro,0,0,1,1,0.0,0.0
Miguel de Cervantes,primanews.ro,0,0,1,1,0.0,0.0
Monica Cure,primanews.ro,0,0,1,1,0.0,0.0
Paris,primanews.ro,0,0,4,4,0.0,0.0
Rio de Janeiro,primanews.ro,1,0,0,1,1.0,1.0
Sfântul Gheorghe,primanews.ro,0,0,1,1,0.0,0.0
Vladimir Nabokov,primanews.ro,0,0,1,1,0.0,0.0
William Shakespeare,primanews.ro,0,0,1,1,0.0,0.0
bărbat,primanews.ro,0,2,1,3,-0.6666666666666666,0.6666666666666666
cititor,primanews.ro,1,0,1,2,0.5,0.5
editor,primanews.ro,0,1,1,2,-0.5,0.5
fete,primanews.ro,0,0,1,1,0.0,0.0
librar,primanews.ro,1,0,0,1,1.0,1.0
scriitor,primanews.ro,0,0,2,2,0.0,0.0
Dragomir Tomașeschi,adevarul.ro,0,0,1,1,0.0,0.0
Tomașeschi,adevarul.ro,0,0,1,1,0.0,0.0
aspirant,adevarul.ro,0,1,2,3,-0.3333333333333333,0.3333333333333333
avocat,adevarul.ro,0,3,8,11,-0.2727272727272727,0.2727272727272727
Armand,www.cotidianul.ro,0,0,1,1,0.0,0.0
Ciprian Ciucu,www.cotidianul.ro,0,0,1,1,0.0,0.0
Clotilde Armand,www.cotidianul.ro,0,0,1,1,0.0,0.0
Daniel Buda,www.cotidianul.ro,0,0,2,2,0.0,0.0
Siegfried Mureșan,www.cotidianul.ro,0,0,2,2,0.0,0.0
Stelian Ion,www.cotidianul.ro,0,0,1,1,0.0,0.0
șeful statului,stirileprotv.ro,0,2,4,6,-0.3333333333333333,0.3333333333333333
Ludovic Orban,www.antena3.ro,0,1,7,8,-0.125,0.125
realizator,www.antena3.ro,0,2,4,6,-0.3333333333333333,0.3333333333333333
Ion Iliescu,www.g4media.ro,0,1,5,6,-0.16666666666666666,0.16666666666666666
Lucian Romașcanu,www.euronews.ro,0,0,7,7,0.0,0.0
Romașcanu,www.euronews.ro,0,0,3,3,0.0,0.0
actor,adevarul.ro,0,8,11,19,-0.42105263157894735,0.42105263157894735
artist,adevarul.ro,1,1,3,5,0.0,0.0
Tudor Chirilă,adevarul.ro,0,0,2,2,0.0,0.0
prieteni,adevarul.ro,3,2,2,7,0.14285714285714285,0.14285714285714285
China,www.mediafax.ro,0,1,2,3,-0.3333333333333333,0.3333333333333333
Ionuț Moșteanu,www.mediafax.ro,1,0,9,10,0.1,0.1
John Ion Banu,www.mediafax.ro,1,0,0,1,1.0,1.0
Crin Antonescu,www.news.ro,5,14,53,72,-0.125,0.125
Dragoș Sprânceană,www.news.ro,0,0,3,3,0.0,0.0
Hunedoara,www.news.ro,0,0,1,1,0.0,0.0
Mar,www.news.ro,0,0,3,3,0.0,0.0
Rareș Bogdan,www.news.ro,0,1,6,7,-0.14285714285714285,0.14285714285714285
Mihai,www.news.ro,0,0,2,2,0.0,0.0
domnie,www.news.ro,0,4,0,4,-1.0,1.0
Sprânceană,www.news.ro,0,1,1,2,-0.5,0.5
intermediar,www.news.ro,0,0,1,1,0.0,0.0
patriarh,www.news.ro,0,0,1,1,0.0,0.0
Tomița,www.news.ro,0,0,1,1,0.0,0.0
Dacian Cioloș,www.euronews.ro,0,0,2,2,0.0,0.0
Drulă,www.euronews.ro,0,1,0,1,-1.0,1.0
prezidențiabil,www.euronews.ro,0,2,3,5,-0.4,0.4
miniștri,adevarul.ro,0,4,6,10,-0.4,0.4
Alex Jones,www.antena3.ro,0,1,0,1,-1.0,1.0
Alice Weidel,www.antena3.ro,0,0,2,2,0.0,0.0
Bogdan Ivan,www.antena3.ro,0,0,1,1,0.0,0.0
București,www.antena3.ro,1,0,21,22,0.045454545454545456,0.045454545454545456
Elon Musk,www.antena3.ro,0,1,4,5,-0.2,0.2
Emil Hurezeanu,www.antena3.ro,0,1,5,6,-0.16666666666666666,0.16666666666666666
Keith Kellogg,www.antena3.ro,0,0,1,1,0.0,0.0
Musk,www.antena3.ro,0,3,1,4,-0.75,0.75
München,www.antena3.ro,0,0,2,2,0.0,0.0
oficial,www.antena3.ro,1,10,3,14,-0.6428571428571429,0.6428571428571429
Richard Grenell,www.antena3.ro,0,0,1,1,0.0,0.0
SUA,www.antena3.ro,2,3,28,33,-0.030303030303030304,0.030303030303030304
Scholz,www.antena3.ro,0,0,1,1,0.0,0.0
Vance,www.antena3.ro,0,2,0,2,-1.0,1.0
Vladimir Putin,www.antena3.ro,0,5,3,8,-0.625,0.625
Olaf Scholz,www.antena3.ro,0,2,0,2,-1.0,1.0
George Soros,www.antena3.ro,0,1,0,1,-1.0,1.0
influencer,www.antena3.ro,0,4,0,4,-1.0,1.0
inginer,www.antena3.ro,0,0,7,7,0.0,0.0
susținătoare,www.antena3.ro,1,0,0,1,1.0,1.0
trimis,www.antena3.ro,0,0,1,1,0.0,0.0
Fanel Iacobescu,www.luju.ro,0,0,2,2,0.0,0.0
specialist,www.luju.ro,1,1,0,2,0.0,0.0
Lasconi,www.comisarul.ro,1,2,8,11,-0.09090909090909091,0.09090909090909091
Laura Chiriac,www.comisarul.ro,0,0,1,1,0.0,0.0
lume,www.comisarul.ro,0,4,5,9,-0.4444444444444444,0.4444444444444444
politician,www.comisarul.ro,0,37,4,41,-0.9024390243902439,0.9024390243902439
judecător,www.antena3.ro,0,8,9,17,-0.47058823529411764,0.47058823529411764
magistrat,www.antena3.ro,1,8,8,17,-0.4117647058823529,0.4117647058823529
personal,www.antena3.ro,0,0,4,4,0.0,0.0
procuror,www.antena3.ro,0,9,6,15,-0.6,0.6
Vasile Dîncu,www.euronews.ro,0,1,3,4,-0.25,0.25
Volodimir Zelenski,www.euronews.ro,1,2,13,16,-0.0625,0.0625
terorist,www.euronews.ro,0,1,0,1,-1.0,1.0
titular,www.euronews.ro,0,0,1,1,0.0,0.0
Aurelia Cristea,pressone.ro,0,0,2,2,0.0,0.0
Cavnic,pressone.ro,0,1,0,1,-1.0,1.0
Chirica,pressone.ro,0,2,0,2,-1.0,1.0
Ciprian Necula,pressone.ro,0,1,1,2,-0.5,0.5
Daniel Șandru,pressone.ro,0,0,1,1,0.0,0.0
Florin Iordache,pressone.ro,0,1,11,12,-0.08333333333333333,0.08333333333333333
Florin Jianu,pressone.ro,0,0,1,1,0.0,0.0
Ialomița,pressone.ro,0,1,3,4,-0.25,0.25
Iași,pressone.ro,2,2,17,21,0.0,0.0
Mihai Chirica,pressone.ro,0,2,0,2,-1.0,1.0
Mihai Gore,pressone.ro,0,1,0,1,-1.0,1.0
Necula,pressone.ro,0,1,0,1,-1.0,1.0
Năstase,pressone.ro,0,4,5,9,-0.4444444444444444,0.4444444444444444
Sighișoara,pressone.ro,0,0,1,1,0.0,0.0
Valentin Lupșa,pressone.ro,0,1,0,1,-1.0,1.0
Vicepreședintele,pressone.ro,0,1,3,4,-0.25,0.25
Vladimir Petruț,pressone.ro,0,1,0,1,-1.0,1.0
ar,pressone.ro,0,3,0,3,-1.0,1.0
demnitar,pressone.ro,1,11,0,12,-0.8333333333333334,0.8333333333333334
nemulțumit,pressone.ro,0,1,0,1,-1.0,1.0
universitar,pressone.ro,0,2,2,4,-0.5,0.5
Urelia Cristea,pressone.ro,0,1,0,1,-1.0,1.0
Șandru,pressone.ro,0,1,1,2,-0.5,0.5
Ovidiu Mălăncrăvean,pressone.ro,0,1,0,1,-1.0,1.0
Dan Cărbunaru,www.gandul.ro,0,0,1,1,0.0,0.0
Florin Roman,www.gandul.ro,0,1,4,5,-0.2,0.2
Sorin Grindeanu,www.gandul.ro,0,2,15,17,-0.11764705882352941,0.11764705882352941
Virgil Popescu,www.gandul.ro,0,0,2,2,0.0,0.0
demnitar,www.gandul.ro,0,5,0,5,-1.0,1.0
Chesnoiu,www.gandul.ro,0,0,1,1,0.0,0.0
Dâncu,www.gandul.ro,0,0,1,1,0.0,0.0
Rafila,www.gandul.ro,0,1,3,4,-0.25,0.25
purtător de cuvânt,www.gandul.ro,0,2,11,13,-0.15384615384615385,0.15384615384615385
șef de stat,www.gandul.ro,1,1,5,7,0.0,0.0
Alexandru Vucici,adevarul.ro,0,0,1,1,0.0,0.0
Irlanda,adevarul.ro,0,0,2,2,0.0,0.0
Liviu Iolu,adevarul.ro,0,0,1,1,0.0,0.0
client,adevarul.ro,1,2,2,5,-0.2,0.2
omolog,adevarul.ro,0,7,4,11,-0.6363636363636364,0.6363636363636364
Alexandru Muraru,agerpres.ro,0,0,4,4,0.0,0.0
ieșean,agerpres.ro,0,1,0,1,-1.0,1.0
Anamaria Gavrilă,www.mediafax.ro,0,1,3,4,-0.25,0.25
Elena Lasconi,www.mediafax.ro,0,7,24,31,-0.22580645161290322,0.22580645161290322
Gavrilă,www.mediafax.ro,0,0,1,1,0.0,0.0
Emil Constantinescu,www.comisarul.ro,1,0,5,6,0.16666666666666666,0.16666666666666666
Mihai Răzvan Ungureanu,www.comisarul.ro,0,0,1,1,0.0,0.0
Mircea Malița,www.comisarul.ro,0,0,1,1,0.0,0.0
Mugur Isărescu,www.comisarul.ro,0,0,1,1,0.0,0.0
ambasador,www.comisarul.ro,2,3,4,9,-0.1111111111111111,0.1111111111111111
candidați,www.comisarul.ro,0,5,10,15,-0.3333333333333333,0.3333333333333333
electorat,www.comisarul.ro,1,8,13,22,-0.3181818181818182,0.3181818181818182
jurnalist,www.comisarul.ro,0,14,30,44,-0.3181818181818182,0.3181818181818182
raportor,www.comisarul.ro,0,0,1,1,0.0,0.0
consilier,www.cotidianul.ro,0,9,2,11,-0.8181818181818182,0.8181818181818182
Ovidiu Zară,www.cotidianul.ro,0,1,0,1,-1.0,1.0
Bucureștean,www.cotidianul.ro,0,0,1,1,0.0,0.0
salvator,www.cotidianul.ro,0,3,0,3,-1.0,1.0
Ștefan Oprea,www.cotidianul.ro,0,1,1,2,-0.5,0.5
coleg,www.mediafax.ro,8,5,17,30,0.1,0.1
Cluj,www.cotidianul.ro,0,0,6,6,0.0,0.0
Dumitru Coarnă,www.cotidianul.ro,0,1,0,1,-1.0,1.0
Snoop,www.cotidianul.ro,0,0,1,1,0.0,0.0
Vasile Blaga,www.cotidianul.ro,0,2,3,5,-0.4,0.4
angajat,www.cotidianul.ro,0,7,6,13,-0.5384615384615384,0.5384615384615384
,www.comisarul.ro,0,2,2,4,-0.5,0.5
Alexandrescu,www.comisarul.ro,0,0,1,1,0.0,0.0
America,www.comisarul.ro,0,2,6,8,-0.25,0.25
Anca Alexandrescu,www.comisarul.ro,0,0,2,2,0.0,0.0
Anglia,www.comisarul.ro,0,0,1,1,0.0,0.0
Arabia Saudită,www.comisarul.ro,0,0,2,2,0.0,0.0
Austria,www.comisarul.ro,0,0,3,3,0.0,0.0
Bansko,www.comisarul.ro,0,1,0,1,-1.0,1.0
Beniamin Netanyahu,www.comisarul.ro,0,0,1,1,0.0,0.0
Brazilia,www.comisarul.ro,0,0,2,2,0.0,0.0
China,www.comisarul.ro,0,0,5,5,0.0,0.0
Cipru,www.comisarul.ro,0,1,3,4,-0.25,0.25
Cluj,www.comisarul.ro,0,0,10,10,0.0,0.0
conducător,www.comisarul.ro,0,2,0,2,-1.0,1.0
Dan Dungaciu,www.comisarul.ro,0,0,4,4,0.0,0.0
Florin Zamfirescu,www.comisarul.ro,0,0,1,1,0.0,0.0
funcționar,www.comisarul.ro,0,6,1,7,-0.8571428571428571,0.8571428571428571
Fălticeni,www.comisarul.ro,0,1,0,1,-1.0,1.0
Gaza,www.comisarul.ro,0,0,1,1,0.0,0.0
Gelu Vișan,www.comisarul.ro,0,0,1,1,0.0,0.0
George,www.comisarul.ro,0,0,3,3,0.0,0.0
Germania,www.comisarul.ro,0,4,14,18,-0.2222222222222222,0.2222222222222222
Giorgia Meloni,www.comisarul.ro,0,0,2,2,0.0,0.0
Gorj,www.comisarul.ro,0,0,3,3,0.0,0.0
Grecia,www.comisarul.ro,0,0,4,4,0.0,0.0
Hagi,www.comisarul.ro,0,1,0,1,-1.0,1.0
Halep,www.comisarul.ro,0,0,1,1,0.0,0.0
Iisus Hristos,www.comisarul.ro,0,0,1,1,0.0,0.0
Iosefina Pascal,www.comisarul.ro,0,0,1,1,0.0,0.0
Iran,www.comisarul.ro,0,2,0,2,-1.0,1.0
Karol Nawrocki,www.comisarul.ro,0,0,3,3,0.0,0.0
Marius Tucă,www.comisarul.ro,0,0,1,1,0.0,0.0
Moldova,www.comisarul.ro,1,2,11,14,-0.07142857142857142,0.07142857142857142
Morawiecki,www.comisarul.ro,0,1,0,1,-1.0,1.0
Nazaret,www.comisarul.ro,0,0,1,1,0.0,0.0
Netanyahu,www.comisarul.ro,0,1,0,1,-1.0,1.0
Nicolae Iorga,www.comisarul.ro,1,0,0,1,1.0,1.0
Oman,www.comisarul.ro,1,0,1,2,0.5,0.5
Paris,www.comisarul.ro,1,0,5,6,0.16666666666666666,0.16666666666666666
pensionar,www.comisarul.ro,0,3,4,7,-0.42857142857142855,0.42857142857142855
Portugalia,www.comisarul.ro,0,0,2,2,0.0,0.0
Premierul Donald Tusk,www.comisarul.ro,0,1,0,1,-1.0,1.0
Robert Turcescu,www.comisarul.ro,0,0,2,2,0.0,0.0
sector,www.comisarul.ro,0,1,0,1,-1.0,1.0
Siria,www.comisarul.ro,0,1,1,2,-0.5,0.5
Sorina Matei,www.comisarul.ro,0,0,1,1,0.0,0.0
Soros,www.comisarul.ro,0,2,0,2,-1.0,1.0
Spania,www.comisarul.ro,0,0,12,12,0.0,0.0
Ștefan Bartulica,www.comisarul.ro,0,0,1,1,0.0,0.0
Tiberiu Iacob,www.comisarul.ro,0,0,1,1,0.0,0.0
Turcia,www.comisarul.ro,0,0,3,3,0.0,0.0
Uniunea,www.comisarul.ro,0,2,0,2,-1.0,1.0
Varșovia,www.comisarul.ro,0,1,4,5,-0.2,0.2
Voronin,www.comisarul.ro,0,1,0,1,-1.0,1.0
Washington,www.comisarul.ro,0,1,5,6,-0.16666666666666666,0.16666666666666666
Zabrze,www.comisarul.ro,0,0,1,1,0.0,0.0
acelui,www.comisarul.ro,0,1,0,1,-1.0,1.0
adept,www.comisarul.ro,0,3,0,3,-1.0,1.0
aliaț,www.comisarul.ro,0,4,1,5,-0.8,0.8
amantel,www.comisarul.ro,0,1,0,1,-1.0,1.0
amândoi,www.comisarul.ro,0,1,2,3,-0.3333333333333333,0.3333333333333333
angajat,www.comisarul.ro,2,4,4,10,-0.2,0.2
ascultător,www.comisarul.ro,0,1,0,1,-1.0,1.0
bucureștean,www.comisarul.ro,0,0,2,2,0.0,0.0
băiat,www.comisarul.ro,0,2,3,5,-0.4,0.4
cadru,www.comisarul.ro,0,1,0,1,-1.0,1.0
domnul,www.comisarul.ro,0,0,2,2,0.0,0.0
Dungaciu,www.comisarul.ro,0,0,3,3,0.0,0.0
emisar,www.comisarul.ro,0,2,0,2,-1.0,1.0
europarlamentar,www.comisarul.ro,0,4,8,12,-0.3333333333333333,0.3333333333333333
familie,www.comisarul.ro,3,4,5,12,-0.08333333333333333,0.08333333333333333
fiu,www.comisarul.ro,0,0,7,7,0.0,0.0
frate,www.comisarul.ro,1,3,4,8,-0.25,0.25
individ,www.comisarul.ro,1,3,0,4,-0.5,0.5
invitat,www.comisarul.ro,0,0,1,1,0.0,0.0
maeștră,www.comisarul.ro,1,0,0,1,1.0,1.0
magistrat,www.comisarul.ro,0,7,5,12,-0.5833333333333334,0.5833333333333334
mamă,www.comisarul.ro,1,1,1,3,0.0,0.0
militar,www.comisarul.ro,0,0,4,4,0.0,0.0
minier,www.comisarul.ro,1,0,0,1,1.0,1.0
patriot,www.comisarul.ro,1,2,0,3,-0.3333333333333333,0.3333333333333333
patron,www.comisarul.ro,0,7,3,10,-0.7,0.7
politruc,www.comisarul.ro,0,1,0,1,-1.0,1.0
polițist,www.comisarul.ro,0,9,7,16,-0.5625,0.5625
pompier,www.comisarul.ro,0,1,2,3,-0.3333333333333333,0.3333333333333333
popor,www.comisarul.ro,7,6,2,15,0.06666666666666667,0.06666666666666667
prieteni,www.comisarul.ro,2,0,3,5,0.4,0.4
rump,www.comisarul.ro,0,1,0,1,-1.0,1.0
soție,www.comisarul.ro,0,2,23,25,-0.08,0.08
stăpân,www.comisarul.ro,0,1,1,2,-0.5,0.5
suveran,www.comisarul.ro,0,9,0,9,-1.0,1.0
tată,www.comisarul.ro,0,1,13,14,-0.07142857142857142,0.07142857142857142
tâmplar,www.comisarul.ro,0,0,1,1,0.0,0.0
vârstnic,www.comisarul.ro,1,0,0,1,1.0,1.0
împărat,www.comisarul.ro,0,2,0,2,-1.0,1.0
pe,agerpres.ro,0,0,1,1,0.0,0.0
Sorinel Peneș,agerpres.ro,0,0,4,4,0.0,0.0
candidați,agerpres.ro,0,1,2,3,-0.3333333333333333,0.3333333333333333
cupolă,agerpres.ro,0,1,0,1,-1.0,1.0
Grindeanu,agerpres.ro,0,0,2,2,0.0,0.0
peneliști,agerpres.ro,0,1,0,1,-1.0,1.0
pescar,agerpres.ro,0,1,0,1,-1.0,1.0
sediuș,agerpres.ro,0,1,0,1,-1.0,1.0
Brăila,stirileprotv.ro,0,0,1,1,0.0,0.0
Bacău,stirileprotv.ro,0,1,2,3,-0.3333333333333333,0.3333333333333333
Cătălin Toma,stirileprotv.ro,0,0,1,1,0.0,0.0
Hunedoara,stirileprotv.ro,0,0,2,2,0.0,0.0
Ialomița,stirileprotv.ro,0,1,1,2,-0.5,0.5
Vrancea,stirileprotv.ro,0,1,2,3,-0.3333333333333333,0.3333333333333333
câștigător,stirileprotv.ro,1,0,1,2,0.5,0.5
liberal,stirileprotv.ro,0,6,0,6,-1.0,1.0
Nicolae Robu,stirileprotv.ro,0,0,2,2,0.0,0.0
capitală,www.g4media.ro,0,1,5,6,-0.16666666666666666,0.16666666666666666
Diana Șoșoacă,www.g4media.ro,0,10,3,13,-0.7692307692307693,0.7692307692307693
Elena Năstăsoiu,www.g4media.ro,0,1,0,1,-1.0,1.0
Enachi Raisa,www.g4media.ro,0,1,0,1,-1.0,1.0
Marius Apopei,www.g4media.ro,0,1,0,1,-1.0,1.0
Mihail Dojană,www.g4media.ro,0,1,0,1,-1.0,1.0
Năstăsoiu,www.g4media.ro,0,1,0,1,-1.0,1.0
Ovidiu Szime,www.g4media.ro,0,0,1,1,0.0,0.0
Radu Ghidău,www.g4media.ro,0,1,0,1,-1.0,1.0
senatoare,www.g4media.ro,0,1,0,1,-1.0,1.0
Valentin Florea,www.g4media.ro,0,0,1,1,0.0,0.0
Vaslui,www.g4media.ro,0,0,5,5,0.0,0.0
Virgil Popescu,www.g4media.ro,0,0,1,1,0.0,0.0
Ana Birchall,www.romaniatv.net,0,0,1,1,0.0,0.0
Daniel Funeriu,www.romaniatv.net,0,0,3,3,0.0,0.0
Elena Lasconi,www.romaniatv.net,1,9,30,40,-0.2,0.2
prim-ministru,www.romaniatv.net,0,4,12,16,-0.25,0.25
personalitate,www.romaniatv.net,0,1,2,3,-0.3333333333333333,0.3333333333333333
Hașotti,adevarul.ro,0,1,0,1,-1.0,1.0
Puiu Hașotti,adevarul.ro,0,0,1,1,0.0,0.0
Sorin Hașotti,adevarul.ro,0,1,0,1,-1.0,1.0
Capitale,www.realitatea.net,2,3,7,12,-0.08333333333333333,0.08333333333333333
Ciucă,www.realitatea.net,0,1,0,1,-1.0,1.0
Stejarii,www.realitatea.net,0,0,1,1,0.0,0.0
Zaherman,www.realitatea.net,0,1,0,1,-1.0,1.0
edil,www.realitatea.net,1,7,2,10,-0.6,0.6
Georgescu,primanews.ro,0,1,7,8,-0.125,0.125
Horațiu Potra,primanews.ro,0,1,0,1,-1.0,1.0
jandarm,primanews.ro,0,0,1,1,0.0,0.0
mercenar,primanews.ro,0,1,0,1,-1.0,1.0
procuror,primanews.ro,0,1,2,3,-0.3333333333333333,0.3333333333333333
Tudose,www.aktual24.ro,1,5,3,9,-0.4444444444444444,0.4444444444444444
doamnă,www.aktual24.ro,0,2,2,4,-0.5,0.5
Diana Șoșoacă,www.aktual24.ro,0,1,0,1,-1.0,1.0
erou,www.aktual24.ro,0,1,0,1,-1.0,1.0
Dumnezeu,a1.ro,1,1,1,3,0.0,0.0
Kremlin,a1.ro,0,1,0,1,-1.0,1.0
Vladimir Putin,a1.ro,0,1,0,1,-1.0,1.0
Rusia,a1.ro,0,2,0,2,-1.0,1.0
cetățean,a1.ro,2,5,17,24,-0.125,0.125
dictator,a1.ro,0,1,0,1,-1.0,1.0
popor,a1.ro,2,1,0,3,0.3333333333333333,0.3333333333333333
public,a1.ro,2,0,6,8,0.25,0.25
vinovat,a1.ro,0,1,0,1,-1.0,1.0
Blaszcak,www.comisarul.ro,0,1,0,1,-1.0,1.0
Blaszczak,www.comisarul.ro,0,1,0,1,-1.0,1.0
Marcin Romanowski,www.comisarul.ro,0,1,1,2,-0.5,0.5
Mariusz Blaszczak,www.comisarul.ro,0,0,1,1,0.0,0.0
Dariusz Matecki,www.comisarul.ro,0,1,0,1,-1.0,1.0
ministru adjunct,www.comisarul.ro,0,1,0,1,-1.0,1.0
Alin Mituță,stirileprotv.ro,0,1,0,1,-1.0,1.0
Alin Prunean,stirileprotv.ro,0,0,1,1,0.0,0.0
Anca Dragu,stirileprotv.ro,0,0,2,2,0.0,0.0
Andrei Lupu,stirileprotv.ro,0,0,1,1,0.0,0.0
cioloș,stirileprotv.ro,0,0,12,12,0.0,0.0
Cosmin Poteraș,stirileprotv.ro,0,0,1,1,0.0,0.0
Dacian Cioloș,stirileprotv.ro,0,0,17,17,0.0,0.0
Dragoș Pîslaru,stirileprotv.ro,0,0,2,2,0.0,0.0
Dragoș Tudorache,stirileprotv.ro,0,0,1,1,0.0,0.0
Lorant Sas,stirileprotv.ro,0,0,1,1,0.0,0.0
Ramona Strugariu,stirileprotv.ro,0,0,1,1,0.0,0.0
Vlad Voiculescu,stirileprotv.ro,0,0,1,1,0.0,0.0
apropiat,stirileprotv.ro,0,3,1,4,-0.75,0.75
Adrian Vigheciu,www.g4media.ro,0,0,4,4,0.0,0.0
aliaț,www.g4media.ro,0,1,1,2,-0.5,0.5
Cristian Popescu Piedone,www.g4media.ro,0,0,3,3,0.0,0.0
Cătălin Drulă,www.g4media.ro,0,1,1,2,-0.5,0.5
Dacian Cioloș,www.g4media.ro,0,0,2,2,0.0,0.0
Daniel Băluță,www.g4media.ro,0,0,12,12,0.0,0.0
Drulă,www.g4media.ro,0,0,1,1,0.0,0.0
Gabriela Firea,www.g4media.ro,0,0,1,1,0.0,0.0
Mihai Enache,www.g4media.ro,0,1,3,4,-0.25,0.25
Piedone,www.g4media.ro,0,1,2,3,-0.3333333333333333,0.3333333333333333
sector,www.g4media.ro,0,0,1,1,0.0,0.0
Stelian Bujduveanu,www.g4media.ro,0,0,4,4,0.0,0.0
Vlad Gheorghe,www.g4media.ro,0,0,7,7,0.0,0.0
viceprimar,www.g4media.ro,0,6,17,23,-0.2608695652173913,0.2608695652173913
Mircea Popescu,www.cotidianul.ro,0,1,0,1,-1.0,1.0
electorat,www.cotidianul.ro,0,5,6,11,-0.45454545454545453,0.45454545454545453
personaj,www.cotidianul.ro,1,5,1,7,-0.5714285714285714,0.5714285714285714
Adriana Nica,snoop.ro,0,1,0,1,-1.0,1.0
Cristoiu,snoop.ro,0,0,1,1,0.0,0.0
Cătălin,snoop.ro,0,1,1,2,-0.5,0.5
Cătălin Cârstoiu,snoop.ro,0,0,1,1,0.0,0.0
Dragoș Tănăsoiu,snoop.ro,0,0,1,1,0.0,0.0
Ludovic Orban,snoop.ro,0,0,2,2,0.0,0.0
Monica Cîrstoiu,snoop.ro,0,2,2,4,-0.5,0.5
Nica,snoop.ro,0,0,1,1,0.0,0.0
Oprescu,snoop.ro,0,1,0,1,-1.0,1.0
controlor,snoop.ro,0,1,0,1,-1.0,1.0
Roxana Bohîlțea,snoop.ro,0,0,1,1,0.0,0.0
Mirela Neag,snoop.ro,0,0,1,1,0.0,0.0
secretar,snoop.ro,0,1,11,12,-0.08333333333333333,0.08333333333333333
ziarist,snoop.ro,0,4,1,5,-0.8,0.8
Brândușa Vlanga,snoop.ro,0,0,1,1,0.0,0.0
Cristian Mihai,snoop.ro,0,0,1,1,0.0,0.0
Doina Grosu,snoop.ro,0,1,0,1,-1.0,1.0
Doinița Mihai,snoop.ro,0,0,1,1,0.0,0.0
Firea,snoop.ro,0,2,1,3,-0.6666666666666666,0.6666666666666666
Gabriel Radu-Constantinescu,snoop.ro,0,0,2,2,0.0,0.0
Gabriela Firea,snoop.ro,0,0,8,8,0.0,0.0
Gheorghe Gheorghiu,snoop.ro,0,0,1,1,0.0,0.0
Ghiocel Asi,snoop.ro,0,0,1,1,0.0,0.0
Ionuț Mateș,snoop.ro,0,0,1,1,0.0,0.0
Răzvan Luțac,snoop.ro,0,0,2,2,0.0,0.0
Vlanga Andreea,snoop.ro,0,0,1,1,0.0,0.0
Vrancea,snoop.ro,0,0,2,2,0.0,0.0
donator,snoop.ro,0,0,5,5,0.0,0.0
electorat,snoop.ro,0,0,2,2,0.0,0.0
om de afaceri,snoop.ro,0,7,4,11,-0.6363636363636364,0.6363636363636364
patron,snoop.ro,0,11,1,12,-0.9166666666666666,0.9166666666666666
pionier,snoop.ro,0,0,1,1,0.0,0.0
Tucker Carlson,www.realitatea.net,0,1,0,1,-1.0,1.0
diasporă,www.realitatea.net,0,0,1,1,0.0,0.0
finanțator,www.romaniatv.net,0,1,0,1,-1.0,1.0
populație,www.romaniatv.net,0,8,9,17,-0.47058823529411764,0.47058823529411764
Bucium,www.activenews.ro,0,1,0,1,-1.0,1.0
Codruț Olaru,www.activenews.ro,0,0,1,1,0.0,0.0
Comanac,www.activenews.ro,0,0,1,1,0.0,0.0
Dumnezeu,www.activenews.ro,17,3,0,20,0.7,0.7
Gabriel Oprea,www.activenews.ro,0,1,1,2,-0.5,0.5
Gabriel Vlase,www.activenews.ro,0,0,1,1,0.0,0.0
Grigore Popa,www.activenews.ro,0,1,0,1,-1.0,1.0
Hristos,www.activenews.ro,10,0,1,11,0.9090909090909091,0.9090909090909091
Man,www.activenews.ro,0,1,0,1,-1.0,1.0
Silvian,www.activenews.ro,0,0,1,1,0.0,0.0
Tudorel Toader,www.activenews.ro,0,0,1,1,0.0,0.0
agresor,www.activenews.ro,0,1,0,1,-1.0,1.0
apropiat,www.activenews.ro,1,3,1,5,-0.4,0.4
atacator,www.activenews.ro,0,1,0,1,-1.0,1.0
cadru didactic,www.activenews.ro,0,2,2,4,-0.5,0.5
celor,www.activenews.ro,0,1,0,1,-1.0,1.0
dușman,www.activenews.ro,0,3,0,3,-1.0,1.0
Olaru,www.activenews.ro,0,0,1,1,0.0,0.0
jurnalistă,www.activenews.ro,0,0,2,2,0.0,0.0
oponent,www.activenews.ro,0,1,0,1,-1.0,1.0
Toma Tătaru,www.activenews.ro,0,1,0,1,-1.0,1.0
tânăr,www.activenews.ro,0,2,5,7,-0.2857142857142857,0.2857142857142857
Teodosie,www.activenews.ro,1,0,2,3,0.3333333333333333,0.3333333333333333
cuvios,www.activenews.ro,0,0,1,1,0.0,0.0
Dobrogea,www.activenews.ro,0,0,1,1,0.0,0.0
domnului,www.activenews.ro,2,0,0,2,1.0,1.0
Pimen,www.activenews.ro,1,0,1,2,0.5,0.5
LUM,www.activenews.ro,1,0,0,1,1.0,1.0
Milo,www.activenews.ro,0,0,1,1,0.0,0.0
NOI,www.activenews.ro,1,1,0,2,0.0,0.0
Natan,www.activenews.ro,2,0,0,2,1.0,1.0
OAMENI,www.activenews.ro,0,0,2,2,0.0,0.0
Paisie,www.activenews.ro,1,0,0,1,1.0,1.0
Sam,www.activenews.ro,0,0,1,1,0.0,0.0
sfânt,www.activenews.ro,8,0,1,9,0.8888888888888888,0.8888888888888888
Sfântul Ierarh Ioan Gură de Aur,www.activenews.ro,1,0,0,1,1.0,1.0
Sfinții Sila,www.activenews.ro,1,0,0,1,1.0,1.0
Sfântul Cuvios Pahomie cel Mare,www.activenews.ro,1,0,1,2,0.5,0.5
Sfântul Apostol Andrei,www.activenews.ro,1,0,0,1,1.0,1.0
Sila,www.activenews.ro,1,0,0,1,1.0,1.0
Tor,www.activenews.ro,0,0,1,1,0.0,0.0
toți,www.activenews.ro,0,0,1,1,0.0,0.0
Vasile cel Mare,www.activenews.ro,1,0,0,1,1.0,1.0
cârmuitor,www.activenews.ro,0,3,0,3,-1.0,1.0
luminător,www.activenews.ro,1,0,0,1,1.0,1.0
nen,www.activenews.ro,0,1,0,1,-1.0,1.0
pomenire,www.activenews.ro,1,0,0,1,1.0,1.0
povățuitor,www.activenews.ro,1,1,0,2,0.0,0.0
ul,www.activenews.ro,0,1,1,2,-0.5,0.5
Attila Cseke,adevarul.ro,0,0,1,1,0.0,0.0
Tanczos Barna,adevarul.ro,0,0,3,3,0.0,0.0
populație,adevarul.ro,2,7,14,23,-0.21739130434782608,0.21739130434782608
Ceaușescu,stirileprotv.ro,0,2,0,2,-1.0,1.0
Hrebenciuc,stirileprotv.ro,0,1,0,1,-1.0,1.0
Radu Sarbu,stirileprotv.ro,0,2,0,2,-1.0,1.0
Vantu,stirileprotv.ro,0,1,0,1,-1.0,1.0
acestia,stirileprotv.ro,0,3,6,9,-0.3333333333333333,0.3333333333333333
Horațiu Potra,www.b1tv.ro,0,1,0,1,-1.0,1.0
Iulian Fota,www.b1tv.ro,0,0,2,2,0.0,0.0
concetățean,www.b1tv.ro,0,1,0,1,-1.0,1.0
consilier prezidențial,www.b1tv.ro,0,0,1,1,0.0,0.0
mercenar,www.b1tv.ro,0,1,0,1,-1.0,1.0
Aleș,www.comisarul.ro,0,1,0,1,-1.0,1.0
Cernit,www.comisarul.ro,0,1,0,1,-1.0,1.0
Maria Cernit,www.comisarul.ro,0,2,0,2,-1.0,1.0
Cristian Cîmpan,www.comisarul.ro,0,1,1,2,-0.5,0.5
Cristian Popa,www.comisarul.ro,0,2,1,3,-0.6666666666666666,0.6666666666666666
Cîmpan,www.comisarul.ro,0,1,0,1,-1.0,1.0
Fodoca,www.comisarul.ro,0,1,0,1,-1.0,1.0
Ghiță,www.comisarul.ro,0,2,0,2,-1.0,1.0
Liviu Iulian Fodoca,www.comisarul.ro,0,1,1,2,-0.5,0.5
Matei,www.comisarul.ro,0,0,1,1,0.0,0.0
Olt,www.comisarul.ro,0,0,1,1,0.0,0.0
Popa,www.comisarul.ro,0,1,2,3,-0.3333333333333333,0.3333333333333333
Robert Daniel Ghiță,www.comisarul.ro,0,0,2,2,0.0,0.0
Sergiu Lucian Matei,www.comisarul.ro,0,1,0,1,-1.0,1.0
Slatina,www.comisarul.ro,0,0,1,1,0.0,0.0
Teslui,www.comisarul.ro,0,0,1,1,0.0,0.0
acționar,www.comisarul.ro,0,1,1,2,-0.5,0.5
soț,www.comisarul.ro,0,4,5,9,-0.4444444444444444,0.4444444444444444
ă,www.comisarul.ro,0,0,1,1,0.0,0.0
Remus Stefureac,www.aktual24.ro,0,0,4,4,0.0,0.0
Stefureac,www.aktual24.ro,0,0,4,4,0.0,0.0
castigator,www.aktual24.ro,0,0,2,2,0.0,0.0
respondent,www.aktual24.ro,1,0,5,6,0.16666666666666666,0.16666666666666666
Adrian Câciu,www.comisarul.ro,0,0,5,5,0.0,0.0
Ciucă,www.comisarul.ro,0,2,2,4,-0.5,0.5
Câciu,www.comisarul.ro,0,2,2,4,-0.5,0.5
Constantinescu,www.mediafax.ro,0,0,1,1,0.0,0.0
Mazăre,www.mediafax.ro,0,0,1,1,0.0,0.0
Nicușor Constantinescu,www.mediafax.ro,0,0,1,1,0.0,0.0
Tăriceanu,www.mediafax.ro,0,11,3,14,-0.7857142857142857,0.7857142857142857
Covrig,recorder.ro,0,0,1,1,0.0,0.0
Ilie Covrig,recorder.ro,1,0,2,3,0.3333333333333333,0.3333333333333333
silvicultor,recorder.ro,0,2,1,3,-0.6666666666666666,0.6666666666666666
pădurar,recorder.ro,0,1,0,1,-1.0,1.0
credincios,www.realitatea.net,0,1,0,1,-1.0,1.0
localnic,www.realitatea.net,0,0,1,1,0.0,0.0
moderatoare,www.realitatea.net,0,1,1,2,-0.5,0.5
Mircea Abrudean,www.cotidianul.ro,0,0,3,3,0.0,0.0
Ninel Peia,www.cotidianul.ro,0,0,2,2,0.0,0.0
funcționar,www.cotidianul.ro,1,4,0,5,-0.6,0.6
medic,www.cotidianul.ro,1,1,0,2,0.0,0.0
Rafila,www.cotidianul.ro,0,1,0,1,-1.0,1.0
Administrația Trump,www.antena3.ro,0,0,1,1,0.0,0.0
Dragoș Sprînceană,www.antena3.ro,0,0,3,3,0.0,0.0
Florida,www.antena3.ro,0,0,4,4,0.0,0.0
Javier Milei,www.antena3.ro,0,0,1,1,0.0,0.0
Kimberly Guilfoyle,www.antena3.ro,0,0,1,1,0.0,0.0
Kristi Noem,www.antena3.ro,0,0,2,2,0.0,0.0
Mar,www.antena3.ro,0,0,3,3,0.0,0.0
Marea Britanie,www.antena3.ro,0,0,5,5,0.0,0.0
ambasador,www.antena3.ro,0,2,7,9,-0.2222222222222222,0.2222222222222222
conducător,www.antena3.ro,1,2,0,3,-0.3333333333333333,0.3333333333333333
diplomat,www.antena3.ro,0,0,3,3,0.0,0.0
Dragoș Sprânceană,www.antena3.ro,0,0,1,1,0.0,0.0
emisar,www.antena3.ro,0,1,3,4,-0.25,0.25
medic,www.antena3.ro,1,0,5,6,0.16666666666666666,0.16666666666666666
Dominic Fritz,www.news.ro,0,2,11,13,-0.15384615384615385,0.15384615384615385
președintă,www.news.ro,1,0,0,1,1.0,1.0
înlocuitor,adevarul.ro,0,3,1,4,-0.75,0.75
Cotroceni,www.comisarul.ro,0,1,5,6,-0.16666666666666666,0.16666666666666666
Cătălin Predoiu,www.comisarul.ro,0,1,5,6,-0.16666666666666666,0.16666666666666666
Kelemen Hunor,www.comisarul.ro,0,0,11,11,0.0,0.0
Agighiol,www.comisarul.ro,0,0,1,1,0.0,0.0
Alba Iulia,www.comisarul.ro,0,0,4,4,0.0,0.0
Assen,www.comisarul.ro,0,2,4,6,-0.3333333333333333,0.3333333333333333
Bacău,www.comisarul.ro,0,0,2,2,0.0,0.0
Brașov,www.comisarul.ro,0,0,4,4,0.0,0.0
Caspar Veldkamp,www.comisarul.ro,0,0,1,1,0.0,0.0
Co,www.comisarul.ro,0,0,1,1,0.0,0.0
Coțofenești,www.comisarul.ro,2,1,4,7,0.14285714285714285,0.14285714285714285
Dacia,www.comisarul.ro,0,0,1,1,0.0,0.0
Dacian Cioloș,www.comisarul.ro,0,1,3,4,-0.25,0.25
Emil Hurezeanu,www.comisarul.ro,0,0,2,2,0.0,0.0
Epureni,www.comisarul.ro,0,0,1,1,0.0,0.0
Lupu,www.comisarul.ro,0,0,1,1,0.0,0.0
Olanda,www.comisarul.ro,0,0,7,7,0.0,0.0
Ostrovul Mare,www.comisarul.ro,0,0,1,1,0.0,0.0
Peretu,www.comisarul.ro,0,0,1,1,0.0,0.0
Perșinari,www.comisarul.ro,0,0,1,1,0.0,0.0
Poiana Gorj,www.comisarul.ro,0,0,1,1,0.0,0.0
Regatul Țărilor de Jos,www.comisarul.ro,0,0,1,1,0.0,0.0
Răcătău,www.comisarul.ro,0,0,1,1,0.0,0.0
Sacoșul Mare,www.comisarul.ro,0,0,1,1,0.0,0.0
Sarmizegetusa,www.comisarul.ro,0,0,1,1,0.0,0.0
Sarmizegetusa Regia,www.comisarul.ro,1,0,1,2,0.5,0.5
Senereuș,www.comisarul.ro,0,0,1,1,0.0,0.0
Solonețu Nou,www.comisarul.ro,0,0,1,1,0.0,0.0
Stâncești,www.comisarul.ro,0,0,1,1,0.0,0.0
Suceava,www.comisarul.ro,0,0,5,5,0.0,0.0
Sâncrăieni,www.comisarul.ro,0,0,1,1,0.0,0.0
Sângeru de Pădure,www.comisarul.ro,0,0,1,1,0.0,0.0
Săcuieni,www.comisarul.ro,0,0,1,1,0.0,0.0
Sărmășag,www.comisarul.ro,0,0,1,1,0.0,0.0
arheolog,www.comisarul.ro,0,0,2,2,0.0,0.0
braconier,www.comisarul.ro,0,2,0,2,-1.0,1.0
celor,www.comisarul.ro,0,1,0,1,-1.0,1.0
Hurezeanu,www.comisarul.ro,0,0,1,1,0.0,0.0
făptuitor,www.comisarul.ro,0,1,0,1,-1.0,1.0
hoț,www.comisarul.ro,0,5,0,5,-1.0,1.0
inclus,www.comisarul.ro,0,0,1,1,0.0,0.0
omolog,www.comisarul.ro,0,2,1,3,-0.6666666666666666,0.6666666666666666
pat,www.comisarul.ro,0,0,1,1,0.0,0.0
Augustin Lazăr,www.comisarul.ro,0,1,0,1,-1.0,1.0
public,www.comisarul.ro,0,3,4,7,-0.42857142857142855,0.42857142857142855
tuturor,www.comisarul.ro,0,0,1,1,0.0,0.0
Țările de Jos,www.comisarul.ro,0,0,2,2,0.0,0.0
Raluca Turcan,stirileprotv.ro,0,1,4,5,-0.2,0.2
Turcan,stirileprotv.ro,0,1,0,1,-1.0,1.0
Vitalie Cojocari,stirileprotv.ro,0,1,0,1,-1.0,1.0
ea,stirileprotv.ro,1,1,0,2,0.0,0.0
șefă,stirileprotv.ro,0,2,3,5,-0.4,0.4
Bacău,adevarul.ro,0,3,6,9,-0.3333333333333333,0.3333333333333333
Dominic Fritz,adevarul.ro,0,1,12,13,-0.07692307692307693,0.07692307692307693
Stelian Ion,adevarul.ro,0,0,9,9,0.0,0.0
Diana Șoșoacă,www.cotidianul.ro,0,4,2,6,-0.6666666666666666,0.6666666666666666
Alexander Dobrindt,primanews.ro,0,0,2,2,0.0,0.0
Angela Merkel,primanews.ro,0,0,2,2,0.0,0.0
Austria,primanews.ro,0,0,3,3,0.0,0.0
Berlin,primanews.ro,0,0,2,2,0.0,0.0
Germania,primanews.ro,0,0,9,9,0.0,0.0
Merz,primanews.ro,0,1,3,4,-0.25,0.25
Polonia,primanews.ro,0,0,10,10,0.0,0.0
Olaf Scholz,primanews.ro,0,1,1,2,-0.5,0.5
critic,primanews.ro,0,3,0,3,-1.0,1.0
migrant,primanews.ro,0,4,0,4,-1.0,1.0
refugiat,primanews.ro,0,2,0,2,-1.0,1.0
solicitant,primanews.ro,0,1,0,1,-1.0,1.0
șefă,primanews.ro,0,1,0,1,-1.0,1.0
Hunor Kelemen,www.g4media.ro,0,0,2,2,0.0,0.0
János Lázár,www.g4media.ro,0,0,3,3,0.0,0.0
Kőszeg,www.g4media.ro,0,0,2,2,0.0,0.0
Péter Magyar,www.g4media.ro,0,2,0,2,-1.0,1.0
Semjén,www.g4media.ro,0,2,2,4,-0.5,0.5
Vas,www.g4media.ro,0,0,2,2,0.0,0.0
Veszprém,www.g4media.ro,0,0,2,2,0.0,0.0
vicepremier,www.g4media.ro,0,1,6,7,-0.14285714285714285,0.14285714285714285
Viktor Orbán,www.g4media.ro,0,5,0,5,-1.0,1.0
Zsolt Semjén,www.g4media.ro,0,0,2,2,0.0,0.0
Cristian Terheș,www.news.ro,0,0,2,2,0.0,0.0
respondent,www.news.ro,0,0,3,3,0.0,0.0
Abrudean,www.g4media.ro,0,0,1,1,0.0,0.0
Mircea Abrudean,www.g4media.ro,0,0,3,3,0.0,0.0
Nadia Cerva,www.g4media.ro,0,0,1,1,0.0,0.0
Petrișor Peiu,www.g4media.ro,0,1,6,7,-0.14285714285714285,0.14285714285714285
Simona Bucura-Oprescu,www.g4media.ro,0,1,1,2,-0.5,0.5
atar,www.g4media.ro,0,1,0,1,-1.0,1.0
Antonescu,www.news.ro,0,3,27,30,-0.1,0.1
partener,www.news.ro,3,2,6,11,0.09090909090909091,0.09090909090909091
senator,www.antena3.ro,0,2,5,7,-0.2857142857142857,0.2857142857142857
pensionar,www.antena3.ro,0,3,2,5,-0.6,0.6
absolvent,www.comisarul.ro,0,1,1,2,-0.5,0.5
Adrian Vintilă,www.comisarul.ro,0,0,1,1,0.0,0.0
Andrei Nicolae Popa,www.comisarul.ro,0,0,1,1,0.0,0.0
Babagianu,www.comisarul.ro,0,0,1,1,0.0,0.0
Burduja,www.comisarul.ro,0,1,0,1,-1.0,1.0
Burduja Mihai Adrian Vintilă,www.comisarul.ro,0,0,1,1,0.0,0.0
Nicolae Niculăiță,www.comisarul.ro,0,3,1,4,-0.75,0.75
Vintilă,www.comisarul.ro,0,1,1,2,-0.5,0.5
Dragoș Ștefan Roibu,www.comisarul.ro,0,1,0,1,-1.0,1.0
Dragoș Roibu,www.comisarul.ro,0,0,1,1,0.0,0.0
Gheorghe Babagianu,www.comisarul.ro,0,0,1,1,0.0,0.0
Marinel Burduja,www.comisarul.ro,0,0,1,1,0.0,0.0
Mihai Adrian Vintilă,www.comisarul.ro,0,0,1,1,0.0,0.0
Sebastian Burduja,www.comisarul.ro,0,6,8,14,-0.42857142857142855,0.42857142857142855
Mioara Mantale,www.comisarul.ro,0,0,1,1,0.0,0.0
Niculăiță,www.comisarul.ro,0,1,0,1,-1.0,1.0
Oana Babagianu,www.comisarul.ro,0,0,3,3,0.0,0.0
Roibu,www.comisarul.ro,0,1,0,1,-1.0,1.0
Silviu Văduva,www.comisarul.ro,0,2,0,2,-1.0,1.0
Virgil Popescu,www.comisarul.ro,0,0,1,1,0.0,0.0
Vitali Machitski,www.comisarul.ro,0,0,1,1,0.0,0.0
administrator,www.comisarul.ro,1,2,4,7,-0.14285714285714285,0.14285714285714285
director general,www.comisarul.ro,0,1,0,1,-1.0,1.0
Rareș Bogdan,www.comisarul.ro,0,0,4,4,0.0,0.0
masterand,www.comisarul.ro,0,0,1,1,0.0,0.0
Mihai Burduja,www.comisarul.ro,0,1,0,1,-1.0,1.0
Ramona Gabor,www.comisarul.ro,0,1,0,1,-1.0,1.0
oligarh,www.comisarul.ro,0,1,0,1,-1.0,1.0
prefect,www.comisarul.ro,0,2,3,5,-0.4,0.4
Florian Colceag,www.comisarul.ro,0,0,1,1,0.0,0.0
secretar,www.comisarul.ro,0,0,8,8,0.0,0.0
sinecuriști,www.comisarul.ro,0,1,0,1,-1.0,1.0
specialist,www.comisarul.ro,3,1,12,16,0.125,0.125
subprefect,www.comisarul.ro,0,1,0,1,-1.0,1.0
trezorier,www.comisarul.ro,0,0,1,1,0.0,0.0
Gigi Chiru,www.mediafax.ro,0,0,2,2,0.0,0.0
director,www.mediafax.ro,1,2,8,11,-0.09090909090909091,0.09090909090909091
Capitale,www.mediafax.ro,0,0,8,8,0.0,0.0
Clotilde Armand,www.mediafax.ro,0,1,0,1,-1.0,1.0
colegiu,www.mediafax.ro,0,1,2,3,-0.3333333333333333,0.3333333333333333
Dominic Fritz,www.mediafax.ro,0,0,7,7,0.0,0.0
Elena Lascon,www.mediafax.ro,0,1,0,1,-1.0,1.0
Ionuș Moșteanu,www.mediafax.ro,0,1,0,1,-1.0,1.0
Lasconi,www.mediafax.ro,0,3,10,13,-0.23076923076923078,0.23076923076923078
nimeni,www.mediafax.ro,0,1,0,1,-1.0,1.0
Timișoara,www.mediafax.ro,0,0,6,6,0.0,0.0
câștigător,www.mediafax.ro,0,1,0,1,-1.0,1.0
femeie,www.mediafax.ro,0,1,2,3,-0.3333333333333333,0.3333333333333333
independent,www.mediafax.ro,0,1,2,3,-0.3333333333333333,0.3333333333333333
loser,www.mediafax.ro,0,1,0,1,-1.0,1.0
tânăr,www.mediafax.ro,0,3,0,3,-1.0,1.0
Alexandru Cozadin,pressone.ro,0,0,4,4,0.0,0.0
Andreea Pavel,pressone.ro,0,0,4,4,0.0,0.0
Attila Biro,pressone.ro,0,0,4,4,0.0,0.0
Aurelian Popa,pressone.ro,0,0,1,1,0.0,0.0
Belgia,pressone.ro,0,0,8,8,0.0,0.0
Biana Oanea,pressone.ro,0,0,3,3,0.0,0.0
Bogdan,pressone.ro,0,0,1,1,0.0,0.0
Candid,pressone.ro,0,0,1,1,0.0,0.0
Claudiu Manda,pressone.ro,0,1,6,7,-0.14285714285714285,0.14285714285714285
Claudiu Târziu,pressone.ro,0,3,4,7,-0.42857142857142855,0.42857142857142855
Cosmina Ungureanu,pressone.ro,0,0,4,4,0.0,0.0
Craiovei,pressone.ro,0,0,4,4,0.0,0.0
Cristian Andrei Leonte,pressone.ro,0,0,6,6,0.0,0.0
Cristian Movilă,pressone.ro,0,0,4,4,0.0,0.0
Dan Diaconescu,pressone.ro,0,0,4,4,0.0,0.0
Dan Nica,pressone.ro,0,2,6,8,-0.25,0.25
Delia Dascălu,pressone.ro,0,0,5,5,0.0,0.0
Dîncu,pressone.ro,0,3,1,4,-0.75,0.75
Falcă,pressone.ro,0,4,1,5,-0.8,0.8
Florentin Pandele,pressone.ro,0,0,4,4,0.0,0.0
Gabriel Mateescu,pressone.ro,0,0,4,4,0.0,0.0
Gabriela Firea,pressone.ro,1,12,10,23,-0.4782608695652174,0.4782608695652174
George Călin,pressone.ro,0,2,9,11,-0.18181818181818182,0.18181818181818182
George Călin Popa,pressone.ro,0,1,0,1,-1.0,1.0
George Călin Șerban,pressone.ro,0,0,2,2,0.0,0.0
Gheorghe Falcă,pressone.ro,0,2,6,8,-0.25,0.25
Gherasim,pressone.ro,0,0,1,1,0.0,0.0
Gherasim Laura,pressone.ro,0,0,1,1,0.0,0.0
Grapini,pressone.ro,0,0,4,4,0.0,0.0
Hermann,pressone.ro,0,2,1,3,-0.6666666666666666,0.6666666666666666
Insulele Canare,pressone.ro,0,1,0,1,-1.0,1.0
Ioana Epure,pressone.ro,1,0,5,6,0.16666666666666666,0.16666666666666666
Iulia Stănoiu,pressone.ro,0,0,6,6,0.0,0.0
Laura Gherasim,pressone.ro,0,0,2,2,0.0,0.0
Laurei Gherasim,pressone.ro,1,0,0,1,1.0,1.0
Luis Lazarus,pressone.ro,0,0,2,2,0.0,0.0
Macedonia de Nord,pressone.ro,0,0,3,3,0.0,0.0
Manda,pressone.ro,0,1,1,2,-0.5,0.5
Marionela Toma,pressone.ro,0,0,6,6,0.0,0.0
Matthew Garvey,pressone.ro,0,0,4,4,0.0,0.0
Mihaela Tănase,pressone.ro,0,0,6,6,0.0,0.0
Mihail Sturdza,pressone.ro,0,0,2,2,0.0,0.0
Mircea Pătrașcu,pressone.ro,0,0,4,4,0.0,0.0
Oana Manițiu,pressone.ro,0,0,4,4,0.0,0.0
Petruț Iacob,pressone.ro,0,0,6,6,0.0,0.0
Popa,pressone.ro,1,5,2,8,-0.5,0.5
proprietar,pressone.ro,0,11,10,21,-0.5238095238095238,0.5238095238095238
Roșca Stănescu,pressone.ro,0,1,0,1,-1.0,1.0
Sabin Cirstoveanu,pressone.ro,0,1,4,5,-0.2,0.2
Soții Falcă,pressone.ro,0,1,1,2,-0.5,0.5
Toth,pressone.ro,0,0,1,1,0.0,0.0
Târgoviște,pressone.ro,0,0,4,4,0.0,0.0
Vlad Botoș,pressone.ro,0,0,1,1,0.0,0.0
Voiculescu,pressone.ro,1,3,0,4,-0.5,0.5
voluntar,pressone.ro,2,0,5,7,0.2857142857142857,0.2857142857142857
administrat,pressone.ro,0,1,0,1,-1.0,1.0
arbitru,pressone.ro,0,3,2,5,-0.6,0.6
asociat,pressone.ro,0,3,13,16,-0.1875,0.1875
baron,pressone.ro,0,14,1,15,-0.9333333333333333,0.9333333333333333
consul,pressone.ro,0,1,2,3,-0.3333333333333333,0.3333333333333333
copreședinte,pressone.ro,0,1,3,4,-0.25,0.25
cuplu,pressone.ro,0,1,0,1,-1.0,1.0
descendent,pressone.ro,0,0,1,1,0.0,0.0
didați,pressone.ro,0,0,1,1,0.0,0.0
familia Botoș,pressone.ro,0,1,0,1,-1.0,1.0
luencer,pressone.ro,0,1,0,1,-1.0,1.0
pictor,pressone.ro,0,0,5,5,0.0,0.0
primăriță,pressone.ro,0,5,0,5,-1.0,1.0
re,pressone.ro,0,0,1,1,0.0,0.0
Șerban Dimitrie Sturdza,pressone.ro,0,0,3,3,0.0,0.0
Șoșoacă,pressone.ro,0,12,2,14,-0.8571428571428571,0.8571428571428571
Ștefan Mușoiu,pressone.ro,0,0,2,2,0.0,0.0
Mirel Palada,www.mediafax.ro,0,2,1,3,-0.6666666666666666,0.6666666666666666
Goțiu,www.mediafax.ro,0,0,1,1,0.0,0.0
Mihai Goțiu,www.mediafax.ro,0,3,0,3,-1.0,1.0
Nadia Ciurlin,www.mediafax.ro,1,0,0,1,1.0,1.0
Orban,www.mediafax.ro,0,0,9,9,0.0,0.0
Palada,www.mediafax.ro,0,2,0,2,-1.0,1.0
Ploiești,www.mediafax.ro,0,0,2,2,0.0,0.0
Portocală,www.mediafax.ro,0,1,0,1,-1.0,1.0
Sebastian Ghiță,www.mediafax.ro,0,2,1,3,-0.6666666666666666,0.6666666666666666
amândoi,www.mediafax.ro,0,1,0,1,-1.0,1.0
avocat,www.mediafax.ro,0,0,3,3,0.0,0.0
Adrian Prisnel,www.mediafax.ro,0,1,0,1,-1.0,1.0
Domnul Palada,www.mediafax.ro,0,1,0,1,-1.0,1.0
er,www.mediafax.ro,0,1,0,1,-1.0,1.0
huligan,www.mediafax.ro,0,1,0,1,-1.0,1.0
Mihai Tăriceanu,www.mediafax.ro,0,1,0,1,-1.0,1.0
prieten,www.mediafax.ro,0,2,3,5,-0.4,0.4
Negulescu,www.mediafax.ro,0,1,0,1,-1.0,1.0
Bulgaria,www.b1tv.ro,0,0,2,2,0.0,0.0
Cătălin Predoiu,www.b1tv.ro,0,0,1,1,0.0,0.0
Predoiu,www.b1tv.ro,0,0,1,1,0.0,0.0
Cotroceni,observatornews.ro,0,0,4,4,0.0,0.0
Eduard Hellvig,observatornews.ro,2,0,2,4,0.5,0.5
extremist,observatornews.ro,0,1,0,1,-1.0,1.0
Londra,recorder.ro,0,0,2,2,0.0,0.0
Răzvan,recorder.ro,1,0,0,1,1.0,1.0
Vlad,recorder.ro,0,0,1,1,0.0,0.0
consultant,recorder.ro,0,1,4,5,-0.2,0.2
Radu Delicote,adevarul.ro,0,0,5,5,0.0,0.0
George Becali,www.romaniatv.net,0,1,1,2,-0.5,0.5
Mugur Mihăiescu,www.romaniatv.net,0,1,1,2,-0.5,0.5
Chelaru,www.romaniatv.net,0,1,0,1,-1.0,1.0
Bogdan Dinu,www.antena3.ro,0,1,0,1,-1.0,1.0
Eduard Hellvig,www.antena3.ro,0,0,3,3,0.0,0.0
Gabriel Vlase,www.antena3.ro,0,1,1,2,-0.5,0.5
Sebastian Burduja,www.antena3.ro,0,2,0,2,-1.0,1.0
angajat,www.antena3.ro,1,3,2,6,-0.3333333333333333,0.3333333333333333
director,www.antena3.ro,0,4,11,15,-0.26666666666666666,0.26666666666666666
gazdă,www.antena3.ro,0,2,0,2,-1.0,1.0
Călin Georgescu,www.mediafax.ro,1,3,3,7,-0.2857142857142857,0.2857142857142857
Stan,www.mediafax.ro,0,0,1,1,0.0,0.0
analist,www.mediafax.ro,0,1,2,3,-0.3333333333333333,0.3333333333333333
Adrian Streinu Cerce,recorder.ro,0,0,1,1,0.0,0.0
Adrian Streinu-Cercel,recorder.ro,0,0,1,1,0.0,0.0
Aleksandr Sol,recorder.ro,0,1,0,1,-1.0,1.0
Alexandru Kansou,recorder.ro,0,0,1,1,0.0,0.0
Alexandru Rafila,recorder.ro,0,0,2,2,0.0,0.0
Andrei Pleșu,recorder.ro,0,0,3,3,0.0,0.0
Antonel Tănase,recorder.ro,0,0,1,1,0.0,0.0
Barack Obama,recorder.ro,0,0,1,1,0.0,0.0
Belarus,recorder.ro,0,2,1,3,-0.6666666666666666,0.6666666666666666
Berlin,recorder.ro,0,0,2,2,0.0,0.0
Boris Pasternak,recorder.ro,0,0,1,1,0.0,0.0
Boualem Sansal,recorder.ro,1,0,0,1,1.0,1.0
Capitale,recorder.ro,0,1,2,3,-0.3333333333333333,0.3333333333333333
Carmen Mihălcescu,recorder.ro,0,0,1,1,0.0,0.0
Carol cel Mare,recorder.ro,1,0,0,1,1.0,1.0
Claudiu Năsui,recorder.ro,0,0,2,2,0.0,0.0
Constantin Noica,recorder.ro,1,0,0,1,1.0,1.0
Cosmin Popp,recorder.ro,0,0,1,1,0.0,0.0
Covasna,recorder.ro,0,2,4,6,-0.3333333333333333,0.3333333333333333
Cristian Băcanu,recorder.ro,0,0,1,1,0.0,0.0
Cristian Diaconescu,recorder.ro,0,0,1,1,0.0,0.0
Cristian Ghica,recorder.ro,0,0,1,1,0.0,0.0
Cristian Seidler,recorder.ro,0,0,2,2,0.0,0.0
Cristina Prună,recorder.ro,0,0,4,4,0.0,0.0
Cristina Trăilă,recorder.ro,0,0,1,1,0.0,0.0
Cătălin Teniță,recorder.ro,0,0,2,2,0.0,0.0
Dan Cristian Popescu,recorder.ro,0,0,1,1,0.0,0.0
Dan L. Longo,recorder.ro,0,0,1,1,0.0,0.0
Dan Tudorache,recorder.ro,0,1,1,2,-0.5,0.5
Daniel Florea,recorder.ro,0,0,1,1,0.0,0.0
Daniel Levitin,recorder.ro,0,0,1,1,0.0,0.0
Daniel Zamfir,recorder.ro,0,0,1,1,0.0,0.0
David Litt,recorder.ro,0,0,1,1,0.0,0.0
Deirdre McCloskey,recorder.ro,0,0,1,1,0.0,0.0
Delia Owens,recorder.ro,0,0,1,1,0.0,0.0
Diana Buzoianu,recorder.ro,0,0,1,1,0.0,0.0
Diana Tu,recorder.ro,0,0,1,1,0.0,0.0
Diana Tușa,recorder.ro,0,0,1,1,0.0,0.0
Dostoievski,recorder.ro,0,0,2,2,0.0,0.0
Dumnezeu,recorder.ro,5,2,4,11,0.2727272727272727,0.2727272727272727
Florin Cîțu,recorder.ro,0,3,7,10,-0.3,0.3
Gabriel Mutu,recorder.ro,0,0,2,2,0.0,0.0
Gad Saad,recorder.ro,0,0,1,1,0.0,0.0
George Akerlof,recorder.ro,0,0,1,1,0.0,0.0
Harrison,recorder.ro,0,0,1,1,0.0,0.0
Hillary Clinton,recorder.ro,0,0,2,2,0.0,0.0
Ilfov,recorder.ro,0,1,6,7,-0.14285714285714285,0.14285714285714285
Iuliana Neagu,recorder.ro,0,0,1,1,0.0,0.0
Jared Diamond,recorder.ro,0,0,1,1,0.0,0.0
John Yo,recorder.ro,0,0,1,1,0.0,0.0
Lucian Boia,recorder.ro,0,0,3,3,0.0,0.0
Margaret Thatcher,recorder.ro,0,0,1,1,0.0,0.0
Mario Vargas Llosa,recorder.ro,0,0,1,1,0.0,0.0
Mackenna,recorder.ro,0,0,1,1,0.0,0.0
Mihai Alexandru Badea,recorder.ro,0,0,1,1,0.0,0.0
Milan Kundera,recorder.ro,1,0,1,2,0.5,0.5
Monica Anisie,recorder.ro,0,0,1,1,0.0,0.0
Murray Rothbard,recorder.ro,0,0,1,1,0.0,0.0
Nick Bostrom,recorder.ro,0,0,1,1,0.0,0.0
Nicolae Bănicioiu,recorder.ro,0,1,2,3,-0.3333333333333333,0.3333333333333333
Nicoleta Goleac,recorder.ro,0,0,1,1,0.0,0.0
Oana Florea,recorder.ro,0,0,1,1,0.0,0.0
Oana Țoiu,recorder.ro,0,0,1,1,0.0,0.0
Occident,recorder.ro,0,1,1,2,-0.5,0.5
Octavian Paler,recorder.ro,0,0,2,2,0.0,0.0
pandemie,recorder.ro,0,7,0,7,-1.0,1.0
Paulo Coelho,recorder.ro,0,0,1,1,0.0,0.0
Pavel Popescu,recorder.ro,0,0,1,1,0.0,0.0
Peter Thiel,recorder.ro,1,0,0,1,1.0,1.0
Petre Florin Manole,recorder.ro,0,0,1,1,0.0,0.0
popul,recorder.ro,0,0,1,1,0.0,0.0
Robert J. Shiller,recorder.ro,0,0,1,1,0.0,0.0
Rodica Nassar,recorder.ro,0,0,1,1,0.0,0.0
Sebastian Burduja,recorder.ro,0,1,6,7,-0.14285714285714285,0.14285714285714285
Silvia Dinică,recorder.ro,0,0,1,1,0.0,0.0
Simona Spătaru,recorder.ro,0,0,2,2,0.0,0.0
Sorin Cîmpeanu,recorder.ro,0,0,1,1,0.0,0.0
Sorin Negruți,recorder.ro,0,0,1,1,0.0,0.0
Spiru Haret,recorder.ro,1,0,1,2,0.5,0.5
Valer Dorneanu,recorder.ro,0,0,1,1,0.0,0.0
Violeta Alexandru,recorder.ro,0,0,1,1,0.0,0.0
actor,recorder.ro,0,2,2,4,-0.5,0.5
ade,recorder.ro,0,0,1,1,0.0,0.0
analist,recorder.ro,0,0,3,3,0.0,0.0
asigurat,recorder.ro,0,0,1,1,0.0,0.0
asistent social,recorder.ro,0,1,0,1,-1.0,1.0
Bucureștean,recorder.ro,0,0,1,1,0.0,0.0
bucureștean,recorder.ro,0,0,2,2,0.0,0.0
co,recorder.ro,0,0,1,1,0.0,0.0
consilier parlamentar,recorder.ro,0,0,2,2,0.0,0.0
cursant,recorder.ro,0,0,2,2,0.0,0.0
diletant,recorder.ro,0,1,0,1,-1.0,1.0
diplomat,recorder.ro,0,0,4,4,0.0,0.0
Isărescu,recorder.ro,0,1,0,1,-1.0,1.0
fată,recorder.ro,1,5,5,11,-0.36363636363636365,0.36363636363636365
ging partner,recorder.ro,0,1,0,1,-1.0,1.0
magistrat,recorder.ro,1,8,2,11,-0.6363636363636364,0.6363636363636364
mamă,recorder.ro,9,7,6,22,0.09090909090909091,0.09090909090909091
mame,recorder.ro,1,0,2,3,0.3333333333333333,0.3333333333333333
matematician,recorder.ro,0,0,2,2,0.0,0.0
operator,recorder.ro,0,0,3,3,0.0,0.0
os,recorder.ro,0,0,1,1,0.0,0.0
planificator,recorder.ro,0,1,0,1,-1.0,1.0
polit,recorder.ro,0,1,0,1,-1.0,1.0
Călin Popescu-Tăriceanu,recorder.ro,0,1,0,1,-1.0,1.0
Preotul Dumitru Stăniloae,recorder.ro,1,0,0,1,1.0,1.0
preparator,recorder.ro,0,0,4,4,0.0,0.0
profesionist,recorder.ro,7,3,1,11,0.36363636363636365,0.36363636363636365
profesoară,recorder.ro,1,0,2,3,0.3333333333333333,0.3333333333333333
proprietar,recorder.ro,0,5,1,6,-0.8333333333333334,0.8333333333333334
psiholog,recorder.ro,2,0,6,8,0.25,0.25
rector,recorder.ro,0,0,5,5,0.0,0.0
referent,recorder.ro,0,0,6,6,0.0,0.0
traducător,recorder.ro,0,0,1,1,0.0,0.0
trainer,recorder.ro,1,0,3,4,0.25,0.25
trezorier,recorder.ro,0,1,0,1,-1.0,1.0
voluntar,recorder.ro,5,0,6,11,0.45454545454545453,0.45454545454545453
înger,recorder.ro,0,1,0,1,-1.0,1.0
Ștefan Pălărie,recorder.ro,0,0,1,1,0.0,0.0
Elena Liliana Popescu,recorder.ro,0,0,1,1,0.0,0.0
Robert Galbraith,recorder.ro,0,0,1,1,0.0,0.0
Andrzej Duda,www.luju.ro,0,0,1,1,0.0,0.0
Polonia,www.luju.ro,0,0,3,3,0.0,0.0
lider politic,www.luju.ro,0,1,0,1,-1.0,1.0
Cristian Popescu,www.mediafax.ro,0,1,0,1,-1.0,1.0
autor,www.luju.ro,0,6,1,7,-0.8571428571428571,0.8571428571428571
inițiator,www.luju.ro,0,2,0,2,-1.0,1.0
legiuitor,www.luju.ro,0,3,5,8,-0.375,0.375
urmaș,www.luju.ro,0,3,0,3,-1.0,1.0
aceastia,www.aktual24.ro,0,1,1,2,-0.5,0.5
Adrian Gluga,www.aktual24.ro,0,1,0,1,-1.0,1.0
caiac,www.aktual24.ro,0,1,0,1,-1.0,1.0
Cimino,www.aktual24.ro,0,0,1,1,0.0,0.0
Constantin Nicolescu,www.aktual24.ro,0,0,1,1,0.0,0.0
Craiovei,www.aktual24.ro,1,2,3,6,-0.16666666666666666,0.16666666666666666
Fane Vitamina,www.aktual24.ro,0,0,1,1,0.0,0.0
Fanel Trandafir,www.aktual24.ro,0,0,1,1,0.0,0.0
Gigel Rosianu,www.aktual24.ro,0,0,1,1,0.0,0.0
Gigi Vadik Zavera,www.aktual24.ro,0,0,1,1,0.0,0.0
Gigioc,www.aktual24.ro,0,0,1,1,0.0,0.0
Ilie Puscarie,www.aktual24.ro,0,0,1,1,0.0,0.0
Ion Ilie,www.aktual24.ro,0,0,1,1,0.0,0.0
Nicolescu,www.aktual24.ro,0,0,1,1,0.0,0.0
Rosianu,www.aktual24.ro,0,1,0,1,-1.0,1.0
Stefan Cantemir Mitre,www.aktual24.ro,0,0,1,1,0.0,0.0
acestia,www.aktual24.ro,1,7,8,16,-0.375,0.375
adjunct,www.aktual24.ro,0,1,2,3,-0.3333333333333333,0.3333333333333333
judecător,www.aktual24.ro,0,12,9,21,-0.5714285714285714,0.5714285714285714
locotenent,www.aktual24.ro,0,1,0,1,-1.0,1.0
mort,www.aktual24.ro,0,1,1,2,-0.5,0.5
ofiter,www.aktual24.ro,0,2,0,2,-1.0,1.0
personaj,www.aktual24.ro,0,4,0,4,-1.0,1.0
seful,www.aktual24.ro,0,5,0,5,-1.0,1.0
Mircea Diaconu,www.digi24.ro,0,1,0,1,-1.0,1.0
Radu Magdin,www.digi24.ro,0,0,1,1,0.0,0.0
Sorin Oprescu,www.digi24.ro,0,0,2,2,0.0,0.0
Theodor Stolojan,www.digi24.ro,0,0,3,3,0.0,0.0
Valeriu Turcan,www.digi24.ro,0,0,3,3,0.0,0.0
comentator,www.digi24.ro,0,1,0,1,-1.0,1.0
competitor,www.digi24.ro,0,1,0,1,-1.0,1.0
infractor,www.romaniatv.net,0,1,0,1,-1.0,1.0
Andrei Pleșu,www.digi24.ro,0,0,1,1,0.0,0.0
Daniel Barbu,www.digi24.ro,0,0,1,1,0.0,0.0
Elena Udrea,www.digi24.ro,0,3,1,4,-0.75,0.75
Pleșu,www.digi24.ro,0,0,1,1,0.0,0.0
Teodor Baconschi,www.digi24.ro,0,1,0,1,-1.0,1.0
doctorand,www.digi24.ro,0,0,1,1,0.0,0.0
filozof,www.digi24.ro,0,0,1,1,0.0,0.0
intelectual,www.digi24.ro,0,3,0,3,-1.0,1.0
scriitor,www.digi24.ro,0,0,2,2,0.0,0.0
Valeriu Tabără,primanews.ro,0,0,1,1,0.0,0.0
Lucian Romașcanu,www.g4media.ro,1,1,5,7,0.0,0.0
Romeo Lungu,www.g4media.ro,0,0,7,7,0.0,0.0
chestor,www.g4media.ro,0,1,1,2,-0.5,0.5
delegat,www.g4media.ro,0,2,4,6,-0.3333333333333333,0.3333333333333333
vicepreședinte,www.g4media.ro,0,3,25,28,-0.10714285714285714,0.10714285714285714
cetățean,www.romaniatv.net,20,6,24,50,0.28,0.28
consilier,www.realitatea.net,0,2,6,8,-0.25,0.25
Serbia,www.realitatea.net,0,1,3,4,-0.25,0.25
bărbat,www.realitatea.net,0,1,2,3,-0.3333333333333333,0.3333333333333333
Doina Pană,www.realitatea.net,0,0,1,1,0.0,0.0
domn,www.realitatea.net,0,2,1,3,-0.6666666666666666,0.6666666666666666
Niculescu,www.realitatea.net,0,1,1,2,-0.5,0.5
Budapesta,www.activenews.ro,0,2,3,5,-0.4,0.4
Victor Orbán,www.activenews.ro,0,1,0,1,-1.0,1.0
creator,www.activenews.ro,0,0,1,1,0.0,0.0
prieten,www.activenews.ro,2,7,4,13,-0.38461538461538464,0.38461538461538464
susținător,www.activenews.ro,0,5,4,9,-0.5555555555555556,0.5555555555555556
suveran,www.activenews.ro,0,3,1,4,-0.75,0.75
Adrian Câciu,adevarul.ro,0,0,3,3,0.0,0.0
Alexandru Rafila,adevarul.ro,0,0,1,1,0.0,0.0
Angel Tîlvăr,adevarul.ro,0,0,2,2,0.0,0.0
Bogdan Ivan,adevarul.ro,0,0,1,1,0.0,0.0
Cseke Atilla,adevarul.ro,0,0,1,1,0.0,0.0
Florin Barbu,adevarul.ro,0,0,1,1,0.0,0.0
Marcel Boloș,adevarul.ro,0,0,1,1,0.0,0.0
Sebastian Burduja,adevarul.ro,0,2,3,5,-0.4,0.4
Simona Bucura-Oprescu,adevarul.ro,0,0,1,1,0.0,0.0
Sorin Grindeanu,adevarul.ro,0,2,7,9,-0.2222222222222222,0.2222222222222222
Traian Băsescu,www.comisarul.ro,0,8,10,18,-0.4444444444444444,0.4444444444444444
ambasador,www.mediafax.ro,0,1,1,2,-0.5,0.5
Andrei Muraru,www.mediafax.ro,0,0,1,1,0.0,0.0
diplomat,www.mediafax.ro,0,1,1,2,-0.5,0.5
Muraru,www.mediafax.ro,0,0,1,1,0.0,0.0
Washington,www.mediafax.ro,0,0,1,1,0.0,0.0
AUR,www.gandul.ro,0,0,1,1,0.0,0.0
Cristescu,www.gandul.ro,0,1,0,1,-1.0,1.0
Dâmbovița,www.gandul.ro,0,1,1,2,-0.5,0.5
Florian Coldea,www.gandul.ro,0,0,3,3,0.0,0.0
Radu,www.gandul.ro,0,0,2,2,0.0,0.0
Radu Cristescu,www.gandul.ro,0,1,0,1,-1.0,1.0
Radu Popa,www.gandul.ro,0,1,1,2,-0.5,0.5
toți,www.gandul.ro,0,0,1,1,0.0,0.0
comesen,www.gandul.ro,0,0,1,1,0.0,0.0
familia Coldea,www.gandul.ro,0,0,1,1,0.0,0.0
ființă,www.gandul.ro,0,1,0,1,-1.0,1.0
fin,www.gandul.ro,0,2,0,2,-1.0,1.0
fost adjunct,www.gandul.ro,0,1,0,1,-1.0,1.0
naș,www.gandul.ro,0,1,1,2,-0.5,0.5
profesor,www.gandul.ro,2,2,5,9,0.0,0.0
Vasile Dâncu,www.gandul.ro,0,0,1,1,0.0,0.0
securist,www.gandul.ro,0,2,0,2,-1.0,1.0
Felix Stroe,agerpres.ro,1,0,1,2,0.5,0.5
Nona Jalbă,agerpres.ro,0,1,0,1,-1.0,1.0
Stroe,agerpres.ro,0,0,1,1,0.0,0.0
nerezident,www.cotidianul.ro,0,1,0,1,-1.0,1.0
transportator,www.cotidianul.ro,0,1,0,1,-1.0,1.0
Dan Nicușor Daniel,adevarul.ro,0,1,0,1,-1.0,1.0
primar general,adevarul.ro,0,4,2,6,-0.6666666666666666,0.6666666666666666
Primar General,adevarul.ro,0,1,0,1,-1.0,1.0
autor,adevarul.ro,1,3,3,7,-0.2857142857142857,0.2857142857142857
Nicușor Daniel Dan,adevarul.ro,0,1,0,1,-1.0,1.0
inspector,adevarul.ro,0,1,3,4,-0.25,0.25
Dragoș Sprînceană,adevarul.ro,0,4,5,9,-0.4444444444444444,0.4444444444444444
emisar,adevarul.ro,0,11,7,18,-0.6111111111111112,0.6111111111111112
om de afaceri,adevarul.ro,0,7,12,19,-0.3684210526315789,0.3684210526315789
ață,adevarul.ro,0,1,0,1,-1.0,1.0
delegat,adevarul.ro,1,4,6,11,-0.2727272727272727,0.2727272727272727
Chișinău,stirileprotv.ro,0,0,1,1,0.0,0.0
Dorin Recean,stirileprotv.ro,0,0,1,1,0.0,0.0
Maia Sandu,stirileprotv.ro,0,0,2,2,0.0,0.0
Moscova,stirileprotv.ro,0,4,2,6,-0.6666666666666666,0.6666666666666666
oficial,stirileprotv.ro,0,12,6,18,-0.6666666666666666,0.6666666666666666
Nicolae Ciucă,stirileprotv.ro,0,2,20,22,-0.09090909090909091,0.09090909090909091
Jakov Milatović,www.gandul.ro,0,0,1,1,0.0,0.0
Muntenegru,www.gandul.ro,0,0,2,2,0.0,0.0
stat,www.gandul.ro,0,0,1,1,0.0,0.0
Kelemen Hunor,www.cotidianul.ro,0,3,8,11,-0.2727272727272727,0.2727272727272727
specialist,www.cotidianul.ro,1,1,2,4,0.0,0.0
Funeriu,a1.ro,0,3,0,3,-1.0,1.0
pedelist,a1.ro,0,7,1,8,-0.875,0.875
Sorin Oprescu,a1.ro,0,0,1,1,0.0,0.0
rector,a1.ro,0,3,2,5,-0.6,0.6
Adrian Vestea Bolojan,www.aktual24.ro,0,0,1,1,0.0,0.0
Buda,www.aktual24.ro,0,0,2,2,0.0,0.0
Busoi,www.aktual24.ro,0,1,1,2,-0.5,0.5
Ciprian Ciucu,www.aktual24.ro,0,0,7,7,0.0,0.0
Dan Motreanu,www.aktual24.ro,0,0,1,1,0.0,0.0
Emil Boc,www.aktual24.ro,0,0,3,3,0.0,0.0
Falca,www.aktual24.ro,0,0,2,2,0.0,0.0
Flutur,www.aktual24.ro,0,0,2,2,0.0,0.0
Thuma,www.aktual24.ro,0,1,1,2,-0.5,0.5
Valeriu Iftime,www.aktual24.ro,0,0,2,2,0.0,0.0
SUA,www.digi24.ro,1,4,24,29,-0.10344827586206896,0.10344827586206896
Tate,www.digi24.ro,0,1,1,2,-0.5,0.5
Geoană,www.mediafax.ro,1,2,9,12,-0.08333333333333333,0.08333333333333333
Mircea Geoană,www.mediafax.ro,1,0,8,9,0.1111111111111111,0.1111111111111111
Alexandru,www.romaniatv.net,0,0,1,1,0.0,0.0
Baia Mare,www.romaniatv.net,0,1,1,2,-0.5,0.5
Constantin Tanase,www.romaniatv.net,0,0,1,1,0.0,0.0
Cosmin Iosub,www.romaniatv.net,0,0,1,1,0.0,0.0
Gelul Vișan,www.romaniatv.net,0,1,0,1,-1.0,1.0
Irindea Mirela Daniela,www.romaniatv.net,0,1,0,1,-1.0,1.0
Tănase,www.romaniatv.net,0,0,2,2,0.0,0.0
Lovin,www.romaniatv.net,0,0,1,1,0.0,0.0
Mircea Cirț,www.romaniatv.net,0,1,0,1,-1.0,1.0
Ramona Lovin,www.romaniatv.net,0,0,1,1,0.0,0.0
Silvestru Șoșoacă,www.romaniatv.net,0,1,0,1,-1.0,1.0
Silviu Mănăstire,www.romaniatv.net,0,0,3,3,0.0,0.0
Silviu Tanase,www.romaniatv.net,0,0,1,1,0.0,0.0
Silviu Tănase,www.romaniatv.net,0,0,2,2,0.0,0.0
Sorin Muncaciu,www.romaniatv.net,0,0,1,1,0.0,0.0
Vișan,www.romaniatv.net,0,1,0,1,-1.0,1.0
anchetator,www.romaniatv.net,0,1,0,1,-1.0,1.0
beneficiar,www.romaniatv.net,0,3,2,5,-0.6,0.6
donator,www.romaniatv.net,0,3,0,3,-1.0,1.0
europarlamentar,www.romaniatv.net,0,2,12,14,-0.14285714285714285,0.14285714285714285
Cirț,www.romaniatv.net,0,1,0,1,-1.0,1.0
partener,www.romaniatv.net,0,4,8,12,-0.3333333333333333,0.3333333333333333
personaj,www.romaniatv.net,0,5,1,6,-0.8333333333333334,0.8333333333333334
Constantin Tănase,www.romaniatv.net,0,1,0,1,-1.0,1.0
Mircea Snegur,www.romaniatv.net,0,0,1,1,0.0,0.0
Dimitrie Sturdza,www.romaniatv.net,0,0,1,1,0.0,0.0
soț,www.romaniatv.net,2,2,3,7,0.0,0.0
viceprimar,www.romaniatv.net,1,2,0,3,-0.3333333333333333,0.3333333333333333
zidar,www.romaniatv.net,0,1,0,1,-1.0,1.0
șefă,www.romaniatv.net,0,0,4,4,0.0,0.0
cioloș,www.mediafax.ro,1,0,3,4,0.25,0.25
prim-ministru,www.mediafax.ro,0,1,11,12,-0.08333333333333333,0.08333333333333333
Adrian Mureșan,pressone.ro,0,0,1,1,0.0,0.0
Avram,pressone.ro,0,1,0,1,-1.0,1.0
Carmen Grozavu,pressone.ro,0,0,2,2,0.0,0.0
Director,pressone.ro,0,1,0,1,-1.0,1.0
Ervin Molnar,pressone.ro,0,1,3,4,-0.25,0.25
Florina,pressone.ro,1,0,0,1,1.0,1.0
Florina Rus,pressone.ro,0,0,1,1,0.0,0.0
Grozavu,pressone.ro,0,1,0,1,-1.0,1.0
Ianculescu,pressone.ro,0,0,1,1,0.0,0.0
Leo Grozavu,pressone.ro,0,1,0,1,-1.0,1.0
Molnar,pressone.ro,0,0,1,1,0.0,0.0
Recorder,pressone.ro,0,1,1,2,-0.5,0.5
Rus,pressone.ro,0,3,0,3,-1.0,1.0
Valentin Avram,pressone.ro,0,4,1,5,-0.8,0.8
Zalău,pressone.ro,0,0,2,2,0.0,0.0
alist,pressone.ro,0,1,0,1,-1.0,1.0
casnică,pressone.ro,0,1,0,1,-1.0,1.0
Adrian Dohotaru,pressone.ro,0,1,0,1,-1.0,1.0
director general,pressone.ro,0,1,2,3,-0.3333333333333333,0.3333333333333333
Dohotaru,pressone.ro,0,0,1,1,0.0,0.0
Mihai Mureșan,pressone.ro,0,0,1,1,0.0,0.0
infractor,pressone.ro,0,11,1,12,-0.9166666666666666,0.9166666666666666
Ovidiu Ianculescu,pressone.ro,0,1,0,1,-1.0,1.0
inspectoare,pressone.ro,0,1,0,1,-1.0,1.0
nimănui,pressone.ro,0,1,1,2,-0.5,0.5
peneliști,pressone.ro,0,3,0,3,-1.0,1.0
politruc,pressone.ro,0,2,0,2,-1.0,1.0
prietenă,pressone.ro,2,3,1,6,-0.16666666666666666,0.16666666666666666
profesionist,pressone.ro,2,1,2,5,0.2,0.2
prost,pressone.ro,0,2,0,2,-1.0,1.0
subordonat,pressone.ro,0,2,0,2,-1.0,1.0
subsemnat,pressone.ro,0,1,1,2,-0.5,0.5
superior,pressone.ro,0,2,0,2,-1.0,1.0
tată,pressone.ro,2,8,17,27,-0.2222222222222222,0.2222222222222222
Danu,www.digi24.ro,0,1,0,1,-1.0,1.0
primar general,www.digi24.ro,0,1,0,1,-1.0,1.0
Simion,www.digi24.ro,0,12,6,18,-0.6666666666666666,0.6666666666666666
bucureștean,www.digi24.ro,0,0,1,1,0.0,0.0
finală,www.digi24.ro,0,1,0,1,-1.0,1.0
prefect,www.digi24.ro,0,1,1,2,-0.5,0.5
speculator,www.digi24.ro,0,1,0,1,-1.0,1.0
Florin Cîțu,www.b1tv.ro,1,0,3,4,0.25,0.25
Cătălin Predoiu,www.romaniatv.net,0,0,16,16,0.0,0.0
Predoiu,www.romaniatv.net,0,4,4,8,-0.5,0.5
Varujan Pambuccian,www.romaniatv.net,0,0,1,1,0.0,0.0
lume,www.romaniatv.net,0,2,1,3,-0.6666666666666666,0.6666666666666666
funcționar,adevarul.ro,1,2,2,5,-0.2,0.2
Alfred Simonis,www.gandul.ro,0,0,1,1,0.0,0.0
Simonis,www.gandul.ro,0,0,1,1,0.0,0.0
Boc,stirileprotv.ro,0,4,1,5,-0.8,0.8
Gabriel Oprea,stirileprotv.ro,0,1,0,1,-1.0,1.0
Marian Sarbu,stirileprotv.ro,0,0,1,1,0.0,0.0
Silviu Prigoana,stirileprotv.ro,0,0,2,2,0.0,0.0
indrag,stirileprotv.ro,0,1,0,1,-1.0,1.0
trădător,stirileprotv.ro,0,3,0,3,-1.0,1.0
Belarus,www.digi24.ro,0,0,1,1,0.0,0.0
Federația Rusă,www.digi24.ro,1,4,1,6,-0.5,0.5
Matei Păun,www.digi24.ro,0,1,1,2,-0.5,0.5
bancher,www.digi24.ro,0,1,0,1,-1.0,1.0
Simonis,stirileprotv.ro,0,0,1,1,0.0,0.0
Adam Kay,recorder.ro,0,0,1,1,0.0,0.0
Alexandru Șerban,recorder.ro,0,0,1,1,0.0,0.0
Aurel Nechita,recorder.ro,0,0,1,1,0.0,0.0
Bogdan Rodeanu,recorder.ro,0,0,1,1,0.0,0.0
Brăila,recorder.ro,0,0,5,5,0.0,0.0
Constantin Brâncoveanu,recorder.ro,0,0,1,1,0.0,0.0
Cristian Dima,recorder.ro,0,0,1,1,0.0,0.0
John Perkins,recorder.ro,0,0,1,1,0.0,0.0
Laurențiu Viorel Gîdei,recorder.ro,0,0,1,1,0.0,0.0
Marius Mărgărit,recorder.ro,0,0,1,1,0.0,0.0
Ray Bradbury,recorder.ro,0,0,1,1,0.0,0.0
Târgu Bujor,recorder.ro,0,0,1,1,0.0,0.0
Viorica Sandu,recorder.ro,0,0,1,1,0.0,0.0
contributor,recorder.ro,2,0,0,2,1.0,1.0
de Jos,recorder.ro,0,0,1,1,0.0,0.0
depanator,recorder.ro,0,1,0,1,-1.0,1.0
grafician,recorder.ro,0,0,1,1,0.0,0.0
gălățean,recorder.ro,0,1,0,1,-1.0,1.0
ucenic,recorder.ro,0,0,1,1,0.0,0.0
șefă,recorder.ro,0,4,7,11,-0.36363636363636365,0.36363636363636365
Călin Georgesu,www.romaniatv.net,0,0,1,1,0.0,0.0
Hristos,www.romaniatv.net,2,0,0,2,1.0,1.0
acesta,www.romaniatv.net,0,1,2,3,-0.3333333333333333,0.3333333333333333
martir,www.romaniatv.net,2,0,0,2,1.0,1.0
popor,www.romaniatv.net,4,7,1,12,-0.25,0.25
părinte,www.romaniatv.net,6,0,5,11,0.5454545454545454,0.5454545454545454
sfânt,www.romaniatv.net,2,0,0,2,1.0,1.0
străbun,www.romaniatv.net,2,0,0,2,1.0,1.0
Adrian Năstase,pressone.ro,1,0,17,18,0.05555555555555555,0.05555555555555555
Alba,pressone.ro,0,1,9,10,-0.1,0.1
Andrei Baciu,pressone.ro,0,1,0,1,-1.0,1.0
Aurelian Pavelescu,pressone.ro,0,2,0,2,-1.0,1.0
Cristian Terheș,pressone.ro,0,1,4,5,-0.2,0.2
Cătălina Păun,pressone.ro,0,0,1,1,0.0,0.0
Dan Marin Ștefănel,pressone.ro,0,0,1,1,0.0,0.0
Dan Motreanu,pressone.ro,0,2,2,4,-0.5,0.5
Dumitru Sosoaca,pressone.ro,0,1,0,1,-1.0,1.0
Dumitru Silvestru Șoșoacă,pressone.ro,0,1,0,1,-1.0,1.0
Dumitru Șoșoacă,pressone.ro,0,1,0,1,-1.0,1.0
Dâmbovița,pressone.ro,0,3,3,6,-0.5,0.5
editor,pressone.ro,2,0,3,5,0.4,0.4
eurocandidat,pressone.ro,0,2,2,4,-0.5,0.5
George Motreanu,pressone.ro,0,0,1,1,0.0,0.0
Gheorghe,pressone.ro,0,0,1,1,0.0,0.0
Ilona Andrei,pressone.ro,0,0,2,2,0.0,0.0
Ioana Mihăilă,pressone.ro,0,1,1,2,-0.5,0.5
jurnalistă,pressone.ro,0,1,0,1,-1.0,1.0
Lucia Goracci,pressone.ro,0,1,0,1,-1.0,1.0
Mihaela Bobar,pressone.ro,0,1,0,1,-1.0,1.0
Mihaela Nica,pressone.ro,0,0,2,2,0.0,0.0
Mircea Hava,pressone.ro,0,2,3,5,-0.4,0.4
Mălina Gîndu,pressone.ro,0,0,4,4,0.0,0.0
Nica,pressone.ro,0,2,1,3,-0.6666666666666666,0.6666666666666666
Octav Ganea Șoșoacă,pressone.ro,0,1,0,1,-1.0,1.0
Pucioasa,pressone.ro,0,1,0,1,-1.0,1.0
Răchiteni,pressone.ro,0,1,0,1,-1.0,1.0
Silvestru,pressone.ro,0,1,0,1,-1.0,1.0
Silvestru Șoșoacă,pressone.ro,0,1,1,2,-0.5,0.5
Terheș,pressone.ro,0,3,1,4,-0.75,0.75
Thomas Lundin,pressone.ro,0,0,1,1,0.0,0.0
Vlad Voiculescu,pressone.ro,1,0,5,6,0.16666666666666666,0.16666666666666666
agresor,pressone.ro,0,4,0,4,-1.0,1.0
lector,pressone.ro,0,0,7,7,0.0,0.0
manager,pressone.ro,0,6,13,19,-0.3157894736842105,0.3157894736842105
miniștri,pressone.ro,0,23,8,31,-0.7419354838709677,0.7419354838709677
mort,pressone.ro,0,5,3,8,-0.625,0.625
preot,pressone.ro,0,4,2,6,-0.6666666666666666,0.6666666666666666
rezident,pressone.ro,0,0,2,2,0.0,0.0
senatoare,pressone.ro,0,2,4,6,-0.3333333333333333,0.3333333333333333
șofer,pressone.ro,0,11,5,16,-0.6875,0.6875
Ținut Secuiesc,pressone.ro,0,0,2,2,0.0,0.0
Ciprian Ciucu,stirileprotv.ro,0,0,2,2,0.0,0.0
Cristian Ghinea,stirileprotv.ro,0,0,2,2,0.0,0.0
Daniel Suciu,stirileprotv.ro,0,0,2,2,0.0,0.0
Nicușor Dan,stirileprotv.ro,2,2,14,18,0.0,0.0
semnatar,stirileprotv.ro,0,0,1,1,0.0,0.0
Timișoara,stirileprotv.ro,0,0,4,4,0.0,0.0
activist,stirileprotv.ro,0,1,1,2,-0.5,0.5
edil,stirileprotv.ro,0,3,2,5,-0.6,0.6
primar general,stirileprotv.ro,0,2,2,4,-0.5,0.5
Gorghiu,observatornews.ro,0,1,0,1,-1.0,1.0
copreședinte,observatornews.ro,0,1,2,3,-0.3333333333333333,0.3333333333333333
manifestanț,observatornews.ro,0,1,0,1,-1.0,1.0
Alfred Simonis,www.news.ro,0,1,3,4,-0.25,0.25
Buzău,www.news.ro,0,0,1,1,0.0,0.0
Ciolacu,www.news.ro,1,16,21,38,-0.39473684210526316,0.39473684210526316
India,www.news.ro,0,1,0,1,-1.0,1.0
Kelemen Hunor,www.news.ro,0,0,11,11,0.0,0.0
Klaus Iohannis,www.news.ro,0,16,20,36,-0.4444444444444444,0.4444444444444444
Pakistan,www.news.ro,0,1,0,1,-1.0,1.0
acolit,www.news.ro,0,1,0,1,-1.0,1.0
afacerist,www.news.ro,0,2,0,2,-1.0,1.0
aliaț,www.news.ro,0,2,1,3,-0.6666666666666666,0.6666666666666666
antreprenor,www.news.ro,2,1,2,5,0.2,0.2
guvernator,www.news.ro,0,2,0,2,-1.0,1.0
inculpat,www.news.ro,0,2,0,2,-1.0,1.0
inițiator,www.news.ro,0,1,0,1,-1.0,1.0
miniștri,www.news.ro,0,6,1,7,-0.8571428571428571,0.8571428571428571
or,www.news.ro,0,0,1,1,0.0,0.0
parlamentar,www.news.ro,0,12,7,19,-0.631578947368421,0.631578947368421
pensionar,www.news.ro,1,2,2,5,-0.2,0.2
personal,www.news.ro,1,2,2,5,-0.2,0.2
popor,www.news.ro,4,6,1,11,-0.18181818181818182,0.18181818181818182
salariat,www.news.ro,0,1,0,1,-1.0,1.0
salariaț,www.news.ro,0,1,0,1,-1.0,1.0
senior,www.news.ro,0,2,0,2,-1.0,1.0
însoțitor,www.news.ro,0,1,0,1,-1.0,1.0
Remus Pricopie,adevarul.ro,0,1,11,12,-0.08333333333333333,0.08333333333333333
Ionel Bogdan,www.digi24.ro,1,0,2,3,0.3333333333333333,0.3333333333333333
Vladimir Iacob,www.digi24.ro,1,0,0,1,1.0,1.0
Bacău,www.news.ro,0,0,4,4,0.0,0.0
contracandidat,www.news.ro,0,3,1,4,-0.75,0.75
premiu,www.news.ro,0,0,2,2,0.0,0.0
Toni Greblă,adevarul.ro,0,3,11,14,-0.21428571428571427,0.21428571428571427
Bodog,pressone.ro,0,3,1,4,-0.75,0.75
Buicu,pressone.ro,0,0,1,1,0.0,0.0
Corneliu Buicu,pressone.ro,0,0,2,2,0.0,0.0
Diana Loreta Păun,pressone.ro,0,0,2,2,0.0,0.0
Diana Păun,pressone.ro,0,0,1,1,0.0,0.0
Florian Bodog,pressone.ro,0,2,5,7,-0.2857142857142857,0.2857142857142857
Grindeanu,pressone.ro,0,13,5,18,-0.7222222222222222,0.7222222222222222
László Attila,pressone.ro,0,0,1,1,0.0,0.0
prim-ministru,pressone.ro,0,5,7,12,-0.4166666666666667,0.4166666666666667
Viena,pressone.ro,0,0,3,3,0.0,0.0
distribuitor,pressone.ro,0,1,0,1,-1.0,1.0
lor,pressone.ro,0,3,2,5,-0.6,0.6
Australia,www.euronews.ro,0,0,2,2,0.0,0.0
Celeb,www.euronews.ro,0,0,1,1,0.0,0.0
Jeff Bezos,www.euronews.ro,0,0,1,1,0.0,0.0
Katy Perry,www.euronews.ro,0,0,1,1,0.0,0.0
Lauren Sánchez,www.euronews.ro,0,0,1,1,0.0,0.0
Noua Zeelandă,www.euronews.ro,0,0,4,4,0.0,0.0
oficial,www.euronews.ro,0,17,6,23,-0.7391304347826086,0.7391304347826086
cercetător,www.euronews.ro,0,0,1,1,0.0,0.0
femeie,www.euronews.ro,1,1,6,8,0.0,0.0
necunoscut,www.euronews.ro,0,1,0,1,-1.0,1.0
pasager,www.euronews.ro,0,1,0,1,-1.0,1.0
Craiovei,www.romaniatv.net,0,0,1,1,0.0,0.0
Daniel David,www.romaniatv.net,0,0,7,7,0.0,0.0
Lia Olguța Vasilescu,www.romaniatv.net,0,0,4,4,0.0,0.0
Lia Roberts,adevarul.ro,0,0,1,1,0.0,0.0
Moldova,adevarul.ro,0,3,5,8,-0.375,0.375
Corneliu Tudor,www.romaniatv.net,0,1,0,1,-1.0,1.0
director,www.romaniatv.net,0,3,9,12,-0.25,0.25
Emil Constantinescu,www.romaniatv.net,0,0,5,5,0.0,0.0
Gheorghe Hagi,www.romaniatv.net,0,0,1,1,0.0,0.0
Gică Popescu,www.romaniatv.net,0,0,1,1,0.0,0.0
Ion Iliescu,www.romaniatv.net,1,1,6,8,0.0,0.0
Ion Rațiu,www.romaniatv.net,0,0,1,1,0.0,0.0
Istanbul,www.romaniatv.net,0,0,1,1,0.0,0.0
Mircea Geoană,www.romaniatv.net,0,1,9,10,-0.1,0.1
Mirel Palada,www.romaniatv.net,1,0,7,8,0.125,0.125
Palada,www.romaniatv.net,0,1,1,2,-0.5,0.5
Radu Câmpeanu,www.romaniatv.net,0,1,0,1,-1.0,1.0
Regele,www.romaniatv.net,0,0,1,1,0.0,0.0
Viorica Dăncilă,www.romaniatv.net,0,0,1,1,0.0,0.0
E,a1.ro,0,1,0,1,-1.0,1.0
Elena Udrea,a1.ro,1,12,2,15,-0.7333333333333333,0.7333333333333333
hocheist,a1.ro,0,2,0,2,-1.0,1.0
Mircea Badea,a1.ro,0,3,3,6,-0.5,0.5
Tihamar Begze,a1.ro,0,1,0,1,-1.0,1.0
Tinut Secuiesc,a1.ro,0,1,1,2,-0.5,0.5
Ungaria,a1.ro,0,1,2,3,-0.3333333333333333,0.3333333333333333
Ungarie,a1.ro,0,1,0,1,-1.0,1.0
Vedeta,a1.ro,0,1,0,1,-1.0,1.0
lacheu,a1.ro,0,1,0,1,-1.0,1.0
sclav,a1.ro,0,1,0,1,-1.0,1.0
slugă,a1.ro,0,2,0,2,-1.0,1.0
vedetă,a1.ro,0,1,0,1,-1.0,1.0
fetiță,www.g4media.ro,0,1,2,3,-0.3333333333333333,0.3333333333333333
Ion M Ioniță,adevarul.ro,0,0,1,1,0.0,0.0
Ion M. Ioniță,adevarul.ro,0,1,4,5,-0.2,0.2
Ionaș-Vladimir,adevarul.ro,0,0,2,2,0.0,0.0
Ioniță,adevarul.ro,0,1,1,2,-0.5,0.5
Sebastian Pricop,adevarul.ro,0,0,2,2,0.0,0.0
sociolog,adevarul.ro,2,4,27,33,-0.06060606060606061,0.06060606060606061
Remus Ștefureac,adevarul.ro,0,0,6,6,0.0,0.0
elector,adevarul.ro,0,0,2,2,0.0,0.0
redactor șef,adevarul.ro,0,0,3,3,0.0,0.0
Ancăi Alexandrescu,www.romaniatv.net,0,0,1,1,0.0,0.0
Horațiu Potra,www.romaniatv.net,0,2,0,2,-1.0,1.0
Oprea,www.romaniatv.net,0,1,0,1,-1.0,1.0
Sinaia,www.romaniatv.net,0,0,2,2,0.0,0.0
Vlad Oprea,www.romaniatv.net,0,1,0,1,-1.0,1.0
domn,www.romaniatv.net,0,1,2,3,-0.3333333333333333,0.3333333333333333
mercenar,www.romaniatv.net,0,3,0,3,-1.0,1.0
Călin Georgescu,www.gandul.ro,2,7,12,21,-0.23809523809523808,0.23809523809523808
Georgescu,www.gandul.ro,0,5,5,10,-0.5,0.5
anchetator,www.gandul.ro,0,0,1,1,0.0,0.0
Adrian Zăbavă,adevarul.ro,0,1,4,5,-0.2,0.2
Dan,adevarul.ro,0,0,3,3,0.0,0.0
Cristian Părvulescu,adevarul.ro,0,0,2,2,0.0,0.0
analist politic,adevarul.ro,0,1,5,6,-0.16666666666666666,0.16666666666666666
Anamaria Gavrilă,snoop.ro,0,0,1,1,0.0,0.0
Ciprian Paul Pintea,snoop.ro,0,0,1,1,0.0,0.0
Ciprian Pintea,snoop.ro,0,1,0,1,-1.0,1.0
Cristian Andrei,snoop.ro,0,0,2,2,0.0,0.0
Cristian Popa,snoop.ro,0,0,2,2,0.0,0.0
Paul Pintea,snoop.ro,0,1,1,2,-0.5,0.5
Pintea,snoop.ro,0,0,3,3,0.0,0.0
Paul Ciprian Pintea,snoop.ro,0,0,1,1,0.0,0.0
Sabin Cîrstoveanu,snoop.ro,0,0,1,1,0.0,0.0
Sn,snoop.ro,0,0,3,3,0.0,0.0
Snoo,snoop.ro,0,0,1,1,0.0,0.0
Zalău,snoop.ro,0,0,1,1,0.0,0.0
elev,snoop.ro,0,4,11,15,-0.26666666666666666,0.26666666666666666
rar,snoop.ro,0,0,1,1,0.0,0.0
sursă,snoop.ro,0,0,2,2,0.0,0.0
tor,snoop.ro,0,2,0,2,-1.0,1.0
Alunița Voiculescu,snoop.ro,0,0,1,1,0.0,0.0
Branza,a1.ro,0,1,0,1,-1.0,1.0
Cipru,a1.ro,0,0,1,1,0.0,0.0
Portugalia,a1.ro,0,0,2,2,0.0,0.0
Spania,a1.ro,0,0,2,2,0.0,0.0
Venetia,a1.ro,0,0,1,1,0.0,0.0
Attila Verestoy,a1.ro,0,1,0,1,-1.0,1.0
William Branza,a1.ro,0,1,0,1,-1.0,1.0
dvs,a1.ro,0,1,0,1,-1.0,1.0
marinar,a1.ro,0,0,1,1,0.0,0.0
Covasna,agerpres.ro,0,0,1,1,0.0,0.0
Oana Mălina Negrea,agerpres.ro,0,0,2,2,0.0,0.0
Tamas Sandor,agerpres.ro,0,0,1,1,0.0,0.0
Tamás Sándor,agerpres.ro,0,0,1,1,0.0,0.0
electorat,agerpres.ro,0,1,5,6,-0.16666666666666666,0.16666666666666666
tânăr,agerpres.ro,7,2,1,10,0.5,0.5
turișt,agerpres.ro,0,1,0,1,-1.0,1.0
votant,agerpres.ro,1,2,1,4,-0.25,0.25
Ariton,a1.ro,1,0,1,2,0.5,0.5
Daniel Funeriu,a1.ro,0,2,6,8,-0.25,0.25
Ion Ariton,a1.ro,0,0,2,2,0.0,0.0
Lucian Bode,a1.ro,0,0,1,1,0.0,0.0
Mihai Razvan Ungureanu,a1.ro,0,0,4,4,0.0,0.0
Sibiu,a1.ro,0,0,4,4,0.0,0.0
Ungureanu,a1.ro,0,1,5,6,-0.16666666666666666,0.16666666666666666
amandă,a1.ro,0,0,1,1,0.0,0.0
Cyrus de la Rubia,www.digi24.ro,0,1,0,1,-1.0,1.0
Michel Barnier,www.digi24.ro,0,0,1,1,0.0,0.0
analișt,www.digi24.ro,0,0,1,1,0.0,0.0
economist,www.digi24.ro,0,1,0,1,-1.0,1.0
olac,www.digi24.ro,0,1,0,1,-1.0,1.0
Moșteanu,observatornews.ro,0,0,3,3,0.0,0.0
purtător de cuvânt,observatornews.ro,0,0,7,7,0.0,0.0
Anamaria Gavrila,www.realitatea.net,0,0,3,3,0.0,0.0
Capiatală,www.realitatea.net,0,0,1,1,0.0,0.0
capitală,www.realitatea.net,0,2,5,7,-0.2857142857142857,0.2857142857142857
Mateusz Morawiecki,www.realitatea.net,0,0,2,2,0.0,0.0
expert,www.realitatea.net,0,0,2,2,0.0,0.0
reprezentant,www.realitatea.net,0,1,7,8,-0.125,0.125
Cri Antonescu,www.aktual24.ro,0,1,0,1,-1.0,1.0
public,adevarul.ro,1,11,8,20,-0.5,0.5
utilizator,adevarul.ro,2,3,3,8,-0.125,0.125
Bratieni,www.aktual24.ro,0,1,0,1,-1.0,1.0
China,www.aktual24.ro,0,2,0,2,-1.0,1.0
Cotroceni,www.aktual24.ro,0,1,0,1,-1.0,1.0
Crin,www.aktual24.ro,1,2,0,3,-0.3333333333333333,0.3333333333333333
Cristi Borcea,www.aktual24.ro,0,1,0,1,-1.0,1.0
Hi,www.aktual24.ro,0,1,0,1,-1.0,1.0
Mesia,www.aktual24.ro,0,1,0,1,-1.0,1.0
Sfântul Crin,www.aktual24.ro,0,1,0,1,-1.0,1.0
Somnorila,www.aktual24.ro,0,1,0,1,-1.0,1.0
TikTok,www.aktual24.ro,0,1,0,1,-1.0,1.0
alora,www.aktual24.ro,0,1,0,1,-1.0,1.0
chiulangiu,www.aktual24.ro,0,1,0,1,-1.0,1.0
consoartă,www.aktual24.ro,0,1,0,1,-1.0,1.0
far,www.aktual24.ro,0,1,0,1,-1.0,1.0
fratior,www.aktual24.ro,0,1,0,1,-1.0,1.0
nevastă,www.aktual24.ro,0,1,1,2,-0.5,0.5
reformist,www.aktual24.ro,0,3,0,3,-1.0,1.0
tatăl,www.aktual24.ro,0,2,0,2,-1.0,1.0
zombie,www.aktual24.ro,0,1,0,1,-1.0,1.0
Andi Manciu,www.activenews.ro,0,1,0,1,-1.0,1.0
Boros Orsolya Eva,www.activenews.ro,0,0,1,1,0.0,0.0
Daniela Bârsan,www.activenews.ro,0,1,0,1,-1.0,1.0
Dorina Rusu,www.activenews.ro,0,0,1,1,0.0,0.0
Georgică Severin,www.activenews.ro,0,0,1,1,0.0,0.0
Ionel Paler,www.activenews.ro,0,0,1,1,0.0,0.0
Lucian Dindirică,www.activenews.ro,0,0,1,1,0.0,0.0
Mircea Toma,www.activenews.ro,0,0,1,1,0.0,0.0
Oana Simona Dincă,www.activenews.ro,0,0,1,1,0.0,0.0
Vasile Bănescu,www.activenews.ro,0,5,0,5,-1.0,1.0
Valentin Jucan,www.activenews.ro,0,1,1,2,-0.5,0.5
antă,www.activenews.ro,0,1,0,1,-1.0,1.0
fondator,www.activenews.ro,0,0,2,2,0.0,0.0
pretendent,www.activenews.ro,0,1,0,1,-1.0,1.0
prim,www.activenews.ro,0,0,1,1,0.0,0.0
profesor doctor,www.activenews.ro,0,0,1,1,0.0,0.0
secretar,www.activenews.ro,0,2,5,7,-0.2857142857142857,0.2857142857142857
soție,www.activenews.ro,0,3,4,7,-0.42857142857142855,0.42857142857142855
tovarăș,www.activenews.ro,0,2,0,2,-1.0,1.0
urmaș,www.activenews.ro,0,3,0,3,-1.0,1.0
ziarist,www.activenews.ro,0,3,2,5,-0.6,0.6
Ana Maria Bărbosu,www.gandul.ro,0,0,1,1,0.0,0.0
Brazilia,www.gandul.ro,0,0,1,1,0.0,0.0
Buzău,www.gandul.ro,0,0,5,5,0.0,0.0
Camelia Voinea,www.gandul.ro,0,0,1,1,0.0,0.0
David Popovici,www.gandul.ro,0,0,1,1,0.0,0.0
Izvorani,www.gandul.ro,0,0,1,1,0.0,0.0
Japonia,www.gandul.ro,1,0,3,4,0.25,0.25
Jordan Chiles,www.gandul.ro,0,0,1,1,0.0,0.0
Olanda,www.gandul.ro,0,0,2,2,0.0,0.0
Rina Kishi,www.gandul.ro,0,0,1,1,0.0,0.0
Sabrina Maneca Voinea,www.gandul.ro,0,0,2,2,0.0,0.0
Simone Biles,www.gandul.ro,0,0,1,1,0.0,0.0
antrenor,www.gandul.ro,0,1,2,3,-0.3333333333333333,0.3333333333333333
doamna Lipă,www.gandul.ro,0,1,0,1,-1.0,1.0
Covaliu,www.gandul.ro,0,0,1,1,0.0,0.0
gimnast,www.gandul.ro,0,0,1,1,0.0,0.0
Rebeca Andrade,www.gandul.ro,1,0,0,1,1.0,1.0
specialist,www.gandul.ro,1,2,1,4,-0.25,0.25
Alex Vlădescu,www.b1tv.ro,0,0,3,3,0.0,0.0
Biden,www.b1tv.ro,0,1,0,1,-1.0,1.0
Statele Unite,www.b1tv.ro,0,1,4,5,-0.2,0.2
doamna Șoșoacă,www.b1tv.ro,0,1,0,1,-1.0,1.0
regină,www.b1tv.ro,0,0,1,1,0.0,0.0
Șoșoacă,www.b1tv.ro,0,1,1,2,-0.5,0.5
Adrian Axinia,www.cotidianul.ro,0,0,1,1,0.0,0.0
Dragnea,www.cotidianul.ro,0,3,0,3,-1.0,1.0
Lucian Romașcanu,www.cotidianul.ro,0,0,5,5,0.0,0.0
Romașcanu,www.cotidianul.ro,0,1,2,3,-0.3333333333333333,0.3333333333333333
Viorel Ștefan,www.cotidianul.ro,0,0,1,1,0.0,0.0
buzoi,www.cotidianul.ro,0,1,0,1,-1.0,1.0
colaborator,www.cotidianul.ro,1,2,1,4,-0.25,0.25
purtător de cuvânt,www.cotidianul.ro,0,2,3,5,-0.4,0.4
Bruxelles,primanews.ro,1,4,4,9,-0.3333333333333333,0.3333333333333333
Tanczos Barna,primanews.ro,0,0,3,3,0.0,0.0
Adrian Foghiș,www.cotidianul.ro,0,0,1,1,0.0,0.0
Ancuța Șchiop,www.cotidianul.ro,0,0,1,1,0.0,0.0
Beiuș,www.cotidianul.ro,0,0,1,1,0.0,0.0
Birta Florin,www.cotidianul.ro,0,0,1,1,0.0,0.0
Bolojan,www.cotidianul.ro,2,8,12,22,-0.2727272727272727,0.2727272727272727
Cociuba Mare,www.cotidianul.ro,0,0,1,1,0.0,0.0
Cristian Buzlea,www.cotidianul.ro,0,0,1,1,0.0,0.0
Călin Gal,www.cotidianul.ro,0,0,1,1,0.0,0.0
Gabriel Popa,www.cotidianul.ro,0,0,1,1,0.0,0.0
Gheorghe Bota,www.cotidianul.ro,0,0,1,1,0.0,0.0
Ioan Mărcuș,www.cotidianul.ro,0,0,1,1,0.0,0.0
Iulian Balaj,www.cotidianul.ro,0,0,1,1,0.0,0.0
Marcela Prada,www.cotidianul.ro,0,0,1,1,0.0,0.0
Mihai Sferle,www.cotidianul.ro,0,0,1,1,0.0,0.0
Mircea Mălan,www.cotidianul.ro,0,0,2,2,0.0,0.0
Oradea,www.cotidianul.ro,1,0,2,3,0.3333333333333333,0.3333333333333333
Rieni,www.cotidianul.ro,0,0,1,1,0.0,0.0
Sântandrei,www.cotidianul.ro,0,0,1,1,0.0,0.0
Teofil Filimon,www.cotidianul.ro,0,0,1,1,0.0,0.0
Kiss Janos,www.cotidianul.ro,0,0,1,1,0.0,0.0
Gheorghe Carp,www.cotidianul.ro,0,0,1,1,0.0,0.0
Dumitru Țiplea,www.cotidianul.ro,0,0,1,1,0.0,0.0
Arina Moș,www.cotidianul.ro,0,0,1,1,0.0,0.0
viceprimar,www.cotidianul.ro,0,1,4,5,-0.2,0.2
Ștei,www.cotidianul.ro,0,0,1,1,0.0,0.0
Cristian Seidler,www.digi24.ro,0,0,2,2,0.0,0.0
Seidler,www.digi24.ro,0,0,1,1,0.0,0.0
coordonator,www.digi24.ro,0,1,1,2,-0.5,0.5
Constantinescu,www.comisarul.ro,0,0,2,2,0.0,0.0
Horia Constantinescu,www.comisarul.ro,0,1,1,2,-0.5,0.5
spectator,www.comisarul.ro,0,0,1,1,0.0,0.0
Adina Vălean,recorder.ro,0,0,3,3,0.0,0.0
Alex Florența,recorder.ro,0,0,2,2,0.0,0.0
Alina Corbu,recorder.ro,0,0,1,1,0.0,0.0
Alina Gorghiu,recorder.ro,0,1,4,5,-0.2,0.2
Brazilia,recorder.ro,0,0,1,1,0.0,0.0
Cîrstoiu,recorder.ro,0,1,1,2,-0.5,0.5
Cătălin Cîrstoiu,recorder.ro,0,1,2,3,-0.3333333333333333,0.3333333333333333
Ionel Stoica,recorder.ro,0,0,1,1,0.0,0.0
Japonia,recorder.ro,0,0,1,1,0.0,0.0
Joe Biden,recorder.ro,0,2,7,9,-0.2222222222222222,0.2222222222222222
Stormy Daniels,recorder.ro,0,0,2,2,0.0,0.0
actriță,recorder.ro,0,3,0,3,-1.0,1.0
demnitar,recorder.ro,0,5,2,7,-0.7142857142857143,0.7142857142857143
ministră,recorder.ro,0,2,1,3,-0.6666666666666666,0.6666666666666666
procuror general,recorder.ro,0,2,0,2,-1.0,1.0
rezident,recorder.ro,0,0,1,1,0.0,0.0
Lia Olguța Vasilescu,www.digi24.ro,0,0,1,1,0.0,0.0
Marius Tucă,www.digi24.ro,0,0,1,1,0.0,0.0
Oprea,primanews.ro,0,2,0,2,-1.0,1.0
Ștefan Oprea,primanews.ro,0,0,1,1,0.0,0.0
Balș,pressone.ro,0,0,1,1,0.0,0.0
Cătălin Rotea,pressone.ro,0,0,1,1,0.0,0.0
Darius Vâlcov,pressone.ro,0,5,1,6,-0.8333333333333334,0.8333333333333334
personal medical,pressone.ro,0,1,3,4,-0.25,0.25
Rotea,pressone.ro,0,1,0,1,-1.0,1.0
Slatina,pressone.ro,0,1,4,5,-0.2,0.2
Vâlcov,pressone.ro,0,2,0,2,-1.0,1.0
aparținător,pressone.ro,0,1,1,2,-0.5,0.5
brancardier,pressone.ro,0,0,1,1,0.0,0.0
cără,pressone.ro,0,1,0,1,-1.0,1.0
inculpat,pressone.ro,0,6,0,6,-1.0,1.0
infirmier,pressone.ro,0,0,1,1,0.0,0.0
martor,pressone.ro,0,2,9,11,-0.18181818181818182,0.18181818181818182
mituitor,pressone.ro,0,1,0,1,-1.0,1.0
prefect,pressone.ro,2,6,15,23,-0.17391304347826086,0.17391304347826086
Ankara,adevarul.ro,0,0,2,2,0.0,0.0
Austria,adevarul.ro,0,2,6,8,-0.25,0.25
Berlin,adevarul.ro,0,0,4,4,0.0,0.0
Londra,adevarul.ro,0,0,3,3,0.0,0.0
Madrid,adevarul.ro,0,0,2,2,0.0,0.0
Republica,adevarul.ro,0,0,1,1,0.0,0.0
Roma,adevarul.ro,0,0,3,3,0.0,0.0
Statele Unite ale Americii,adevarul.ro,1,3,15,19,-0.10526315789473684,0.10526315789473684
Viena,adevarul.ro,0,1,2,3,-0.3333333333333333,0.3333333333333333
agricultor,adevarul.ro,1,0,1,2,0.5,0.5
conducător,adevarul.ro,0,5,4,9,-0.5555555555555556,0.5555555555555556
intelectual,adevarul.ro,1,1,0,2,0.0,0.0
vârstnic,adevarul.ro,0,0,2,2,0.0,0.0
ales,www.gandul.ro,0,3,3,6,-0.5,0.5
Florin Călinescu,www.digi24.ro,0,0,2,2,0.0,0.0
drum,www.digi24.ro,0,1,0,1,-1.0,1.0
dvs,www.digi24.ro,0,2,1,3,-0.6666666666666666,0.6666666666666666
oaspete,www.digi24.ro,1,0,0,1,1.0,1.0
Republica Moldova,observatornews.ro,4,0,4,8,0.5,0.5
Marius Tucă,adevarul.ro,1,0,2,3,0.3333333333333333,0.3333333333333333
Ambasador,primanews.ro,0,0,1,1,0.0,0.0
Kiev,primanews.ro,1,0,23,24,0.041666666666666664,0.041666666666666664
Moscova,primanews.ro,0,9,2,11,-0.8181818181818182,0.8181818181818182
Rusia,primanews.ro,0,15,18,33,-0.45454545454545453,0.45454545454545453
Turcia,primanews.ro,0,0,16,16,0.0,0.0
Vladimir Putin,primanews.ro,0,10,18,28,-0.35714285714285715,0.35714285714285715
aliaț,primanews.ro,0,3,3,6,-0.5,0.5
diplomat,primanews.ro,0,2,1,3,-0.6666666666666666,0.6666666666666666
Anton,www.antena3.ro,0,0,1,1,0.0,0.0
Anton Pisaroglu,www.antena3.ro,0,0,1,1,0.0,0.0
Papa Francisc,www.antena3.ro,0,0,1,1,0.0,0.0
Viorica Dăncilă,www.antena3.ro,0,1,5,6,-0.16666666666666666,0.16666666666666666
Adrian Negrescu,www.cotidianul.ro,0,0,2,2,0.0,0.0
analist,www.cotidianul.ro,0,3,2,5,-0.6,0.6
Cosmin Matei,www.cotidianul.ro,0,0,1,1,0.0,0.0
expert,www.cotidianul.ro,0,1,3,4,-0.25,0.25
Zelenski,www.cotidianul.ro,0,1,0,1,-1.0,1.0
investitor,www.cotidianul.ro,2,3,4,9,-0.1111111111111111,0.1111111111111111
Geoană,www.digi24.ro,0,4,3,7,-0.5714285714285714,0.5714285714285714
Mark Rutte,www.digi24.ro,0,0,1,1,0.0,0.0
secretar general adjunct,www.digi24.ro,1,0,2,3,0.3333333333333333,0.3333333333333333
secretar adjunct,www.digi24.ro,0,0,1,1,0.0,0.0
secretar general,www.digi24.ro,0,1,11,12,-0.08333333333333333,0.08333333333333333
Adrian Severin,a1.ro,0,2,0,2,-1.0,1.0
Dan Pasat,a1.ro,0,1,1,2,-0.5,0.5
Ernst Strasser,a1.ro,0,1,0,1,-1.0,1.0
Sebastian Bodu,a1.ro,0,0,1,1,0.0,0.0
Zoran Thaler,a1.ro,0,1,0,1,-1.0,1.0
acestia,a1.ro,0,2,3,5,-0.4,0.4
Bolojani,www.cotidianul.ro,0,1,0,1,-1.0,1.0
Băsiști,www.cotidianul.ro,0,1,0,1,-1.0,1.0
Ciolaci,www.cotidianul.ro,0,1,0,1,-1.0,1.0
Franța,www.cotidianul.ro,0,4,11,15,-0.26666666666666666,0.26666666666666666
Germania,www.cotidianul.ro,0,2,3,5,-0.4,0.4
Grindeni,www.cotidianul.ro,0,1,0,1,-1.0,1.0
Johanniști,www.cotidianul.ro,0,1,0,1,-1.0,1.0
Liviu Dragnea,www.cotidianul.ro,0,2,0,2,-1.0,1.0
Emmanuel Macron,www.cotidianul.ro,0,2,6,8,-0.25,0.25
Rusia,www.cotidianul.ro,0,16,1,17,-0.9411764705882353,0.9411764705882353
Ucraina,www.cotidianul.ro,1,5,10,16,-0.25,0.25
amără,www.cotidianul.ro,0,1,0,1,-1.0,1.0
complic,www.cotidianul.ro,0,1,0,1,-1.0,1.0
cântăreț,www.cotidianul.ro,0,3,0,3,-1.0,1.0
d,www.cotidianul.ro,0,1,1,2,-0.5,0.5
incul,www.cotidianul.ro,0,1,0,1,-1.0,1.0
influencer,www.cotidianul.ro,0,3,0,3,-1.0,1.0
lea,www.cotidianul.ro,0,1,0,1,-1.0,1.0
marionetă,www.cotidianul.ro,0,1,0,1,-1.0,1.0
proști,www.cotidianul.ro,0,1,0,1,-1.0,1.0
securist,www.cotidianul.ro,0,2,0,2,-1.0,1.0
simpatizant,www.cotidianul.ro,0,3,1,4,-0.75,0.75
sportiv,www.cotidianul.ro,0,1,1,2,-0.5,0.5
Berlin,www.news.ro,0,0,2,2,0.0,0.0
Juca,www.news.ro,0,0,1,1,0.0,0.0
Jurca,www.news.ro,0,0,1,1,0.0,0.0
Mihai Jurca,www.news.ro,0,0,2,2,0.0,0.0
Oradea,www.news.ro,0,0,4,4,0.0,0.0
city manager,www.news.ro,0,0,1,1,0.0,0.0
consilier prezidențial,www.news.ro,0,0,3,3,0.0,0.0
Cătălin Măruță,www.gandul.ro,0,0,1,1,0.0,0.0
Octav Ganea,www.digi24.ro,0,0,1,1,0.0,0.0
Robert Negoiță,a1.ro,0,2,1,3,-0.6666666666666666,0.6666666666666666
Adrian Nastase,a1.ro,0,4,5,9,-0.4444444444444444,0.4444444444444444
Aristide Roibu,a1.ro,0,0,1,1,0.0,0.0
Dana Nastase,a1.ro,0,0,1,1,0.0,0.0
Ion Dumitru,a1.ro,0,1,0,1,-1.0,1.0
Irina Jianu,a1.ro,0,1,1,2,-0.5,0.5
Irina Paula Jianu,a1.ro,0,1,0,1,-1.0,1.0
Jianu,a1.ro,0,1,0,1,-1.0,1.0
Nicola Mihaela,a1.ro,0,0,1,1,0.0,0.0
Bogdan Popovici,a1.ro,0,1,1,2,-0.5,0.5
Popovici Marina Ioana,a1.ro,0,1,0,1,-1.0,1.0
Rovana Plumb,a1.ro,0,0,2,2,0.0,0.0
Stireanu Octavian,a1.ro,0,0,1,1,0.0,0.0
furnizor,a1.ro,0,1,0,1,-1.0,1.0
Gasparovici,a1.ro,0,1,0,1,-1.0,1.0
inculpat,a1.ro,0,3,1,4,-0.75,0.75
Vasile Cristian,a1.ro,0,1,0,1,-1.0,1.0
Vasile Mihail Cristian,a1.ro,0,1,0,1,-1.0,1.0
interpus,a1.ro,0,2,0,2,-1.0,1.0
rtor,a1.ro,0,1,0,1,-1.0,1.0
uit,a1.ro,0,1,0,1,-1.0,1.0
Burduja,www.romaniatv.net,0,0,3,3,0.0,0.0
Cehia,www.romaniatv.net,0,0,1,1,0.0,0.0
Miercurea Ciuc,www.romaniatv.net,0,0,1,1,0.0,0.0
Moscova,www.romaniatv.net,0,1,2,3,-0.3333333333333333,0.3333333333333333
Orban,www.romaniatv.net,0,0,1,1,0.0,0.0
Sebastian Burduja,www.romaniatv.net,0,0,8,8,0.0,0.0
Ungaria,www.romaniatv.net,0,2,4,6,-0.3333333333333333,0.3333333333333333
Ungarie,www.romaniatv.net,0,0,2,2,0.0,0.0
Ungurii,www.romaniatv.net,0,0,1,1,0.0,0.0
Viktor Orban,www.romaniatv.net,0,0,2,2,0.0,0.0
angajat,www.romaniatv.net,2,5,15,22,-0.13636363636363635,0.13636363636363635
client,www.romaniatv.net,0,0,1,1,0.0,0.0
utilizator,www.romaniatv.net,0,0,6,6,0.0,0.0
zații,www.romaniatv.net,0,1,0,1,-1.0,1.0
Barbara Deppert Lippitz,www.comisarul.ro,0,0,2,2,0.0,0.0
Decebal,www.comisarul.ro,0,0,2,2,0.0,0.0
Geoagiu Băi,www.comisarul.ro,0,0,1,1,0.0,0.0
George Martinuzzi,www.comisarul.ro,0,1,0,1,-1.0,1.0
Germisa,www.comisarul.ro,0,0,1,1,0.0,0.0
Hațegan,www.comisarul.ro,0,1,0,1,-1.0,1.0
Hațeg,www.comisarul.ro,0,0,1,1,0.0,0.0
Hunedoara,www.comisarul.ro,0,0,1,1,0.0,0.0
Imperiul Roman,www.comisarul.ro,0,0,1,1,0.0,0.0
Sibiu,www.comisarul.ro,0,0,5,5,0.0,0.0
Stan Avram,www.comisarul.ro,0,0,1,1,0.0,0.0
Transilvania,www.comisarul.ro,0,0,2,2,0.0,0.0
Ulpia Traiană,www.comisarul.ro,0,0,1,1,0.0,0.0
autor,www.comisarul.ro,0,1,5,6,-0.16666666666666666,0.16666666666666666
guvernator,www.comisarul.ro,0,2,0,2,-1.0,1.0
intelectual,www.comisarul.ro,0,1,2,3,-0.3333333333333333,0.3333333333333333
istoricul Marius Constantinescu,www.comisarul.ro,0,0,1,1,0.0,0.0
localnic,www.comisarul.ro,1,0,2,3,0.3333333333333333,0.3333333333333333
meșter,www.comisarul.ro,1,1,0,2,0.0,0.0
muncitor,www.comisarul.ro,0,2,5,7,-0.2857142857142857,0.2857142857142857
preot,www.comisarul.ro,0,0,1,1,0.0,0.0
Jacob Jianu,www.comisarul.ro,0,0,1,1,0.0,0.0
preotul,www.comisarul.ro,0,0,1,1,0.0,0.0
sătean,www.comisarul.ro,0,1,0,1,-1.0,1.0
Wolfgang Lazius,www.comisarul.ro,0,0,1,1,0.0,0.0
vizigă,www.comisarul.ro,0,1,0,1,-1.0,1.0
vânător,www.comisarul.ro,0,1,0,1,-1.0,1.0
zeu,www.comisarul.ro,0,0,1,1,0.0,0.0
Diana,www.comisarul.ro,0,0,1,1,0.0,0.0
învățător,www.comisarul.ro,0,0,1,1,0.0,0.0
Marcele,www.news.ro,0,1,0,1,-1.0,1.0
angajat,www.news.ro,1,2,4,7,-0.14285714285714285,0.14285714285714285
electorat,www.news.ro,0,9,11,20,-0.45,0.45
observator,www.news.ro,0,1,0,1,-1.0,1.0
prefect,www.news.ro,0,1,0,1,-1.0,1.0
individ,www.news.ro,0,2,2,4,-0.5,0.5
mandatar,www.news.ro,0,0,1,1,0.0,0.0
simpatizant,www.news.ro,1,3,0,4,-0.5,0.5
Adriana Margareta Luchian,a1.ro,0,0,1,1,0.0,0.0
Ana Maria Topoliceanu,a1.ro,0,0,2,2,0.0,0.0
Udrea,a1.ro,0,8,4,12,-0.6666666666666666,0.6666666666666666
Maria Topoliceanu,a1.ro,0,0,1,1,0.0,0.0
Florin Iordache,www.aktual24.ro,0,2,1,3,-0.6666666666666666,0.6666666666666666
Gorghiu,www.aktual24.ro,0,1,1,2,-0.5,0.5
Hrebenciuc,www.aktual24.ro,0,2,0,2,-1.0,1.0
Marius Tuca,www.aktual24.ro,0,1,1,2,-0.5,0.5
Mircea Geoană,www.aktual24.ro,0,3,10,13,-0.23076923076923078,0.23076923076923078
Oliver Cromwell,www.aktual24.ro,0,1,0,1,-1.0,1.0
Rizea,www.aktual24.ro,0,1,0,1,-1.0,1.0
Turcan,www.aktual24.ro,0,1,0,1,-1.0,1.0
Valeriu Stoica,www.aktual24.ro,0,0,1,1,0.0,0.0
Vanghelie,www.aktual24.ro,0,1,0,1,-1.0,1.0
Vantu,www.aktual24.ro,0,1,0,1,-1.0,1.0
amic,www.aktual24.ro,0,1,0,1,-1.0,1.0
cumnat,www.aktual24.ro,0,3,0,3,-1.0,1.0
editorialist,www.aktual24.ro,0,1,0,1,-1.0,1.0
garant,www.aktual24.ro,0,1,0,1,-1.0,1.0
jurnalistă,www.aktual24.ro,0,1,4,5,-0.2,0.2
miliardar,www.aktual24.ro,0,1,2,3,-0.3333333333333333,0.3333333333333333
om politic,www.aktual24.ro,0,2,0,2,-1.0,1.0
oară,www.aktual24.ro,0,1,0,1,-1.0,1.0
propagandist,www.aktual24.ro,0,3,0,3,-1.0,1.0
Rodica Culcer,www.aktual24.ro,0,0,1,1,0.0,0.0
sil,www.aktual24.ro,0,1,0,1,-1.0,1.0
slugă,www.aktual24.ro,0,3,0,3,-1.0,1.0
stăpânul,www.aktual24.ro,0,1,0,1,-1.0,1.0
Burleanu,stirileprotv.ro,0,1,0,1,-1.0,1.0
Lupescu,stirileprotv.ro,0,1,0,1,-1.0,1.0
ipocrit,stirileprotv.ro,0,1,0,1,-1.0,1.0
manipulator,stirileprotv.ro,0,1,0,1,-1.0,1.0
tuturor,stirileprotv.ro,0,1,0,1,-1.0,1.0
Olosz Gergely,adevarul.ro,0,0,1,1,0.0,0.0
Gergely Olosz,adevarul.ro,0,1,0,1,-1.0,1.0
Tamas Sandor,adevarul.ro,0,0,1,1,0.0,0.0
adult,www.cotidianul.ro,0,1,0,1,-1.0,1.0
familie,www.cotidianul.ro,3,1,4,8,0.25,0.25
ia,www.cotidianul.ro,0,1,0,1,-1.0,1.0
Alina Mungiu Pippidi,www.cotidianul.ro,0,0,2,2,0.0,0.0
Cătălin Predoiu,www.realitatea.net,0,0,2,2,0.0,0.0
Emil Hurezeanu,www.realitatea.net,0,0,1,1,0.0,0.0
Prahova,www.realitatea.net,0,0,1,1,0.0,0.0
emisar,www.realitatea.net,0,0,1,1,0.0,0.0
Stănescu,stirileprotv.ro,0,0,2,2,0.0,0.0
Adrian Teleșpan,recorder.ro,0,0,1,1,0.0,0.0
Alina Teiș,recorder.ro,0,0,1,1,0.0,0.0
Baia de Aramă,recorder.ro,0,0,1,1,0.0,0.0
Cornel Folescu,recorder.ro,0,0,1,1,0.0,0.0
Drobeta-Turnu Severin,recorder.ro,0,0,1,1,0.0,0.0
Dumitru Mărculescu,recorder.ro,0,0,1,1,0.0,0.0
Halânga,recorder.ro,0,1,0,1,-1.0,1.0
Isaac Asimov,recorder.ro,1,0,0,1,1.0,1.0
Jean-Paul Sartre,recorder.ro,0,0,1,1,0.0,0.0
Liviu Lucian Mazilu,recorder.ro,0,0,1,1,0.0,0.0
Mehedinți,recorder.ro,0,3,5,8,-0.375,0.375
pentru,recorder.ro,0,0,3,3,0.0,0.0
Stela Firu,recorder.ro,0,0,1,1,0.0,0.0
Stănești,recorder.ro,0,0,1,1,0.0,0.0
Turnu Severin,recorder.ro,0,0,1,1,0.0,0.0
Victor Negrescu,recorder.ro,2,1,2,5,0.2,0.2
Virgil Alin Chirilă,recorder.ro,0,0,1,1,0.0,0.0
Virgil Popescu,recorder.ro,0,0,1,1,0.0,0.0
dansatoare,recorder.ro,0,1,0,1,-1.0,1.0
electrician,recorder.ro,0,0,3,3,0.0,0.0
emia,recorder.ro,0,2,0,2,-1.0,1.0
iubitor,recorder.ro,1,0,0,1,1.0,1.0
justițiabil,recorder.ro,0,0,1,1,0.0,0.0
mehedințean,recorder.ro,0,0,1,1,0.0,0.0
or,recorder.ro,0,0,1,1,0.0,0.0
plătitor,recorder.ro,0,1,0,1,-1.0,1.0
severinean,recorder.ro,0,1,0,1,-1.0,1.0
Emil Boc,www.gandul.ro,0,0,4,4,0.0,0.0
Lia Olguța Vasilescu,www.gandul.ro,0,2,5,7,-0.2857142857142857,0.2857142857142857
Liviu Pop,www.gandul.ro,0,1,2,3,-0.3333333333333333,0.3333333333333333
Marius Dunca,www.gandul.ro,0,0,1,1,0.0,0.0
Mircea Dobre,www.gandul.ro,0,0,1,1,0.0,0.0
Olguța Vasilescu,www.gandul.ro,0,0,2,2,0.0,0.0
Pieleanu,www.gandul.ro,0,0,1,1,0.0,0.0
Raed Arafat,www.gandul.ro,0,0,1,1,0.0,0.0
Sevil Shhaideh,www.gandul.ro,0,0,1,1,0.0,0.0
sociolog,www.gandul.ro,0,1,2,3,-0.3333333333333333,0.3333333333333333
Marius Pieleanu,www.gandul.ro,0,1,0,1,-1.0,1.0
Teodor Meleșcanu,www.gandul.ro,0,0,2,2,0.0,0.0
Tudorel Toader,www.gandul.ro,0,3,2,5,-0.6,0.6
Tudose,www.gandul.ro,0,3,0,3,-1.0,1.0
Marian Ciolacu,www.gandul.ro,0,0,1,1,0.0,0.0
respondent,www.gandul.ro,0,0,4,4,0.0,0.0
Aleksandar Vucic,www.euronews.ro,0,1,0,1,-1.0,1.0
Arizona,www.euronews.ro,0,0,1,1,0.0,0.0
Belgrad,www.euronews.ro,0,0,1,1,0.0,0.0
Novi Sad,www.euronews.ro,0,0,1,1,0.0,0.0
Panama,www.euronews.ro,0,0,1,1,0.0,0.0
Marius Ghincea,www.euronews.ro,0,0,2,2,0.0,0.0
rănit,www.euronews.ro,0,2,0,2,-1.0,1.0
capitală,a1.ro,0,1,10,11,-0.09090909090909091,0.09090909090909091
Constantin Nicolescu,a1.ro,0,0,2,2,0.0,0.0
Daniel Dragomir,a1.ro,0,1,0,1,-1.0,1.0
Pendiuc,a1.ro,0,0,1,1,0.0,0.0
Piteștiu,a1.ro,0,0,1,1,0.0,0.0
Tudor Pendiuc,a1.ro,0,0,1,1,0.0,0.0
contracandidat,a1.ro,0,3,0,3,-1.0,1.0
subprefect,a1.ro,0,0,1,1,0.0,0.0
viceprimar,a1.ro,0,1,1,2,-0.5,0.5
Ionuț Moșteanu,agerpres.ro,0,1,3,4,-0.25,0.25
Moșteanu,agerpres.ro,0,2,2,4,-0.5,0.5
jurnalist,agerpres.ro,0,1,4,5,-0.2,0.2
Capitale,www.b1tv.ro,2,1,11,14,0.07142857142857142,0.07142857142857142
Dan,www.b1tv.ro,0,0,3,3,0.0,0.0
actor,www.b1tv.ro,0,3,1,4,-0.75,0.75
bătrân,www.b1tv.ro,0,1,2,3,-0.3333333333333333,0.3333333333333333
finanțator,www.b1tv.ro,0,1,0,1,-1.0,1.0
susținător,www.b1tv.ro,0,5,2,7,-0.7142857142857143,0.7142857142857143
Gheorghe Simion,www.g4media.ro,0,1,1,2,-0.5,0.5
opoza,www.g4media.ro,0,1,0,1,-1.0,1.0
participanț,www.g4media.ro,0,0,3,3,0.0,0.0
politician,www.g4media.ro,0,22,2,24,-0.9166666666666666,0.9166666666666666
public,www.g4media.ro,0,7,4,11,-0.6363636363636364,0.6363636363636364
semințe,www.g4media.ro,0,0,1,1,0.0,0.0
el,www.antena3.ro,0,1,1,2,-0.5,0.5
noi,www.antena3.ro,1,0,0,1,1.0,1.0
Allen,observatornews.ro,0,0,1,1,0.0,0.0
Allen Coliban,observatornews.ro,0,0,1,1,0.0,0.0
Clotilde,observatornews.ro,0,0,1,1,0.0,0.0
Clotilde Armande,observatornews.ro,0,0,1,1,0.0,0.0
Fritz,observatornews.ro,0,1,0,1,-1.0,1.0
Ionuț,observatornews.ro,0,0,1,1,0.0,0.0
consultant,observatornews.ro,0,1,1,2,-0.5,0.5
Piedone,www.b1tv.ro,0,3,1,4,-0.75,0.75
Alexandru Florența,www.gandul.ro,0,0,1,1,0.0,0.0
Alina Albu,www.gandul.ro,0,0,1,1,0.0,0.0
Alina Gorghiu,www.gandul.ro,0,0,8,8,0.0,0.0
Cătălin Predoiu,www.gandul.ro,0,0,7,7,0.0,0.0
Daniel Grădinaru,www.gandul.ro,0,0,1,1,0.0,0.0
Federația Rusă,www.gandul.ro,0,2,1,3,-0.6666666666666666,0.6666666666666666
Gorghiu,www.gandul.ro,0,0,1,1,0.0,0.0
Ierusalim,www.gandul.ro,0,0,1,1,0.0,0.0
Marius Voineag,www.gandul.ro,0,0,1,1,0.0,0.0
Siria,www.gandul.ro,0,1,1,2,-0.5,0.5
Terorist,www.gandul.ro,0,1,0,1,-1.0,1.0
Vera Jourová,www.gandul.ro,0,0,1,1,0.0,0.0
Vera Jurova,www.gandul.ro,0,0,1,1,0.0,0.0
activist,www.gandul.ro,0,3,3,6,-0.5,0.5
domnie,www.gandul.ro,2,1,0,3,0.3333333333333333,0.3333333333333333
magistrat,www.gandul.ro,0,1,2,3,-0.3333333333333333,0.3333333333333333
ri,www.gandul.ro,0,0,1,1,0.0,0.0
vicepreședintă,www.gandul.ro,0,0,1,1,0.0,0.0
Brahma,pressone.ro,0,0,1,1,0.0,0.0
Buzzati,pressone.ro,0,1,0,1,-1.0,1.0
Caragiale,pressone.ro,0,0,2,2,0.0,0.0
DJ,pressone.ro,0,0,1,1,0.0,0.0
Doinaș,pressone.ro,0,0,1,1,0.0,0.0
Eliade,pressone.ro,0,1,1,2,-0.5,0.5
Giovanni Drogo,pressone.ro,0,0,1,1,0.0,0.0
Hamlet,pressone.ro,1,0,1,2,0.5,0.5
Hemingway,pressone.ro,0,0,1,1,0.0,0.0
Ivan cel Groaznic,pressone.ro,0,1,0,1,-1.0,1.0
Plevna,pressone.ro,0,0,1,1,0.0,0.0
Polonius,pressone.ro,0,1,0,1,-1.0,1.0
Shiva,pressone.ro,0,0,1,1,0.0,0.0
spărgător,pressone.ro,0,2,0,2,-1.0,1.0
Viv,pressone.ro,1,0,0,1,1.0,1.0
ai,pressone.ro,0,6,2,8,-0.75,0.75
apropiat,pressone.ro,0,6,2,8,-0.75,0.75
at,pressone.ro,0,1,0,1,-1.0,1.0
bunică,pressone.ro,1,1,4,6,0.0,0.0
băiețandru,pressone.ro,0,1,0,1,-1.0,1.0
coordonator,pressone.ro,1,5,15,21,-0.19047619047619047,0.19047619047619047
creier,pressone.ro,2,0,0,2,1.0,1.0
câine,pressone.ro,0,0,1,1,0.0,0.0
cățel,pressone.ro,0,1,1,2,-0.5,0.5
decorator,pressone.ro,0,1,0,1,-1.0,1.0
dirijor,pressone.ro,0,1,0,1,-1.0,1.0
duhovnic,pressone.ro,0,2,1,3,-0.6666666666666666,0.6666666666666666
hamster,pressone.ro,0,1,0,1,-1.0,1.0
instalator,pressone.ro,1,0,0,1,1.0,1.0
meseriaș,pressone.ro,0,2,2,4,-0.5,0.5
meseriași,pressone.ro,0,0,1,1,0.0,0.0
nepri,pressone.ro,0,1,0,1,-1.0,1.0
pescar,pressone.ro,0,4,1,5,-0.8,0.8
Iona,pressone.ro,0,1,0,1,-1.0,1.0
psihoterapeut,pressone.ro,0,0,1,1,0.0,0.0
riaș,pressone.ro,0,1,0,1,-1.0,1.0
răchită,pressone.ro,0,1,0,1,-1.0,1.0
sobar,pressone.ro,0,1,0,1,-1.0,1.0
stomatolog,pressone.ro,0,1,0,1,-1.0,1.0
tip,pressone.ro,0,6,0,6,-1.0,1.0
tătar,pressone.ro,0,1,0,1,-1.0,1.0
umanitate,pressone.ro,0,1,0,1,-1.0,1.0
uț,pressone.ro,0,1,0,1,-1.0,1.0
vecin,pressone.ro,0,5,1,6,-0.8333333333333334,0.8333333333333334
înger,pressone.ro,0,0,1,1,0.0,0.0
întemnițat,pressone.ro,0,1,0,1,-1.0,1.0
șerif,pressone.ro,0,1,0,1,-1.0,1.0
șoarece,pressone.ro,0,1,0,1,-1.0,1.0
Alba Iulia,adevarul.ro,0,0,2,2,0.0,0.0
secretar general adjunct,adevarul.ro,0,0,5,5,0.0,0.0
adjunct,adevarul.ro,0,1,3,4,-0.25,0.25
secretar adjunct,adevarul.ro,0,0,1,1,0.0,0.0
Coreea de Sud,a1.ro,0,0,1,1,0.0,0.0
Ion Diaconescu,a1.ro,0,0,3,3,0.0,0.0
adversar,a1.ro,0,2,0,2,-1.0,1.0
apropiat,a1.ro,0,1,0,1,-1.0,1.0
rudă,a1.ro,0,0,1,1,0.0,0.0
rude,a1.ro,0,0,1,1,0.0,0.0
taranist,a1.ro,0,1,0,1,-1.0,1.0
Funeriu,www.news.ro,0,2,5,7,-0.2857142857142857,0.2857142857142857
elită,www.news.ro,0,1,0,1,-1.0,1.0
judecător,www.news.ro,0,3,8,11,-0.2727272727272727,0.2727272727272727
Cezara,a1.ro,0,0,2,2,0.0,0.0
Cluj,a1.ro,0,0,4,4,0.0,0.0
Cluj Napoca,a1.ro,0,0,1,1,0.0,0.0
Keir Starmer,a1.ro,0,0,1,1,0.0,0.0
Lady Vic,a1.ro,0,1,0,1,-1.0,1.0
Oana,a1.ro,0,1,4,5,-0.2,0.2
Oana Boc,a1.ro,0,0,2,2,0.0,0.0
Oansa Boc,a1.ro,0,0,1,1,0.0,0.0
Patricia,a1.ro,0,0,2,2,0.0,0.0
Victoria Starmer,a1.ro,0,0,1,1,0.0,0.0
fată,a1.ro,0,0,2,2,0.0,0.0
profesor,a1.ro,0,0,2,2,0.0,0.0
scriitoare,a1.ro,1,0,0,1,1.0,1.0
Barna,www.news.ro,0,0,2,2,0.0,0.0
Dan Barna,www.news.ro,0,0,2,2,0.0,0.0
eurodeputat,www.news.ro,0,1,2,3,-0.3333333333333333,0.3333333333333333
Bulgaria,www.aktual24.ro,0,1,5,6,-0.16666666666666666,0.16666666666666666
Joe Biden,www.digi24.ro,2,0,1,3,0.6666666666666666,0.6666666666666666
Daniel Funeriu,primanews.ro,0,0,4,4,0.0,0.0
Gheorghiță Vlad,primanews.ro,0,0,3,3,0.0,0.0
Biden,www.activenews.ro,0,2,0,2,-1.0,1.0
Covid,www.activenews.ro,0,2,0,2,-1.0,1.0
Cătălin Tolontan,www.activenews.ro,0,1,2,3,-0.3333333333333333,0.3333333333333333
Daniel Băluță,www.activenews.ro,0,0,1,1,0.0,0.0
Didier Raoult,www.activenews.ro,0,0,1,1,0.0,0.0
Haley,www.activenews.ro,0,0,1,1,0.0,0.0
Mircea Marian,www.activenews.ro,0,0,1,1,0.0,0.0
Adrian Cuculis,www.activenews.ro,0,0,1,1,0.0,0.0
decedat,www.activenews.ro,0,1,0,1,-1.0,1.0
doctor,www.activenews.ro,0,0,1,1,0.0,0.0
laic,www.activenews.ro,0,1,0,1,-1.0,1.0
medic,www.activenews.ro,0,0,4,4,0.0,0.0
medic legist,www.activenews.ro,0,0,1,1,0.0,0.0
preot,www.activenews.ro,1,7,4,12,-0.5,0.5
ÎPS Teodosie,www.activenews.ro,0,1,0,1,-1.0,1.0
Adriana Denisa Sandu,www.g4media.ro,0,0,1,1,0.0,0.0
Anastasescu,www.g4media.ro,0,0,1,1,0.0,0.0
Bashir,www.g4media.ro,0,1,0,1,-1.0,1.0
Costin Sebastian,www.g4media.ro,0,2,0,2,-1.0,1.0
Daniela,www.g4media.ro,0,0,1,1,0.0,0.0
Dumitru Dumbravă,www.g4media.ro,0,0,1,1,0.0,0.0
Dâmbovița,www.g4media.ro,0,1,3,4,-0.25,0.25
Ekir Mark Bashir,www.g4media.ro,0,1,0,1,-1.0,1.0
Elena Moise,www.g4media.ro,0,2,0,2,-1.0,1.0
Mihaela Neagu,www.g4media.ro,0,1,1,2,-0.5,0.5
Finul,www.g4media.ro,0,1,0,1,-1.0,1.0
Florian Coldea,www.g4media.ro,0,0,1,1,0.0,0.0
Gheorghe Nețoiu,www.g4media.ro,0,0,1,1,0.0,0.0
Gheorghe Becali,www.g4media.ro,0,1,0,1,-1.0,1.0
Ghiță,www.g4media.ro,0,1,0,1,-1.0,1.0
Ilfov,www.g4media.ro,0,0,6,6,0.0,0.0
Ioan Varga,www.g4media.ro,0,0,1,1,0.0,0.0
Ion Mocioalcă,www.g4media.ro,0,0,1,1,0.0,0.0
Ionela Dicu,www.g4media.ro,0,1,0,1,-1.0,1.0
Jean Sasu,www.g4media.ro,0,0,1,1,0.0,0.0
Laura Adriana Niculae,www.g4media.ro,0,1,0,1,-1.0,1.0
Laurențiu Nicușor Gorun,www.g4media.ro,0,2,0,2,-1.0,1.0
Lucia Gabriela Beșciu,www.g4media.ro,0,0,1,1,0.0,0.0
Luciei Beșciu,www.g4media.ro,0,0,1,1,0.0,0.0
Marius Neagu,www.g4media.ro,0,0,2,2,0.0,0.0
Mihai Anastasescu,www.g4media.ro,0,0,1,1,0.0,0.0
Mihai Cristian,www.g4media.ro,0,0,1,1,0.0,0.0
Mihai Leonard Rotaru,www.g4media.ro,0,1,1,2,-0.5,0.5
Mihai Theodor Mincu,www.g4media.ro,0,0,1,1,0.0,0.0
Mircea Geoană,www.g4media.ro,0,0,9,9,0.0,0.0
Mirel Alexandru Marcu,www.g4media.ro,0,0,1,1,0.0,0.0
Neagu,www.g4media.ro,0,1,1,2,-0.5,0.5
Nețoiu,www.g4media.ro,0,0,1,1,0.0,0.0
Ponta,www.g4media.ro,0,6,3,9,-0.6666666666666666,0.6666666666666666
Prahova,www.g4media.ro,0,0,7,7,0.0,0.0
Rotaru,www.g4media.ro,0,1,1,2,-0.5,0.5
Sasu,www.g4media.ro,0,1,0,1,-1.0,1.0
Sebastian Ghiță,www.g4media.ro,0,1,1,2,-0.5,0.5
Snagov,www.g4media.ro,0,0,1,1,0.0,0.0
Sorina Stan Docuz,www.g4media.ro,0,0,1,1,0.0,0.0
Stan Docuz,www.g4media.ro,0,1,0,1,-1.0,1.0
Theodora,www.g4media.ro,0,1,0,1,-1.0,1.0
Trăilă,www.g4media.ro,0,0,1,1,0.0,0.0
Tufan,www.g4media.ro,0,1,0,1,-1.0,1.0
Tufan Emil Mihai,www.g4media.ro,0,1,0,1,-1.0,1.0
Turcia,www.g4media.ro,0,2,1,3,-0.6666666666666666,0.6666666666666666
Vali Porojan,www.g4media.ro,0,0,1,1,0.0,0.0
Varga,www.g4media.ro,0,1,0,1,-1.0,1.0
Vâlcea,www.g4media.ro,0,0,2,2,0.0,0.0
apropiat,www.g4media.ro,0,2,2,4,-0.5,0.5
asasin profesionist,www.g4media.ro,0,1,0,1,-1.0,1.0
asociație,www.g4media.ro,0,1,0,1,-1.0,1.0
Doru Trăilă,www.g4media.ro,0,1,1,2,-0.5,0.5
directoare,www.g4media.ro,0,2,1,3,-0.6666666666666666,0.6666666666666666
fiică,www.g4media.ro,0,3,5,8,-0.375,0.375
fin,www.g4media.ro,0,1,1,2,-0.5,0.5
finanțator,www.g4media.ro,0,1,0,1,-1.0,1.0
ginere,www.g4media.ro,0,1,0,1,-1.0,1.0
interlop,www.g4media.ro,0,1,0,1,-1.0,1.0
investitor,www.g4media.ro,0,3,1,4,-0.75,0.75
masajist,www.g4media.ro,0,1,0,1,-1.0,1.0
Mihai Tufan,www.g4media.ro,0,0,1,1,0.0,0.0
partener,www.g4media.ro,2,2,5,9,0.0,0.0
producător,www.g4media.ro,0,1,0,1,-1.0,1.0
soră,www.g4media.ro,0,1,3,4,-0.25,0.25
suspect,www.g4media.ro,0,2,0,2,-1.0,1.0
trader,www.g4media.ro,0,1,0,1,-1.0,1.0
Antony Blinken,www.digi24.ro,0,1,0,1,-1.0,1.0
Emmanuel Macron,www.digi24.ro,0,4,1,5,-0.8,0.8
Maia Sandu,www.digi24.ro,0,0,2,2,0.0,0.0
Tucker Carlson,www.digi24.ro,0,0,1,1,0.0,0.0
secretar de stat,www.digi24.ro,0,3,4,7,-0.42857142857142855,0.42857142857142855
Becali,www.mediafax.ro,0,2,3,5,-0.4,0.4
Vanghelie,www.mediafax.ro,0,0,2,2,0.0,0.0
Cristian Popescu Piedone,www.b1tv.ro,0,1,1,2,-0.5,0.5
Popescu Piedone,www.b1tv.ro,0,1,0,1,-1.0,1.0
primar,www.b1tv.ro,1,8,17,26,-0.2692307692307692,0.2692307692307692
Boc,www.digi24.ro,0,1,1,2,-0.5,0.5
Elena Vijulie,www.digi24.ro,0,0,1,1,0.0,0.0
Invit,www.digi24.ro,0,0,1,1,0.0,0.0
Ungureanu,www.digi24.ro,0,1,1,2,-0.5,0.5
comisar,www.digi24.ro,1,4,6,11,-0.2727272727272727,0.2727272727272727
dânș,www.digi24.ro,0,1,0,1,-1.0,1.0
popor,adevarul.ro,6,6,5,17,0.0,0.0
Dumitru Borțun,www.euronews.ro,0,0,1,1,0.0,0.0
Geoană,www.euronews.ro,0,0,4,4,0.0,0.0
expert,www.euronews.ro,0,4,7,11,-0.36363636363636365,0.36363636363636365
profesor,www.euronews.ro,0,4,9,13,-0.3076923076923077,0.3076923076923077
Bogdan Bucur,adevarul.ro,2,3,8,13,-0.07692307692307693,0.07692307692307693
Kremlin Georgescu,adevarul.ro,0,1,1,2,-0.5,0.5
Marian Staș,adevarul.ro,0,1,3,4,-0.25,0.25
Mephisto,adevarul.ro,0,1,0,1,-1.0,1.0
oportunist,adevarul.ro,0,3,0,3,-1.0,1.0
vânzător,adevarul.ro,0,2,0,2,-1.0,1.0
Csoma Botond,agerpres.ro,0,0,2,2,0.0,0.0
Călin Georgescu,agerpres.ro,0,4,4,8,-0.5,0.5
Cătălina Matei,agerpres.ro,0,0,11,11,0.0,0.0
Georgescu,agerpres.ro,0,3,1,4,-0.75,0.75
Doina Pană,www.antena3.ro,0,1,1,2,-0.5,0.5
Liviu Dragnea,www.antena3.ro,0,3,3,6,-0.5,0.5
Sebi Ghiță,www.antena3.ro,0,1,0,1,-1.0,1.0
Serbia,www.antena3.ro,0,1,7,8,-0.125,0.125
mitoman,www.antena3.ro,0,1,0,1,-1.0,1.0
prieten,www.antena3.ro,8,2,6,16,0.375,0.375
Ogică,www.romaniatv.net,0,1,0,1,-1.0,1.0
Stelian Ogică,www.romaniatv.net,0,2,0,2,-1.0,1.0
nanist,www.romaniatv.net,0,1,0,1,-1.0,1.0
Bogdan Naumescu,www.aktual24.ro,0,0,1,1,0.0,0.0
Bruxelles,www.aktual24.ro,1,1,14,16,0.0,0.0
Capitale,www.aktual24.ro,0,0,7,7,0.0,0.0
Chișinău,www.aktual24.ro,0,2,1,3,-0.6666666666666666,0.6666666666666666
Dominic Fritz,www.aktual24.ro,0,0,3,3,0.0,0.0
Iulian Fota,www.aktual24.ro,0,0,5,5,0.0,0.0
fetită,www.aktual24.ro,0,1,1,2,-0.5,0.5
tră,www.aktual24.ro,0,1,0,1,-1.0,1.0
Romeo Lungu,www.romaniatv.net,0,0,4,4,0.0,0.0
artist,www.romaniatv.net,1,1,1,3,0.0,0.0
Recorder,recorder.ro,0,6,16,22,-0.2727272727272727,0.2727272727272727
Timișoara,www.news.ro,0,0,8,8,0.0,0.0
ambasador,recorder.ro,0,1,4,5,-0.2,0.2
Bill Clinton,recorder.ro,0,0,2,2,0.0,0.0
Cristian Rizea,recorder.ro,0,1,0,1,-1.0,1.0
George W. Bush,recorder.ro,0,1,0,1,-1.0,1.0
Marian Vanghelie,recorder.ro,0,1,1,2,-0.5,0.5
Sorin Ovidiu Vântu,recorder.ro,0,1,0,1,-1.0,1.0
Vanghelie,recorder.ro,0,1,0,1,-1.0,1.0
Viorica Dăncilă,recorder.ro,0,11,10,21,-0.5238095238095238,0.5238095238095238
adjunct,recorder.ro,0,2,2,4,-0.5,0.5
mogul,recorder.ro,0,3,0,3,-1.0,1.0
Geoană,www.antena3.ro,0,2,2,4,-0.5,0.5
Mircea Geoană,www.antena3.ro,0,0,7,7,0.0,0.0
Secretar General Adjunct,www.antena3.ro,0,0,1,1,0.0,0.0
secretar general,www.antena3.ro,0,0,8,8,0.0,0.0
ct,www.antena3.ro,0,0,1,1,0.0,0.0
Washington,www.romaniatv.net,0,2,2,4,-0.5,0.5
Alexandria,pressone.ro,0,0,2,2,0.0,0.0
Bel,pressone.ro,0,0,1,1,0.0,0.0
Belina,pressone.ro,0,1,0,1,-1.0,1.0
Buzău,pressone.ro,0,0,5,5,0.0,0.0
Carmen Dan,pressone.ro,0,2,4,6,-0.3333333333333333,0.3333333333333333
Craiova,pressone.ro,0,0,5,5,0.0,0.0
Don Corleone,pressone.ro,0,1,0,1,-1.0,1.0
Olguța Vasilescu,pressone.ro,0,3,3,6,-0.5,0.5
plumb,pressone.ro,0,0,1,1,0.0,0.0
Rovana Plumb,pressone.ro,0,1,8,9,-0.1111111111111111,0.1111111111111111
Sevil Shhaideh,pressone.ro,0,4,4,8,-0.5,0.5
Shhaideh,pressone.ro,0,3,1,4,-0.75,0.75
Sorin Moisă,pressone.ro,0,1,0,1,-1.0,1.0
Videle,pressone.ro,0,0,1,1,0.0,0.0
a,pressone.ro,0,1,1,2,-0.5,0.5
formator,pressone.ro,0,0,2,2,0.0,0.0
Vasilescu,pressone.ro,0,1,1,2,-0.5,0.5
Akram Shhaideh,pressone.ro,0,0,1,1,0.0,0.0
subprefect,pressone.ro,0,0,4,4,0.0,0.0
Canada,www.aktual24.ro,0,1,3,4,-0.25,0.25
Regatul Unit al Marii Britanii și al Irlandei de Nord,www.aktual24.ro,0,0,1,1,0.0,0.0
Cernavodă,www.cotidianul.ro,0,0,1,1,0.0,0.0
decident,www.cotidianul.ro,0,2,0,2,-1.0,1.0
lucrător,www.cotidianul.ro,0,0,1,1,0.0,0.0
personal,www.cotidianul.ro,0,0,4,4,0.0,0.0
sindicalist,www.cotidianul.ro,0,2,1,3,-0.6666666666666666,0.6666666666666666
Volodimir Zelenski,www.news.ro,0,3,2,5,-0.6,0.6
Washington,www.news.ro,0,4,7,11,-0.36363636363636365,0.36363636363636365
Ecaterina Andronescu,stirileprotv.ro,0,0,2,2,0.0,0.0
Florian Bodog,stirileprotv.ro,0,0,1,1,0.0,0.0
Liviu Pop,stirileprotv.ro,0,0,2,2,0.0,0.0
Lucian Romașcanu,stirileprotv.ro,0,1,5,6,-0.16666666666666666,0.16666666666666666
Pop,stirileprotv.ro,0,1,0,1,-1.0,1.0
Viorica Dăncilă,stirileprotv.ro,0,4,8,12,-0.3333333333333333,0.3333333333333333
Sighiartău,www.cotidianul.ro,0,0,1,1,0.0,0.0
Robert Sighiartău,www.cotidianul.ro,0,1,1,2,-0.5,0.5
Adriana Saftoiu,a1.ro,0,1,1,2,-0.5,0.5
Ceaușescu,a1.ro,0,2,2,4,-0.5,0.5
Mircea Diaconu,a1.ro,0,2,1,3,-0.6666666666666666,0.6666666666666666
salvator,a1.ro,0,1,0,1,-1.0,1.0
șeful statului,a1.ro,0,5,6,11,-0.45454545454545453,0.45454545454545453
Ilfovul,www.gandul.ro,0,0,1,1,0.0,0.0
voluntar,www.gandul.ro,0,0,2,2,0.0,0.0
cuplu,www.gandul.ro,0,0,2,2,0.0,0.0
primar general,www.gandul.ro,0,1,1,2,-0.5,0.5
Lucian Pahonțu,www.mediafax.ro,0,0,1,1,0.0,0.0
Viorica Dăncilă,www.mediafax.ro,0,6,6,12,-0.5,0.5
oaspete,www.mediafax.ro,1,0,0,1,1.0,1.0
procuror,www.mediafax.ro,0,17,6,23,-0.7391304347826086,0.7391304347826086
responsabil,www.mediafax.ro,0,1,0,1,-1.0,1.0
Balș,www.news.ro,0,0,1,1,0.0,0.0
Boloș,www.news.ro,0,1,0,1,-1.0,1.0
Brăești,www.news.ro,0,0,1,1,0.0,0.0
Constantin,www.news.ro,0,0,1,1,0.0,0.0
Golduț,www.news.ro,0,0,1,1,0.0,0.0
Marcel Boloș,www.news.ro,0,0,1,1,0.0,0.0
Neculai Miron,www.news.ro,0,0,1,1,0.0,0.0
Valea Seacă,www.news.ro,0,0,1,1,0.0,0.0
Vasile Butnaru,www.news.ro,0,0,1,1,0.0,0.0
consilier local,www.news.ro,0,0,1,1,0.0,0.0
edil,www.news.ro,0,2,1,3,-0.6666666666666666,0.6666666666666666
Andreea,agerpres.ro,0,0,1,1,0.0,0.0
Angela Merkel,agerpres.ro,0,0,1,1,0.0,0.0
Berlin,agerpres.ro,0,0,1,1,0.0,0.0
Merz,agerpres.ro,0,0,1,1,0.0,0.0
Sorin Popescu,agerpres.ro,0,0,1,1,0.0,0.0
Olaf Scholz,agerpres.ro,0,0,1,1,0.0,0.0
critic,agerpres.ro,0,1,0,1,-1.0,1.0
roșu,agerpres.ro,0,0,1,1,0.0,0.0
șefă,agerpres.ro,0,1,0,1,-1.0,1.0
Dacian Cioloș,www.mediafax.ro,0,0,5,5,0.0,0.0
angajat,www.mediafax.ro,1,1,2,4,0.0,0.0
Remeș,www.mediafax.ro,0,1,0,1,-1.0,1.0
Batman,pressone.ro,0,0,1,1,0.0,0.0
Harry Potter,pressone.ro,0,1,0,1,-1.0,1.0
Vlad Teohari,pressone.ro,0,1,0,1,-1.0,1.0
atârnător,pressone.ro,0,2,0,2,-1.0,1.0
bebeluș,pressone.ro,1,3,2,6,-0.3333333333333333,0.3333333333333333
criminal,pressone.ro,0,3,0,3,-1.0,1.0
delegat,pressone.ro,1,10,9,20,-0.45,0.45
informat,pressone.ro,0,1,0,1,-1.0,1.0
prieteni,pressone.ro,6,2,5,13,0.3076923076923077,0.3076923076923077
rudă,pressone.ro,0,5,3,8,-0.625,0.625
salvator,pressone.ro,3,2,0,5,0.2,0.2
soră,pressone.ro,0,1,1,2,-0.5,0.5
Angela Merkel,www.romaniatv.net,0,0,1,1,0.0,0.0
Nicolae Ceaușescu,www.romaniatv.net,1,2,0,3,-0.3333333333333333,0.3333333333333333
Olanda,www.romaniatv.net,0,2,2,4,-0.5,0.5
populiști,www.romaniatv.net,0,1,0,1,-1.0,1.0
Suedia,www.romaniatv.net,0,1,1,2,-0.5,0.5
Vladimir Putin,www.romaniatv.net,0,6,4,10,-0.6,0.6
adversar,www.romaniatv.net,0,4,2,6,-0.6666666666666666,0.6666666666666666
imigrant,www.romaniatv.net,0,1,0,1,-1.0,1.0
populist,www.romaniatv.net,0,1,0,1,-1.0,1.0
populișt,www.romaniatv.net,0,2,0,2,-1.0,1.0
refugiat,www.romaniatv.net,0,0,1,1,0.0,0.0
Camerun,www.cotidianul.ro,0,0,1,1,0.0,0.0
Emmanuel Kunde,www.cotidianul.ro,0,0,2,2,0.0,0.0
Italia,www.cotidianul.ro,0,0,5,5,0.0,0.0
Kunde,www.cotidianul.ro,0,0,1,1,0.0,0.0
Spania,www.cotidianul.ro,0,0,6,6,0.0,0.0
antrenor,www.cotidianul.ro,0,0,1,1,0.0,0.0
fundaș,www.cotidianul.ro,0,0,1,1,0.0,0.0
internațional,www.cotidianul.ro,0,1,1,2,-0.5,0.5
Anna Adamiak,www.comisarul.ro,0,0,1,1,0.0,0.0
Budapesta,www.comisarul.ro,0,1,3,4,-0.25,0.25
Romanowski,www.comisarul.ro,0,1,0,1,-1.0,1.0
adversar,www.comisarul.ro,0,9,0,9,-1.0,1.0
procuror general,www.comisarul.ro,0,1,0,1,-1.0,1.0
purtător de cuvânt,www.comisarul.ro,0,3,3,6,-0.5,0.5
Cristian Ghinea,www.digi24.ro,0,0,2,2,0.0,0.0
Florina Presadă,www.digi24.ro,0,0,3,3,0.0,0.0
fondator,www.digi24.ro,0,0,2,2,0.0,0.0
Suceava,www.digi24.ro,0,0,1,1,0.0,0.0
Vlad Alexandrescu,www.digi24.ro,0,0,3,3,0.0,0.0
semnatar,www.digi24.ro,0,3,2,5,-0.6,0.6
Petre Lăzăroiu,stirileprotv.ro,0,0,1,1,0.0,0.0
expert,stirileprotv.ro,1,1,0,2,0.0,0.0
judecător,stirileprotv.ro,1,14,13,28,-0.4642857142857143,0.4642857142857143
personal,stirileprotv.ro,0,1,4,5,-0.2,0.2
Downing Street,www.aktual24.ro,0,0,1,1,0.0,0.0
Irlanda de Nord,www.aktual24.ro,0,0,2,2,0.0,0.0
Rwanda,www.aktual24.ro,0,1,0,1,-1.0,1.0
Scotia,www.aktual24.ro,0,0,1,1,0.0,0.0
Starmer,www.aktual24.ro,1,0,1,2,0.5,0.5
Tara Galilor,www.aktual24.ro,0,0,1,1,0.0,0.0
Tony Blair,www.aktual24.ro,0,1,0,1,-1.0,1.0
laburist,www.aktual24.ro,0,0,1,1,0.0,0.0
migrant,www.aktual24.ro,0,1,0,1,-1.0,1.0
Charles al III-lea,www.aktual24.ro,1,0,0,1,1.0,1.0
Ambilly,www.g4media.ro,0,2,0,2,-1.0,1.0
Berlin,www.g4media.ro,0,0,2,2,0.0,0.0
Dan Enache,www.g4media.ro,0,2,0,2,-1.0,1.0
Germania,www.g4media.ro,0,1,9,10,-0.1,0.1
Marea Britanie,www.g4media.ro,0,0,4,4,0.0,0.0
Roma,www.g4media.ro,0,0,2,2,0.0,0.0
diplomat,www.g4media.ro,0,0,1,1,0.0,0.0
Alexandru Muraru,adevarul.ro,0,0,2,2,0.0,0.0
Muraru,adevarul.ro,0,2,0,2,-1.0,1.0
pacifist,adevarul.ro,0,1,0,1,-1.0,1.0
A. Hadfiled,pressone.ro,0,0,1,1,0.0,0.0
Adina Glava,pressone.ro,0,0,1,1,0.0,0.0
Alex Mintz,pressone.ro,0,0,1,1,0.0,0.0
Ciot,pressone.ro,0,1,0,1,-1.0,1.0
Codruța Simina,pressone.ro,0,0,3,3,0.0,0.0
Dorothea Ionescu,pressone.ro,0,0,1,1,0.0,0.0
Gabriela Ciot,pressone.ro,0,1,0,1,-1.0,1.0
Gabrielei Ciot,pressone.ro,0,0,1,1,0.0,0.0
Gent,pressone.ro,0,0,1,1,0.0,0.0
George Poede,pressone.ro,0,0,1,1,0.0,0.0
Iordan Bărbulescu,pressone.ro,0,0,1,1,0.0,0.0
Karl DeRouen Jr,pressone.ro,0,0,1,1,0.0,0.0
Lucian Leuștean,pressone.ro,0,0,1,1,0.0,0.0
Melania Gabriela Ciot,pressone.ro,0,0,1,1,0.0,0.0
Nicolae Păun,pressone.ro,0,0,1,1,0.0,0.0
Octav,pressone.ro,0,2,0,2,-1.0,1.0
Pușcaș,pressone.ro,0,0,1,1,0.0,0.0
S. Smith,pressone.ro,0,0,1,1,0.0,0.0
Soții Ciot,pressone.ro,0,1,0,1,-1.0,1.0
T. Dunne,pressone.ro,0,0,1,1,0.0,0.0
Vasile Pușcaș,pressone.ro,0,1,1,2,-0.5,0.5
autoare,pressone.ro,0,0,4,4,0.0,0.0
conferențiar,pressone.ro,0,0,5,5,0.0,0.0
or,pressone.ro,0,1,1,2,-0.5,0.5
preparator,pressone.ro,0,1,0,1,-1.0,1.0
Daniel David,pressone.ro,0,0,2,2,0.0,0.0
Ioan Aurel Pop,pressone.ro,0,0,1,1,0.0,0.0
profesor universitar,pressone.ro,0,3,4,7,-0.42857142857142855,0.42857142857142855
prorector,pressone.ro,0,1,4,5,-0.2,0.2
redactor,pressone.ro,0,0,4,4,0.0,0.0
Daniel Constantin,www.mediafax.ro,0,1,7,8,-0.125,0.125
Sfânta Maria,www.mediafax.ro,0,0,1,1,0.0,0.0
Alexandru Muraru,www.aktual24.ro,0,1,2,3,-0.3333333333333333,0.3333333333333333
Muraru,www.aktual24.ro,0,2,2,4,-0.5,0.5
mandatar,adevarul.ro,0,1,5,6,-0.16666666666666666,0.16666666666666666
Adina Vălean,www.digi24.ro,0,0,3,3,0.0,0.0
Antonescu,www.digi24.ro,1,3,12,16,-0.125,0.125
Eduard Helvig,www.digi24.ro,0,0,1,1,0.0,0.0
Tulcea,www.digi24.ro,0,0,1,1,0.0,0.0
Virgil Măgureanu,www.digi24.ro,0,0,1,1,0.0,0.0
Vălean,www.digi24.ro,0,0,1,1,0.0,0.0
baron,www.digi24.ro,0,3,0,3,-1.0,1.0
copreședinte,www.digi24.ro,0,0,3,3,0.0,0.0
critic,www.digi24.ro,0,1,0,1,-1.0,1.0
fiu,www.digi24.ro,0,3,2,5,-0.6,0.6
muzeograf,www.digi24.ro,0,0,1,1,0.0,0.0
procuror general,www.digi24.ro,0,1,0,1,-1.0,1.0
Cluj,adevarul.ro,0,1,8,9,-0.1111111111111111,0.1111111111111111
Coleșa,adevarul.ro,0,1,0,1,-1.0,1.0
Câciu,adevarul.ro,0,1,0,1,-1.0,1.0
agresor,adevarul.ro,0,2,0,2,-1.0,1.0
fetă,adevarul.ro,0,1,0,1,-1.0,1.0
mamă,adevarul.ro,1,4,1,6,-0.5,0.5
Alexandr Dughin,recorder.ro,0,0,1,1,0.0,0.0
Andrei Țărnea,recorder.ro,0,0,2,2,0.0,0.0
Georgia,recorder.ro,0,1,4,5,-0.2,0.2
Kosovo,recorder.ro,0,0,1,1,0.0,0.0
Lasconi,recorder.ro,0,2,3,5,-0.4,0.4
Lucian Romașcanu,recorder.ro,0,0,4,4,0.0,0.0
manifestant,recorder.ro,0,3,1,4,-0.75,0.75
Marea Unite,recorder.ro,0,0,1,1,0.0,0.0
Yoon Suk-yeol,recorder.ro,0,0,1,1,0.0,0.0
ideolog,recorder.ro,0,3,0,3,-1.0,1.0
pensionar,recorder.ro,2,10,5,17,-0.47058823529411764,0.47058823529411764
Laurentiu Gidei,www.aktual24.ro,0,1,0,1,-1.0,1.0
Galați,www.aktual24.ro,0,1,3,4,-0.25,0.25
Gidei,www.aktual24.ro,0,1,0,1,-1.0,1.0
Radu Georgescu,www.romaniatv.net,0,2,0,2,-1.0,1.0
Warren Buffett,www.romaniatv.net,0,0,1,1,0.0,0.0
investitor,www.romaniatv.net,1,2,0,3,-0.3333333333333333,0.3333333333333333
Alice Weidel,www.aktual24.ro,0,0,1,1,0.0,0.0
Daniel Tapp,www.aktual24.ro,0,0,1,1,0.0,0.0
Jens Spahn,www.aktual24.ro,0,1,0,1,-1.0,1.0
Koln,www.aktual24.ro,0,0,1,1,0.0,0.0
Olaf Scholz,www.aktual24.ro,0,0,1,1,0.0,0.0
oponent,www.aktual24.ro,0,1,0,1,-1.0,1.0
Spahn,www.aktual24.ro,0,0,1,1,0.0,0.0
Tino Chrupalla,www.aktual24.ro,0,0,1,1,0.0,0.0
vice-lider,www.aktual24.ro,0,1,0,1,-1.0,1.0
Weidel,www.aktual24.ro,0,0,1,1,0.0,0.0
Ancăi Alexandrescu,www.activenews.ro,0,1,1,2,-0.5,0.5
China,www.activenews.ro,0,3,1,4,-0.75,0.75
Coreea de Nord,www.activenews.ro,0,2,0,2,-1.0,1.0
Eugen Sechilă,www.activenews.ro,0,0,1,1,0.0,0.0
Iulian Capsali,www.activenews.ro,0,1,0,1,-1.0,1.0
Rusia,www.activenews.ro,0,11,4,15,-0.7333333333333333,0.7333333333333333
Stegar Dac,www.activenews.ro,0,1,0,1,-1.0,1.0
Toni Greblă,www.activenews.ro,0,2,1,3,-0.6666666666666666,0.6666666666666666
câștigător,www.activenews.ro,0,2,1,3,-0.6666666666666666,0.6666666666666666
simplu,www.activenews.ro,0,1,0,1,-1.0,1.0
Andrei Țăranu,www.romaniatv.net,0,0,1,1,0.0,0.0
cadru universitar,www.romaniatv.net,0,0,1,1,0.0,0.0
analist,www.romaniatv.net,0,1,10,11,-0.09090909090909091,0.09090909090909091
politolog,www.romaniatv.net,0,0,2,2,0.0,0.0
Țăranu,www.romaniatv.net,0,0,1,1,0.0,0.0
Soos,www.news.ro,0,1,0,1,-1.0,1.0
Soos Zoltan,www.news.ro,0,3,0,3,-1.0,1.0
Soós,www.news.ro,0,1,0,1,-1.0,1.0
Zoltán Soós,www.news.ro,0,0,1,1,0.0,0.0
Târgu Mureș,www.news.ro,0,0,1,1,0.0,0.0
administrator,www.news.ro,0,2,1,3,-0.6666666666666666,0.6666666666666666
Soós Zoltán,www.news.ro,0,1,0,1,-1.0,1.0
Adrian Năstase,www.mediafax.ro,0,3,5,8,-0.375,0.375
Florentin Gust,www.mediafax.ro,0,0,1,1,0.0,0.0
Ion Toma,www.mediafax.ro,0,0,2,2,0.0,0.0
Moldovan,www.mediafax.ro,0,0,1,1,0.0,0.0
Radu Coclici,www.mediafax.ro,0,0,1,1,0.0,0.0
Toma,www.mediafax.ro,0,0,1,1,0.0,0.0
apropiat,www.mediafax.ro,0,0,1,1,0.0,0.0
centru,www.aktual24.ro,0,0,1,1,0.0,0.0
europarlamentarul Diana Sosoaca,www.aktual24.ro,0,1,0,1,-1.0,1.0
fost,www.aktual24.ro,0,1,0,1,-1.0,1.0
inlocuitor,www.aktual24.ro,0,3,1,4,-0.75,0.75
militar,www.aktual24.ro,0,0,2,2,0.0,0.0
Florin Cîțu,www.antena3.ro,0,1,0,1,-1.0,1.0
senatoare,www.antena3.ro,0,1,0,1,-1.0,1.0
Șoșoacă,www.antena3.ro,0,1,2,3,-0.3333333333333333,0.3333333333333333
pensionar,www.romaniatv.net,0,6,7,13,-0.46153846153846156,0.46153846153846156
agricultor,www.romaniatv.net,0,1,2,3,-0.3333333333333333,0.3333333333333333
lucrător,www.romaniatv.net,0,2,2,4,-0.5,0.5
magistrat,www.romaniatv.net,0,2,2,4,-0.5,0.5
Geoană,a1.ro,0,4,1,5,-0.8,0.8
Marius Nistor,a1.ro,0,0,2,2,0.0,0.0
grefier,a1.ro,0,1,0,1,-1.0,1.0
Năstase,primanews.ro,0,0,2,2,0.0,0.0
contracandidat,primanews.ro,0,6,1,7,-0.8571428571428571,0.8571428571428571
intermediar,primanews.ro,0,1,0,1,-1.0,1.0
Adrian Năstase,primanews.ro,0,1,1,2,-0.5,0.5
Ciucu,adevarul.ro,1,1,1,3,0.0,0.0
Cosma,adevarul.ro,0,0,1,1,0.0,0.0
Cristian Hrițuc,adevarul.ro,0,0,2,2,0.0,0.0
Nicolae Negrescu,adevarul.ro,0,1,0,1,-1.0,1.0
Galați,adevarul.ro,1,0,2,3,0.3333333333333333,0.3333333333333333
Predoiu,adevarul.ro,0,3,4,7,-0.42857142857142855,0.42857142857142855
comunicator,adevarul.ro,1,0,3,4,0.25,0.25
domnie,adevarul.ro,0,2,1,3,-0.6666666666666666,0.6666666666666666
Buzatu,adevarul.ro,0,1,0,1,-1.0,1.0
Negrescu,adevarul.ro,1,1,0,2,0.0,0.0
Sorin Sighiartău,adevarul.ro,0,1,0,1,-1.0,1.0
Toma,adevarul.ro,1,0,0,1,1.0,1.0
Târziu,adevarul.ro,0,2,0,2,-1.0,1.0
Ciprian Ciucu,adevarul.ro,0,0,3,3,0.0,0.0
greu,adevarul.ro,0,1,0,1,-1.0,1.0
ilitant,adevarul.ro,0,1,0,1,-1.0,1.0
Antonescu,www.luju.ro,0,3,4,7,-0.42857142857142855,0.42857142857142855
Danilet,www.luju.ro,0,1,0,1,-1.0,1.0
Laurei Kovesi,www.luju.ro,1,0,2,3,0.3333333333333333,0.3333333333333333
Monica Macovei,www.luju.ro,0,3,2,5,-0.6,0.6
Cristi Vasilică Danileț,www.luju.ro,0,1,0,1,-1.0,1.0
Ponta,www.luju.ro,0,5,0,5,-1.0,1.0
Traian Băsescu,www.luju.ro,0,6,6,12,-0.5,0.5
Vasilică,www.luju.ro,0,1,0,1,-1.0,1.0
Vasilica Danilet,www.luju.ro,0,1,0,1,-1.0,1.0
admirator,www.luju.ro,0,1,0,1,-1.0,1.0
consilier,www.luju.ro,2,3,3,8,-0.125,0.125
oaie,www.luju.ro,0,1,0,1,-1.0,1.0
pensionar,www.luju.ro,0,6,3,9,-0.6666666666666666,0.6666666666666666
Cristi Vasilica Danilet,www.luju.ro,0,1,1,2,-0.5,0.5
Alex Jones,www.aktual24.ro,0,1,0,1,-1.0,1.0
Marine Le Pen,www.aktual24.ro,0,0,3,3,0.0,0.0
Marion Marechal,www.aktual24.ro,1,0,0,1,1.0,1.0
Matteo Salvini,www.aktual24.ro,0,1,0,1,-1.0,1.0
Nigel Farage,www.aktual24.ro,0,0,1,1,0.0,0.0
Polonia,www.aktual24.ro,0,4,7,11,-0.36363636363636365,0.36363636363636365
Huligan,www.aktual24.ro,0,1,0,1,-1.0,1.0
Pricopie,www.aktual24.ro,0,1,1,2,-0.5,0.5
Remus Pricopie,www.aktual24.ro,0,0,1,1,0.0,0.0
Robert Fico,www.aktual24.ro,0,0,1,1,0.0,0.0
Robert Rico,www.aktual24.ro,0,0,1,1,0.0,0.0
Roman,www.aktual24.ro,0,2,2,4,-0.5,0.5
Santiago Abascal,www.aktual24.ro,0,0,1,1,0.0,0.0
Slovacia,www.aktual24.ro,0,0,2,2,0.0,0.0
ambasador,www.aktual24.ro,0,2,9,11,-0.18181818181818182,0.18181818181818182
rector,www.aktual24.ro,1,1,3,5,0.0,0.0
roman,www.aktual24.ro,0,0,1,1,0.0,0.0
Vlad Voiculescu,www.digi24.ro,0,1,2,3,-0.3333333333333333,0.3333333333333333
Voiculescu,www.digi24.ro,0,1,2,3,-0.3333333333333333,0.3333333333333333
Ciucă,observatornews.ro,0,2,11,13,-0.15384615384615385,0.15384615384615385
reprezentant,observatornews.ro,0,10,20,30,-0.3333333333333333,0.3333333333333333
client,observatornews.ro,0,1,0,1,-1.0,1.0
judecător,observatornews.ro,0,9,9,18,-0.5,0.5
Kiseleff,www.g4media.ro,0,0,1,1,0.0,0.0
Mihai Ghigiu,www.g4media.ro,0,0,2,2,0.0,0.0
femeie,www.g4media.ro,0,1,14,15,-0.06666666666666667,0.06666666666666667
Donald Trump,www.luju.ro,1,14,1,16,-0.8125,0.8125
Emil Boc,www.luju.ro,0,2,1,3,-0.6666666666666666,0.6666666666666666
Florian Coldea,www.luju.ro,0,7,3,10,-0.7,0.7
Ilie Bolojan,www.luju.ro,0,13,4,17,-0.7647058823529411,0.7647058823529411
Klaus Iohannis,www.luju.ro,0,33,10,43,-0.7674418604651163,0.7674418604651163
Ursula,www.luju.ro,0,2,0,2,-1.0,1.0
ambasador,www.luju.ro,0,3,1,4,-0.75,0.75
artizan,www.luju.ro,0,1,0,1,-1.0,1.0
astia,www.luju.ro,0,3,0,3,-1.0,1.0
bărbat,www.luju.ro,1,1,0,2,0.0,0.0
bolnav,www.luju.ro,0,1,0,1,-1.0,1.0
concubină,www.luju.ro,0,1,0,1,-1.0,1.0
dansator,www.luju.ro,0,1,0,1,-1.0,1.0
dezvoltator,www.luju.ro,0,2,0,2,-1.0,1.0
globalist,www.luju.ro,0,1,0,1,-1.0,1.0
guvernant,www.luju.ro,0,1,0,1,-1.0,1.0
independent,www.luju.ro,0,1,0,1,-1.0,1.0
individ,www.luju.ro,1,4,0,5,-0.6,0.6
iubitor,www.luju.ro,0,1,0,1,-1.0,1.0
partener,www.luju.ro,2,1,1,4,0.25,0.25
personaj,www.luju.ro,0,10,0,10,-1.0,1.0
promotor,www.luju.ro,1,1,0,2,0.0,0.0
sorosist,www.luju.ro,0,1,0,1,-1.0,1.0
sul,www.luju.ro,0,1,0,1,-1.0,1.0
userist,www.luju.ro,0,3,0,3,-1.0,1.0
vinovat,www.luju.ro,0,2,0,2,-1.0,1.0
voievoz,www.luju.ro,0,1,0,1,-1.0,1.0
Adrian Teodor Susca,a1.ro,0,0,1,1,0.0,0.0
Ana Maria Patru,a1.ro,0,0,1,1,0.0,0.0
Andrei Micu,a1.ro,0,0,1,1,0.0,0.0
Brașov,a1.ro,0,0,7,7,0.0,0.0
Cezar Florin Burlacu,a1.ro,0,0,1,1,0.0,0.0
Cristina Baturi,a1.ro,0,0,1,1,0.0,0.0
Dacian Tolea,a1.ro,0,1,0,1,-1.0,1.0
Daniel Brinza,a1.ro,0,1,0,1,-1.0,1.0
Elena Porcos,a1.ro,0,0,1,1,0.0,0.0
Elene Udrea,a1.ro,0,3,3,6,-0.5,0.5
Gabriel Rasvan Toader,a1.ro,0,0,1,1,0.0,0.0
Gheorghe Ialomitianu,a1.ro,0,0,2,2,0.0,0.0
Luminița Kohalmi,a1.ro,0,0,1,1,0.0,0.0
mogosoaie,a1.ro,0,1,0,1,-1.0,1.0
Monica Iacob Ridzi,a1.ro,0,1,0,1,-1.0,1.0
Otopeni,a1.ro,0,0,1,1,0.0,0.0
Ioana Liana Pop,a1.ro,0,0,1,1,0.0,0.0
Radulescu,a1.ro,0,1,0,1,-1.0,1.0
Sebastian Lazaroiu,a1.ro,0,2,2,4,-0.5,0.5
Teodor Baconschi,a1.ro,1,1,3,5,0.0,0.0
Valerian Vreme,a1.ro,0,2,0,2,-1.0,1.0
administrator,a1.ro,0,0,4,4,0.0,0.0
coleg,a1.ro,1,4,12,17,-0.17647058823529413,0.17647058823529413
Willian Brinza,a1.ro,0,0,1,1,0.0,0.0
prietena,a1.ro,0,1,1,2,-0.5,0.5
toți,a1.ro,0,1,0,1,-1.0,1.0
Barbu Mateescu,www.activenews.ro,0,0,1,1,0.0,0.0
Iosif Buble,www.activenews.ro,0,1,0,1,-1.0,1.0
Irlanda,www.activenews.ro,0,0,1,1,0.0,0.0
Patrick André de Hillerin,www.activenews.ro,0,0,2,2,0.0,0.0
Marius Pieleanu,www.activenews.ro,0,0,1,1,0.0,0.0
Răzvan Ionescu,www.activenews.ro,0,1,1,2,-0.5,0.5
editor,www.activenews.ro,0,0,1,1,0.0,0.0
Caracal,observatornews.ro,0,1,0,1,-1.0,1.0
Crevedia,observatornews.ro,0,1,0,1,-1.0,1.0
Florin Petre,observatornews.ro,0,0,1,1,0.0,0.0
Ion Doldurea,observatornews.ro,0,1,0,1,-1.0,1.0
,www.gandul.ro,0,3,0,3,-1.0,1.0
Alice Weidel,www.gandul.ro,0,1,1,2,-0.5,0.5
Axel Springer,www.gandul.ro,0,0,1,1,0.0,0.0
Benner,www.gandul.ro,0,0,1,1,0.0,0.0
Călin Goergescu,www.gandul.ro,0,1,0,1,-1.0,1.0
Elon Musk,www.gandul.ro,0,1,2,3,-0.3333333333333333,0.3333333333333333
Eva Marie Kogel,www.gandul.ro,0,0,1,1,0.0,0.0
Farage,www.gandul.ro,0,1,0,1,-1.0,1.0
Frank Walter Steinmeier,www.gandul.ro,0,0,1,1,0.0,0.0
Franța,www.gandul.ro,1,1,6,8,0.0,0.0
Friedrich Merz,www.gandul.ro,0,0,1,1,0.0,0.0
Ioniță,www.gandul.ro,0,1,0,1,-1.0,1.0
Israel,www.gandul.ro,1,5,5,11,-0.36363636363636365,0.36363636363636365
Jan Philipp Burgard,www.gandul.ro,0,0,1,1,0.0,0.0
Kemi Badenoch,www.gandul.ro,0,0,1,1,0.0,0.0
Magdin,www.gandul.ro,0,1,0,1,-1.0,1.0
magnat,www.gandul.ro,0,1,0,1,-1.0,1.0
Marea Britanie,www.gandul.ro,0,2,7,9,-0.2222222222222222,0.2222222222222222
Marietje Schaake,www.gandul.ro,0,0,1,1,0.0,0.0
miliardar,www.gandul.ro,0,4,0,4,-1.0,1.0
Moscova,www.gandul.ro,1,4,1,6,-0.5,0.5
Musk,www.gandul.ro,0,1,1,2,-0.5,0.5
Nigel Farage,www.gandul.ro,0,0,1,1,0.0,0.0
Camil Ungureanu,www.gandul.ro,0,0,1,1,0.0,0.0
Radu Magdin,www.gandul.ro,0,0,1,1,0.0,0.0
Regatul Unit,www.gandul.ro,0,1,2,3,-0.3333333333333333,0.3333333333333333
Schaake,www.gandul.ro,0,0,1,1,0.0,0.0
Scholz,www.gandul.ro,0,0,2,2,0.0,0.0
Sergei Lavrov,www.gandul.ro,0,0,1,1,0.0,0.0
Sorin Ioniță,www.gandul.ro,0,0,1,1,0.0,0.0
Starmer,www.gandul.ro,0,2,1,3,-0.6666666666666666,0.6666666666666666
Thorsten Benner,www.gandul.ro,0,0,1,1,0.0,0.0
Tommy Robinson,www.gandul.ro,0,1,0,1,-1.0,1.0
analist,www.gandul.ro,0,3,9,12,-0.25,0.25
bărbat,www.gandul.ro,0,1,8,9,-0.1111111111111111,0.1111111111111111
cercetător,www.gandul.ro,0,0,1,1,0.0,0.0
cititor,www.gandul.ro,0,1,0,1,-1.0,1.0
fată,www.gandul.ro,0,1,1,2,-0.5,0.5
ideolog,www.gandul.ro,0,1,0,1,-1.0,1.0
personalitate,www.gandul.ro,1,0,4,5,0.2,0.2
prietenă,www.gandul.ro,0,1,0,1,-1.0,1.0
utilizator,www.gandul.ro,1,2,0,3,-0.3333333333333333,0.3333333333333333
Țările de Jos,www.gandul.ro,0,0,1,1,0.0,0.0
Claudiu Târziu,www.cotidianul.ro,0,1,5,6,-0.16666666666666666,0.16666666666666666
târziu,www.cotidianul.ro,0,1,0,1,-1.0,1.0
conducător,www.cotidianul.ro,0,2,0,2,-1.0,1.0
câștigător,www.cotidianul.ro,0,5,4,9,-0.5555555555555556,0.5555555555555556
organizator,www.cotidianul.ro,0,2,0,2,-1.0,1.0
Covasna,www.comisarul.ro,0,0,6,6,0.0,0.0
Harghita,www.comisarul.ro,0,0,6,6,0.0,0.0
Ilfov,www.comisarul.ro,0,1,10,11,-0.09090909090909091,0.09090909090909091
vontanț,www.comisarul.ro,0,1,0,1,-1.0,1.0
cap,recorder.ro,0,1,1,2,-0.5,0.5
minor,recorder.ro,2,7,4,13,-0.38461538461538464,0.38461538461538464
Rareș Petru Stan,www.cotidianul.ro,0,1,0,1,-1.0,1.0
popor,www.cotidianul.ro,4,13,2,19,-0.47368421052631576,0.47368421052631576
procuror,www.cotidianul.ro,0,3,4,7,-0.42857142857142855,0.42857142857142855
Darius Olaru,primanews.ro,0,0,1,1,0.0,0.0
medic,primanews.ro,1,0,4,5,0.2,0.2
Olaru,primanews.ro,0,0,1,1,0.0,0.0
mijlocaș,primanews.ro,0,1,0,1,-1.0,1.0
Făurești,www.antena3.ro,0,0,1,1,0.0,0.0
Popescu,www.antena3.ro,0,0,1,1,0.0,0.0
Sebastian Constantin Popescu,www.antena3.ro,0,0,2,2,0.0,0.0
Sebastian Popescu,www.antena3.ro,0,0,2,2,0.0,0.0
Vâlcea,www.antena3.ro,0,0,2,2,0.0,0.0
întreprinzător,www.antena3.ro,1,0,0,1,1.0,1.0
Anderson,adevarul.ro,0,0,1,1,0.0,0.0
Cristine Andreson,adevarul.ro,0,0,1,1,0.0,0.0
Lazarus,adevarul.ro,0,0,1,1,0.0,0.0
Luis Lazarus,adevarul.ro,0,0,1,1,0.0,0.0
Sofia,adevarul.ro,0,0,2,2,0.0,0.0
ați,adevarul.ro,0,0,1,1,0.0,0.0
neă,adevarul.ro,0,0,1,1,0.0,0.0
polițist,adevarul.ro,1,6,11,18,-0.2777777777777778,0.2777777777777778
Ana Birchall,pressone.ro,0,0,5,5,0.0,0.0
Anei Birchall,pressone.ro,0,0,1,1,0.0,0.0
Birchall,pressone.ro,0,0,3,3,0.0,0.0
Denise Rifai,pressone.ro,0,0,1,1,0.0,0.0
Gabriela Crețu,pressone.ro,0,1,1,2,-0.5,0.5
civil,pressone.ro,0,0,3,3,0.0,0.0
Dan,pressone.ro,1,1,4,6,0.0,0.0
el,pressone.ro,0,1,0,1,-1.0,1.0
operator,pressone.ro,0,1,0,1,-1.0,1.0
Stalin,pressone.ro,0,2,0,2,-1.0,1.0
Bogdan Ciucă,www.mediafax.ro,0,0,1,1,0.0,0.0
prefect,www.mediafax.ro,0,1,1,2,-0.5,0.5
Abbas Araghchi,www.mediafax.ro,0,0,1,1,0.0,0.0
Araghchi,www.mediafax.ro,0,0,1,1,0.0,0.0
Iran,www.mediafax.ro,0,2,2,4,-0.5,0.5
Muscat,www.mediafax.ro,0,0,1,1,0.0,0.0
Oman,www.mediafax.ro,0,0,1,1,0.0,0.0
expert,www.mediafax.ro,0,0,4,4,0.0,0.0
Bota,www.comisarul.ro,0,1,0,1,-1.0,1.0
Cluj Napoca,www.comisarul.ro,0,0,2,2,0.0,0.0
Cătălin Urtoi,www.comisarul.ro,0,0,1,1,0.0,0.0
Ion Cosmin Petrescu,www.comisarul.ro,0,0,1,1,0.0,0.0
Maramureș,www.comisarul.ro,0,0,4,4,0.0,0.0
milionar,www.comisarul.ro,0,1,0,1,-1.0,1.0
Mitrea Bota,www.comisarul.ro,0,0,1,1,0.0,0.0
Oradea,www.comisarul.ro,1,0,4,5,0.2,0.2
Sorin Bota,www.comisarul.ro,0,1,0,1,-1.0,1.0
Sorin Marius Ovidiu Bota,www.comisarul.ro,0,0,1,1,0.0,0.0
Valea Dragului,www.comisarul.ro,0,0,1,1,0.0,0.0
bugetar,www.comisarul.ro,0,7,0,7,-1.0,1.0
coordonator,www.comisarul.ro,0,0,3,3,0.0,0.0
Miron Mitrea,www.comisarul.ro,0,1,0,1,-1.0,1.0
secretar de stat,www.comisarul.ro,0,0,1,1,0.0,0.0
senator,www.comisarul.ro,1,8,12,21,-0.3333333333333333,0.3333333333333333
Ciprian Ciucu,www.comisarul.ro,0,0,3,3,0.0,0.0
Clotilde Armand,www.comisarul.ro,0,0,2,2,0.0,0.0
Daniel Buda,www.comisarul.ro,0,0,1,1,0.0,0.0
Mihai Enache,www.comisarul.ro,0,0,2,2,0.0,0.0
Siegfried Mureșan,www.comisarul.ro,0,1,1,2,-0.5,0.5
Stelian Ion,www.comisarul.ro,0,1,3,4,-0.25,0.25
client,www.comisarul.ro,1,2,1,4,-0.25,0.25
Bachide,pressone.ro,0,0,1,1,0.0,0.0
Cristian Seidler,pressone.ro,0,0,1,1,0.0,0.0
Dogaru,pressone.ro,0,4,0,4,-1.0,1.0
Eduard Bachide,pressone.ro,0,0,1,1,0.0,0.0
George Calin Virgil Guran,pressone.ro,0,0,1,1,0.0,0.0
Grecia,pressone.ro,0,4,6,10,-0.4,0.4
Guran,pressone.ro,0,0,1,1,0.0,0.0
Ion Rotaru,pressone.ro,0,0,1,1,0.0,0.0
Marcel Boloș,pressone.ro,0,0,1,1,0.0,0.0
Mircea Dogaru,pressone.ro,0,0,3,3,0.0,0.0
secretari,pressone.ro,0,1,0,1,-1.0,1.0
Seidler,pressone.ro,0,0,1,1,0.0,0.0
Spania,pressone.ro,1,1,6,8,0.0,0.0
Virgil Guran,pressone.ro,0,0,2,2,0.0,0.0
vorbitor,pressone.ro,0,7,6,13,-0.5384615384615384,0.5384615384615384
magistrat,pressone.ro,0,3,8,11,-0.2727272727272727,0.2727272727272727
militar,pressone.ro,0,3,6,9,-0.3333333333333333,0.3333333333333333
procuror general,pressone.ro,0,2,2,4,-0.5,0.5
Pălărie,pressone.ro,0,1,0,1,-1.0,1.0
Ștefan Pălărie,pressone.ro,0,0,1,1,0.0,0.0
Anastase,a1.ro,0,2,1,3,-0.6666666666666666,0.6666666666666666
Barosso,a1.ro,0,1,0,1,-1.0,1.0
Buzek,a1.ro,0,1,0,1,-1.0,1.0
Dusa,a1.ro,0,1,0,1,-1.0,1.0
Mircea Dușa,a1.ro,0,0,1,1,0.0,0.0
Mircea Toader,a1.ro,0,0,1,1,0.0,0.0
Tokes,a1.ro,0,2,0,2,-1.0,1.0
ziarist,a1.ro,0,1,1,2,-0.5,0.5
Vasile Blaga,www.digi24.ro,1,0,4,5,0.2,0.2
frate,recorder.ro,3,4,3,10,-0.1,0.1
ă,recorder.ro,0,1,0,1,-1.0,1.0
Nicolae Ciucă,www.comisarul.ro,0,2,9,11,-0.18181818181818182,0.18181818181818182
Alexandru Rafila,pressone.ro,0,1,2,3,-0.3333333333333333,0.3333333333333333
Cristian Nistor,pressone.ro,0,1,0,1,-1.0,1.0
Prahova,pressone.ro,1,1,9,11,0.0,0.0
Roxana Nițescu,pressone.ro,0,0,1,1,0.0,0.0
Silviu Matei,pressone.ro,0,0,1,1,0.0,0.0
Sorin Lupșa,pressone.ro,0,1,0,1,-1.0,1.0
Tetris,pressone.ro,0,0,1,1,0.0,0.0
Tomac,pressone.ro,0,1,0,1,-1.0,1.0
Vaslui,pressone.ro,0,2,6,8,-0.25,0.25
Votanțiu,pressone.ro,0,4,1,5,-0.8,0.8
non,pressone.ro,0,1,0,1,-1.0,1.0
sociolog,pressone.ro,0,2,5,7,-0.2857142857142857,0.2857142857142857
analist,stirileprotv.ro,0,4,6,10,-0.4,0.4
Conor McGregor,www.realitatea.net,0,1,0,1,-1.0,1.0
Elisabeth Warren,www.realitatea.net,0,0,1,1,0.0,0.0
Franța,www.realitatea.net,0,1,3,4,-0.25,0.25
Ilhan Omar,www.realitatea.net,0,0,1,1,0.0,0.0
Irlanda,www.realitatea.net,0,0,2,2,0.0,0.0
Joe Biden,www.realitatea.net,1,0,2,3,0.3333333333333333,0.3333333333333333
Kamala Harris,www.realitatea.net,0,0,1,1,0.0,0.0
Marine Le Pen,www.realitatea.net,0,1,0,1,-1.0,1.0
Rob Fynnerty,www.realitatea.net,0,0,1,1,0.0,0.0
Ungaria,www.realitatea.net,0,1,0,1,-1.0,1.0
extremist,www.realitatea.net,0,1,0,1,-1.0,1.0
invitat,www.realitatea.net,0,1,0,1,-1.0,1.0
Viktor Orban,www.realitatea.net,0,1,1,2,-0.5,0.5
protestatar,www.realitatea.net,0,2,2,4,-0.5,0.5
Mary Jordan,a1.ro,0,0,1,1,0.0,0.0
Jordan,a1.ro,0,0,1,1,0.0,0.0
Kate Bennett,a1.ro,0,0,1,1,0.0,0.0
Marian Robinson,a1.ro,0,0,1,1,0.0,0.0
Melaniei,a1.ro,0,1,2,3,-0.3333333333333333,0.3333333333333333
Michael Wolff,a1.ro,0,0,1,1,0.0,0.0
Michelle Obama,a1.ro,1,0,3,4,0.25,0.25
Prima doamnă,a1.ro,0,1,1,2,-0.5,0.5
stat,a1.ro,0,0,1,1,0.0,0.0
autoare,a1.ro,0,0,2,2,0.0,0.0
menajer,a1.ro,0,1,0,1,-1.0,1.0
personal,a1.ro,0,0,2,2,0.0,0.0
Caragiale,recorder.ro,0,0,1,1,0.0,0.0
Pielești,recorder.ro,0,1,0,1,-1.0,1.0
executant,recorder.ro,0,1,0,1,-1.0,1.0
localnic,recorder.ro,0,4,2,6,-0.6666666666666666,0.6666666666666666
Irinel Irimescu,recorder.ro,0,1,0,1,-1.0,1.0
Alexandru Mocanu,recorder.ro,0,0,1,1,0.0,0.0
Corin Lunganu,recorder.ro,0,0,1,1,0.0,0.0
Dobronăuțeanu,recorder.ro,0,1,0,1,-1.0,1.0
Fișcuci,recorder.ro,0,1,0,1,-1.0,1.0
Florida,recorder.ro,0,0,2,2,0.0,0.0
Leon,recorder.ro,0,0,1,1,0.0,0.0
Marian Fișcuci,recorder.ro,0,0,1,1,0.0,0.0
Petre Roman,recorder.ro,0,3,0,3,-1.0,1.0
Silviu Mina Dobronăuțeanu,recorder.ro,0,0,2,2,0.0,0.0
anchetator,recorder.ro,0,2,0,2,-1.0,1.0
bonică,recorder.ro,0,1,0,1,-1.0,1.0
colindător,recorder.ro,0,1,0,1,-1.0,1.0
cărăuș,recorder.ro,0,1,0,1,-1.0,1.0
interpuși,recorder.ro,0,1,0,1,-1.0,1.0
majoritate,recorder.ro,0,1,0,1,-1.0,1.0
ofertant,recorder.ro,0,1,0,1,-1.0,1.0
paparazzo,recorder.ro,0,1,0,1,-1.0,1.0
patron,recorder.ro,0,7,0,7,-1.0,1.0
personalitate,recorder.ro,0,1,4,5,-0.2,0.2
subaltern,recorder.ro,0,4,0,4,-1.0,1.0
teleormănit,recorder.ro,0,1,0,1,-1.0,1.0
Dan Voiculescu,www.romaniatv.net,0,0,2,2,0.0,0.0
MI,www.romaniatv.net,0,0,1,1,0.0,0.0
copil,www.romaniatv.net,8,4,14,26,0.15384615384615385,0.15384615384615385
elector,www.romaniatv.net,0,0,1,1,0.0,0.0
er,www.romaniatv.net,0,0,1,1,0.0,0.0
ul,www.romaniatv.net,0,0,1,1,0.0,0.0
victimă,www.romaniatv.net,0,1,4,5,-0.2,0.2
Aleksei Rakșa,www.comisarul.ro,0,0,1,1,0.0,0.0
Rakșa,www.comisarul.ro,0,1,0,1,-1.0,1.0
Rosstat,www.comisarul.ro,0,1,0,1,-1.0,1.0
demograf,www.comisarul.ro,0,1,0,1,-1.0,1.0
Daniel Constantin,a1.ro,0,1,1,2,-0.5,0.5
Târgoviște,a1.ro,0,0,1,1,0.0,0.0
Vasile Blaga,a1.ro,0,4,2,6,-0.6666666666666666,0.6666666666666666
simpatizant,a1.ro,0,1,0,1,-1.0,1.0
Bogdan Matei,www.b1tv.ro,0,0,1,1,0.0,0.0
Lucian Heiuș,www.b1tv.ro,0,0,1,1,0.0,0.0
senator,www.b1tv.ro,1,1,10,12,0.0,0.0
Nicolae Ciucă,www.cotidianul.ro,0,6,9,15,-0.4,0.4
cadru,www.cotidianul.ro,0,1,1,2,-0.5,0.5
militar,www.cotidianul.ro,0,0,1,1,0.0,0.0
pensionar,www.cotidianul.ro,0,1,3,4,-0.25,0.25
Andrei Postolache,pressone.ro,0,0,3,3,0.0,0.0
Burduja,pressone.ro,0,1,0,1,-1.0,1.0
cioloș,pressone.ro,2,3,6,11,-0.09090909090909091,0.09090909090909091
Dan Mașca,pressone.ro,0,0,3,3,0.0,0.0
Magdin,pressone.ro,0,1,0,1,-1.0,1.0
Mașca,pressone.ro,0,1,1,2,-0.5,0.5
Radu Magdin,pressone.ro,0,0,1,1,0.0,0.0
Sebastian Burduja,pressone.ro,0,1,4,5,-0.2,0.2
Târgu Mureș,pressone.ro,0,0,7,7,0.0,0.0
Valérie Villemin,pressone.ro,0,0,1,1,0.0,0.0
analist politic,pressone.ro,0,0,1,1,0.0,0.0
anie,pressone.ro,0,1,0,1,-1.0,1.0
nume,pressone.ro,0,0,1,1,0.0,0.0
oponent,pressone.ro,0,4,0,4,-1.0,1.0
Antonio Goleac,recorder.ro,0,2,0,2,-1.0,1.0
Codrin Ștefănescu,recorder.ro,0,1,1,2,-0.5,0.5
Cristian Popescu Piedone,recorder.ro,0,0,4,4,0.0,0.0
Marian Goleac,recorder.ro,0,0,1,1,0.0,0.0
Matilda Goleac,recorder.ro,0,0,1,1,0.0,0.0
Mihai Mitrache,recorder.ro,0,1,0,1,-1.0,1.0
Paul Ene,recorder.ro,0,0,1,1,0.0,0.0
Băluță,recorder.ro,0,1,1,2,-0.5,0.5
Puiu Florian,recorder.ro,0,1,0,1,-1.0,1.0
Robert Nica,recorder.ro,0,1,0,1,-1.0,1.0
sector,recorder.ro,0,1,2,3,-0.3333333333333333,0.3333333333333333
Vlad Popescu Piedone,recorder.ro,0,0,1,1,0.0,0.0
interlop,recorder.ro,0,5,0,5,-1.0,1.0
refugiat,recorder.ro,1,3,0,4,-0.5,0.5
M,pressone.ro,0,1,1,2,-0.5,0.5
vânzător,pressone.ro,0,1,1,2,-0.5,0.5
Bogdan Nica,www.luju.ro,0,0,1,1,0.0,0.0
Cristian Diaconescu,www.luju.ro,0,0,1,1,0.0,0.0
Gabriel Tudoran,www.luju.ro,0,0,1,1,0.0,0.0
George Șerban,www.luju.ro,0,0,1,1,0.0,0.0
Mircea Rosca,www.luju.ro,0,0,1,1,0.0,0.0
Norica Nicolai,www.luju.ro,0,0,1,1,0.0,0.0
Oana Tanasica,www.luju.ro,0,0,1,1,0.0,0.0
Rodica Papuc,www.luju.ro,0,0,1,1,0.0,0.0
Secretar de stat,www.luju.ro,0,0,1,1,0.0,0.0
Serban,www.luju.ro,0,0,1,1,0.0,0.0
Tudorel Toader,www.luju.ro,0,0,3,3,0.0,0.0
Valeriu Stoica,www.luju.ro,0,2,1,3,-0.6666666666666666,0.6666666666666666
George Cătălin Șerban,www.luju.ro,0,0,1,1,0.0,0.0
George Serban,www.luju.ro,0,0,1,1,0.0,0.0
parlamentar,www.luju.ro,0,6,3,9,-0.6666666666666666,0.6666666666666666
Constanța,www.antena3.ro,0,0,3,3,0.0,0.0
expert,www.antena3.ro,1,3,4,8,-0.25,0.25
Predoiu,www.antena3.ro,0,0,3,3,0.0,0.0
Silviu Predoiu,www.antena3.ro,0,0,2,2,0.0,0.0
general,www.antena3.ro,0,0,2,2,0.0,0.0
locotenent,www.antena3.ro,0,0,1,1,0.0,0.0
manager,www.antena3.ro,0,0,3,3,0.0,0.0
ofițer,www.antena3.ro,0,6,1,7,-0.8571428571428571,0.8571428571428571
Florian Bodog,www.mediafax.ro,0,1,0,1,-1.0,1.0
Liviu Marian Pop,www.mediafax.ro,0,0,1,1,0.0,0.0
Răzvan Cuc,www.mediafax.ro,0,1,0,1,-1.0,1.0
student,www.mediafax.ro,0,1,2,3,-0.3333333333333333,0.3333333333333333
elev,www.mediafax.ro,0,1,1,2,-0.5,0.5
medic,www.mediafax.ro,0,1,3,4,-0.25,0.25
rezident,www.mediafax.ro,0,2,0,2,-1.0,1.0
Elena Lasconi,www.realitatea.net,0,3,21,24,-0.125,0.125
apropiat,www.realitatea.net,1,4,1,6,-0.5,0.5
Dl Georgescu,www.realitatea.net,0,1,0,1,-1.0,1.0
personalitate,www.realitatea.net,1,0,0,1,1.0,1.0
telespectator,www.realitatea.net,0,1,0,1,-1.0,1.0
America,www.antena3.ro,0,2,3,5,-0.4,0.4
Donald Trump Jr.,www.antena3.ro,0,1,0,1,-1.0,1.0
Statele Unite ale Americii,www.antena3.ro,2,0,5,7,0.2857142857142857,0.2857142857142857
demnitar,www.antena3.ro,0,2,0,2,-1.0,1.0
entuzias,www.antena3.ro,0,1,0,1,-1.0,1.0
fan,www.antena3.ro,0,4,0,4,-1.0,1.0
fruntaș,www.antena3.ro,0,1,0,1,-1.0,1.0
Alexandru Muraru,stirileprotv.ro,0,0,2,2,0.0,0.0
Attila Cseke,stirileprotv.ro,0,0,4,4,0.0,0.0
Emil Boc,stirileprotv.ro,0,4,4,8,-0.5,0.5
Emil Hurezeanu,stirileprotv.ro,0,0,3,3,0.0,0.0
Fritz,www.news.ro,0,1,7,8,-0.125,0.125
Cseke,www.mediafax.ro,0,0,1,1,0.0,0.0
Attila Cseke,www.mediafax.ro,0,0,3,3,0.0,0.0
București,agerpres.ro,1,3,18,22,-0.09090909090909091,0.09090909090909091
Guver,agerpres.ro,0,0,1,1,0.0,0.0
guvern,agerpres.ro,0,1,1,2,-0.5,0.5
Gorj,agerpres.ro,0,0,1,1,0.0,0.0
Horia,agerpres.ro,0,0,1,1,0.0,0.0
Neamț,agerpres.ro,0,2,1,3,-0.6666666666666666,0.6666666666666666
Paris,agerpres.ro,0,0,1,1,0.0,0.0
Pinoasa,agerpres.ro,0,1,0,1,-1.0,1.0
Timișean,agerpres.ro,0,0,1,1,0.0,0.0
VER,agerpres.ro,0,0,1,1,0.0,0.0
VERN,agerpres.ro,0,0,1,1,0.0,0.0
Liviu Dragnea,www.realitatea.net,0,2,0,2,-1.0,1.0
alții,www.realitatea.net,0,1,1,2,-0.5,0.5
Diana Sosoaca,www.realitatea.net,0,1,0,1,-1.0,1.0
doamnă,www.realitatea.net,0,2,3,5,-0.4,0.4
om de stat,www.realitatea.net,1,0,0,1,1.0,1.0
Jonathan Reynolds,www.mediafax.ro,0,0,1,1,0.0,0.0
Keir Starmer,www.mediafax.ro,0,0,1,1,0.0,0.0
Lucy Powell,www.mediafax.ro,0,0,1,1,0.0,0.0
Marea Britanie,www.mediafax.ro,1,0,2,3,0.3333333333333333,0.3333333333333333
Reynolds,www.mediafax.ro,0,0,1,1,0.0,0.0
Scunthorpe,www.mediafax.ro,0,0,1,1,0.0,0.0
prim-ministru,www.euronews.ro,1,2,11,14,-0.07142857142857142,0.07142857142857142
Capitale,snoop.ro,0,0,7,7,0.0,0.0
Cipru,snoop.ro,0,2,3,5,-0.4,0.4
Ciucă,snoop.ro,0,2,4,6,-0.3333333333333333,0.3333333333333333
Elena Lasconi,snoop.ro,0,1,8,9,-0.1111111111111111,0.1111111111111111
Lasconi,snoop.ro,0,2,2,4,-0.5,0.5
Nicolae Ciucă,snoop.ro,0,2,18,20,-0.1,0.1
Nicușor Dan,snoop.ro,0,1,8,9,-0.1111111111111111,0.1111111111111111
Simion,snoop.ro,1,4,3,8,-0.375,0.375
DJ,www.aktual24.ro,0,0,1,1,0.0,0.0
Dan Ghita,www.aktual24.ro,0,0,1,1,0.0,0.0
Lucian Patrascu,www.aktual24.ro,0,0,1,1,0.0,0.0
realizator,www.aktual24.ro,0,1,2,3,-0.3333333333333333,0.3333333333333333
subprefect,www.aktual24.ro,0,0,1,1,0.0,0.0
Berbești,recorder.ro,0,0,1,1,0.0,0.0
Băile Govora,recorder.ro,0,1,0,1,-1.0,1.0
Băile Olănești,recorder.ro,0,1,0,1,-1.0,1.0
Cazan Laurențiu Nicolae,recorder.ro,0,0,1,1,0.0,0.0
Constantin Rădulescu,recorder.ro,0,0,1,1,0.0,0.0
Cristian Buican,recorder.ro,0,0,1,1,0.0,0.0
Daniel Goleman,recorder.ro,0,0,1,1,0.0,0.0
Drăgășani,recorder.ro,0,0,1,1,0.0,0.0
Henry Troia,recorder.ro,0,0,1,1,0.0,0.0
Jonathan Steinberg,recorder.ro,0,0,1,1,0.0,0.0
Laurențiu Nicolae Cazan,recorder.ro,0,0,1,1,0.0,0.0
Marian Lazăr,recorder.ro,0,0,1,1,0.0,0.0
Martti Larni,recorder.ro,0,0,1,1,0.0,0.0
Robin Sharma,recorder.ro,0,0,2,2,0.0,0.0
Victor George Stănculescu,recorder.ro,0,0,1,1,0.0,0.0
Voineasa,recorder.ro,0,1,0,1,-1.0,1.0
contribuabil,recorder.ro,1,1,0,2,0.0,0.0
erou,recorder.ro,1,1,1,3,0.0,0.0
fetiță,recorder.ro,0,1,3,4,-0.25,0.25
investitor,recorder.ro,7,2,3,12,0.4166666666666667,0.4166666666666667
moșnean,recorder.ro,0,1,0,1,-1.0,1.0
proprietarii,recorder.ro,0,2,0,2,-1.0,1.0
Armand,www.mediafax.ro,0,2,0,2,-1.0,1.0
Fritz,www.mediafax.ro,0,1,1,2,-0.5,0.5
Moșteanu,www.mediafax.ro,0,0,3,3,0.0,0.0
Ciprian Necula,www.mediafax.ro,0,0,4,4,0.0,0.0
Daniel Fenechiu,stirileprotv.ro,0,0,1,1,0.0,0.0
Fenechiu,stirileprotv.ro,0,1,0,1,-1.0,1.0
celor,stirileprotv.ro,0,2,0,2,-1.0,1.0
prieteni,stirileprotv.ro,1,0,2,3,0.3333333333333333,0.3333333333333333
simpatizant,stirileprotv.ro,1,1,0,2,0.0,0.0
Adina Vălean,adevarul.ro,0,0,6,6,0.0,0.0
comisar,adevarul.ro,0,2,7,9,-0.2222222222222222,0.2222222222222222
Ioan Mircea Pașcu,adevarul.ro,0,0,1,1,0.0,0.0
Siegfried Mureșan,adevarul.ro,1,0,3,4,0.25,0.25
Weber,adevarul.ro,0,1,1,2,-0.5,0.5
bărbat,www.comisarul.ro,0,7,10,17,-0.4117647058823529,0.4117647058823529
voluntar,www.comisarul.ro,1,3,3,7,-0.2857142857142857,0.2857142857142857
Alfred Simonis,recorder.ro,0,0,3,3,0.0,0.0
Antonescu,recorder.ro,0,0,1,1,0.0,0.0
Egipt,recorder.ro,0,2,0,2,-1.0,1.0
Florin,recorder.ro,0,0,2,2,0.0,0.0
Gheorghe,recorder.ro,0,1,1,2,-0.5,0.5
Lucian Bode,recorder.ro,0,0,3,3,0.0,0.0
Madrid,recorder.ro,0,0,2,2,0.0,0.0
Nicolae,recorder.ro,0,0,2,2,0.0,0.0
Nisa,recorder.ro,0,0,2,2,0.0,0.0
acționar,recorder.ro,0,3,2,5,-0.6,0.6
campion,recorder.ro,2,1,0,3,0.3333333333333333,0.3333333333333333
corespondent,recorder.ro,0,0,3,3,0.0,0.0
frați,recorder.ro,0,2,0,2,-1.0,1.0
prietenă,recorder.ro,0,1,0,1,-1.0,1.0
păgubitor,recorder.ro,0,1,0,1,-1.0,1.0
soț,recorder.ro,0,6,5,11,-0.5454545454545454,0.5454545454545454
votant,www.realitatea.net,0,2,3,5,-0.4,0.4
Teleormăn,recorder.ro,0,2,0,2,-1.0,1.0
Uniunea,recorder.ro,0,2,1,3,-0.6666666666666666,0.6666666666666666
bătrân,recorder.ro,0,3,1,4,-0.75,0.75
femeie,recorder.ro,9,14,30,53,-0.09433962264150944,0.09433962264150944
tătuca,recorder.ro,0,1,0,1,-1.0,1.0
cunoștință,www.news.ro,1,0,0,1,1.0,1.0
român,www.romaniatv.net,0,0,3,3,0.0,0.0
adult,www.romaniatv.net,0,1,1,2,-0.5,0.5
ministră,www.romaniatv.net,0,1,0,1,-1.0,1.0
Dumnezeu,www.news.ro,4,1,2,7,0.42857142857142855,0.42857142857142855
bărbat,www.news.ro,0,0,1,1,0.0,0.0
prieteni,www.news.ro,2,0,2,4,0.5,0.5
Armand,www.news.ro,0,1,0,1,-1.0,1.0
Daniel Petru Funeriu,adevarul.ro,0,0,1,1,0.0,0.0
donator,adevarul.ro,0,0,2,2,0.0,0.0
Ion Banu Muscel,adevarul.ro,0,0,2,2,0.0,0.0
Alexandru Rafila,www.gandul.ro,0,0,3,3,0.0,0.0
cunoscut,www.gandul.ro,0,0,1,1,0.0,0.0
frate,www.gandul.ro,1,0,1,2,0.5,0.5
Cristian Palade,www.mediafax.ro,0,0,1,1,0.0,0.0
Culiță Chiș,www.mediafax.ro,0,1,0,1,-1.0,1.0
Dan Diaconu,www.mediafax.ro,0,0,1,1,0.0,0.0
Nicolae Robu,www.mediafax.ro,0,1,0,1,-1.0,1.0
Robu,www.mediafax.ro,2,0,0,2,1.0,1.0
domnie,www.mediafax.ro,1,3,1,5,-0.4,0.4
suspect,www.mediafax.ro,0,3,0,3,-1.0,1.0
Constantin Lupu,www.euronews.ro,0,1,0,1,-1.0,1.0
greblă,www.euronews.ro,0,1,1,2,-0.5,0.5
Toni Greblă,www.euronews.ro,0,3,1,4,-0.75,0.75
Vajda Zsombor,www.euronews.ro,0,0,1,1,0.0,0.0
Mihai Lupu,recorder.ro,0,1,0,1,-1.0,1.0
Nottingham,recorder.ro,0,0,1,1,0.0,0.0
Cotroceni,www.mediafax.ro,0,0,2,2,0.0,0.0
coleg,www.realitatea.net,5,4,1,10,0.1,0.1
lăutar,www.realitatea.net,0,1,0,1,-1.0,1.0
mandat,www.realitatea.net,0,1,0,1,-1.0,1.0
preot,www.realitatea.net,0,1,0,1,-1.0,1.0
Bode,www.gandul.ro,0,1,1,2,-0.5,0.5
Lucian Bode,www.gandul.ro,0,0,6,6,0.0,0.0
Lucian Bude,www.gandul.ro,0,0,1,1,0.0,0.0
Modrogan,www.gandul.ro,0,0,1,1,0.0,0.0
Mănăstire,www.gandul.ro,0,0,1,1,0.0,0.0
Răzvan Săndulescu,www.gandul.ro,0,0,1,1,0.0,0.0
Silviu Mănăstire,www.gandul.ro,0,0,2,2,0.0,0.0
Valentin Ștefan,www.gandul.ro,0,0,1,1,0.0,0.0
consultant,www.gandul.ro,0,0,6,6,0.0,0.0
Dan Motreanu,www.gandul.ro,0,0,2,2,0.0,0.0
fondator,www.gandul.ro,2,0,1,3,0.6666666666666666,0.6666666666666666
greu,www.gandul.ro,0,1,0,1,-1.0,1.0
iubit,www.gandul.ro,0,1,1,2,-0.5,0.5
Victor Paul Dobre,www.gandul.ro,0,0,1,1,0.0,0.0
secretar,www.gandul.ro,0,1,8,9,-0.1111111111111111,0.1111111111111111
Mihai Albulescu,www.aktual24.ro,0,0,1,1,0.0,0.0
Negrescu,www.aktual24.ro,1,0,3,4,0.25,0.25
Victor Negrescu,www.aktual24.ro,1,0,6,7,0.14285714285714285,0.14285714285714285
comisar,www.aktual24.ro,0,2,1,3,-0.6666666666666666,0.6666666666666666
doctor,www.aktual24.ro,2,0,1,3,0.6666666666666666,0.6666666666666666
Constantin Nita,www.aktual24.ro,0,0,1,1,0.0,0.0
responsabil,www.aktual24.ro,0,3,0,3,-1.0,1.0
secretar de stat,www.aktual24.ro,0,3,4,7,-0.42857142857142855,0.42857142857142855
Codrin Ștefănescu,www.mediafax.ro,0,0,1,1,0.0,0.0
Cătălin Rădulescu,www.mediafax.ro,0,2,3,5,-0.4,0.4
Dumitru Buzatu,www.mediafax.ro,0,0,1,1,0.0,0.0
Firea,www.mediafax.ro,0,1,2,3,-0.3333333333333333,0.3333333333333333
Gabriela Firea,www.mediafax.ro,0,4,4,8,-0.5,0.5
Ilfov,www.mediafax.ro,0,1,1,2,-0.5,0.5
primar general,www.mediafax.ro,0,3,4,7,-0.42857142857142855,0.42857142857142855
miniștri,www.mediafax.ro,1,6,3,10,-0.5,0.5
Bolojan,www.digi24.ro,0,0,17,17,0.0,0.0
Galați,www.digi24.ro,0,0,2,2,0.0,0.0
Turcia,www.digi24.ro,0,0,5,5,0.0,0.0
șef interimar,www.digi24.ro,0,0,2,2,0.0,0.0
Franța,www.b1tv.ro,1,1,1,3,0.0,0.0
Germania,www.b1tv.ro,0,0,4,4,0.0,0.0
Italia,www.b1tv.ro,0,0,2,2,0.0,0.0
Suceava,www.b1tv.ro,0,0,1,1,0.0,0.0
domnului Vance,www.b1tv.ro,0,0,1,1,0.0,0.0
partener,www.b1tv.ro,2,0,1,3,0.6666666666666666,0.6666666666666666
ști,www.b1tv.ro,0,0,1,1,0.0,0.0
Daniel Constantin,observatornews.ro,0,3,3,6,-0.5,0.5
Dragnea,observatornews.ro,0,5,2,7,-0.7142857142857143,0.7142857142857143
Ponta,observatornews.ro,0,5,3,8,-0.625,0.625
Sorin Câmpeanu,observatornews.ro,0,0,1,1,0.0,0.0
Arsene,pressone.ro,0,1,0,1,-1.0,1.0
Botoșani,pressone.ro,0,2,6,8,-0.25,0.25
Cristian Mihai,pressone.ro,0,0,4,4,0.0,0.0
Gutău,pressone.ro,0,1,0,1,-1.0,1.0
Ionel Arsene,pressone.ro,0,1,0,1,-1.0,1.0
Mircia Gutău,pressone.ro,0,1,0,1,-1.0,1.0
Neamț,pressone.ro,0,3,3,6,-0.5,0.5
Râmnicu Vâlcea,pressone.ro,0,0,1,1,0.0,0.0
Tăușan,pressone.ro,0,0,1,1,0.0,0.0
Vlad Tăușance,pressone.ro,0,0,2,2,0.0,0.0
plătitor,pressone.ro,0,1,0,1,-1.0,1.0
proprietarii,pressone.ro,0,5,0,5,-1.0,1.0
Cluj,www.aktual24.ro,0,0,2,2,0.0,0.0
Daniel,www.aktual24.ro,0,1,0,1,-1.0,1.0
Daniel Zamfir,www.aktual24.ro,0,1,0,1,-1.0,1.0
Vasile Dîncu,www.aktual24.ro,0,1,0,1,-1.0,1.0
rist,www.aktual24.ro,0,1,0,1,-1.0,1.0
traseist,www.aktual24.ro,0,3,0,3,-1.0,1.0
Alexandru Macoveiciuc,snoop.ro,0,0,1,1,0.0,0.0
Denise Rifai,snoop.ro,0,0,1,1,0.0,0.0
jurnalistă,snoop.ro,0,0,2,2,0.0,0.0
Liana Ganea,snoop.ro,0,0,3,3,0.0,0.0
Macoveiciuc,snoop.ro,0,0,1,1,0.0,0.0
Mircea Geoană,snoop.ro,0,2,4,6,-0.3333333333333333,0.3333333333333333
Modrogan,snoop.ro,0,1,1,2,-0.5,0.5
Rifai,snoop.ro,0,0,1,1,0.0,0.0
prezentatoare,snoop.ro,0,1,1,2,-0.5,0.5
realizatoare,snoop.ro,0,0,1,1,0.0,0.0
trainer,snoop.ro,0,1,0,1,-1.0,1.0
Ghigiu,adevarul.ro,0,1,0,1,-1.0,1.0
Mihai Ghigiu,adevarul.ro,0,0,1,1,0.0,0.0
Roxana Mînzatu,adevarul.ro,0,0,1,1,0.0,0.0
Mihai Gâdea,www.gandul.ro,0,0,3,3,0.0,0.0
dependent,www.gandul.ro,0,1,0,1,-1.0,1.0
director,www.gandul.ro,0,5,4,9,-0.5555555555555556,0.5555555555555556
medic,www.gandul.ro,0,2,5,7,-0.2857142857142857,0.2857142857142857
ofițer,www.gandul.ro,0,3,6,9,-0.3333333333333333,0.3333333333333333
ș,www.gandul.ro,0,0,1,1,0.0,0.0
Attila Cseke,www.g4media.ro,0,0,2,2,0.0,0.0
celor,www.aktual24.ro,0,0,5,5,0.0,0.0
Livia Stanciu,www.luju.ro,0,1,0,1,-1.0,1.0
Rovinari,www.luju.ro,0,1,0,1,-1.0,1.0
Turceni,www.luju.ro,0,1,0,1,-1.0,1.0
Pitești,adevarul.ro,0,0,3,3,0.0,0.0
Mihail Neamțu,primanews.ro,0,0,1,1,0.0,0.0
O,pressone.ro,0,0,1,1,0.0,0.0
Olanda,pressone.ro,0,0,11,11,0.0,0.0
Ovidiu Voicu,pressone.ro,0,0,5,5,0.0,0.0
reglementator,pressone.ro,0,5,0,5,-1.0,1.0
V,pressone.ro,0,0,3,3,0.0,0.0
Valeriu Zgonea,pressone.ro,0,1,2,3,-0.3333333333333333,0.3333333333333333
Zgonea,pressone.ro,0,1,1,2,-0.5,0.5
consumator,pressone.ro,0,5,1,6,-0.8333333333333334,0.8333333333333334
marionetă,pressone.ro,0,1,0,1,-1.0,1.0
personaj,pressone.ro,1,23,16,40,-0.55,0.55
Daren Acemoglu,recorder.ro,0,0,1,1,0.0,0.0
Elena Cristina Dinu,recorder.ro,0,1,0,1,-1.0,1.0
Giurgiu,recorder.ro,0,2,5,7,-0.2857142857142857,0.2857142857142857
Ioan Alexandru Andrei,recorder.ro,0,0,1,1,0.0,0.0
James A. Robinson,recorder.ro,0,0,2,2,0.0,0.0
Maria Gabriela Horga,recorder.ro,0,0,1,1,0.0,0.0
Marian Mina,recorder.ro,0,1,0,1,-1.0,1.0
Niall Ferguson,recorder.ro,0,0,1,1,0.0,0.0
Nicolae Barbu,recorder.ro,0,0,1,1,0.0,0.0
Niculae Bădălău,recorder.ro,0,1,1,2,-0.5,0.5
Robert Cazanciuc,recorder.ro,0,1,0,1,-1.0,1.0
Toma Petcu,recorder.ro,0,0,1,1,0.0,0.0
Tudor Radan,recorder.ro,0,0,1,1,0.0,0.0
Ulm,recorder.ro,0,0,1,1,0.0,0.0
agricultor,recorder.ro,3,0,5,8,0.375,0.375
aleș,recorder.ro,1,5,5,11,-0.36363636363636365,0.36363636363636365
lector,recorder.ro,0,0,8,8,0.0,0.0
lector universitar,recorder.ro,1,0,0,1,1.0,1.0
Ionuț Moșteanu,primanews.ro,0,0,4,4,0.0,0.0
Moșteanu,primanews.ro,0,0,2,2,0.0,0.0
Emil Hurezeanu,www.romaniatv.net,0,0,2,2,0.0,0.0
Ioan Aurel Pop,www.romaniatv.net,0,0,1,1,0.0,0.0
Theodor Paleologu,www.romaniatv.net,0,0,1,1,0.0,0.0
Alex Ciob,pressone.ro,0,0,1,1,0.0,0.0
Alex Ciobota,pressone.ro,0,0,2,2,0.0,0.0
Ciobota,pressone.ro,0,0,1,1,0.0,0.0
Foto,pressone.ro,0,0,2,2,0.0,0.0
Glad Varga,pressone.ro,0,1,1,2,-0.5,0.5
Vlad Varga,pressone.ro,0,1,0,1,-1.0,1.0
inițiat,pressone.ro,0,0,2,2,0.0,0.0
partener,pressone.ro,2,18,15,35,-0.45714285714285713,0.45714285714285713
responsabil,pressone.ro,0,3,0,3,-1.0,1.0
răuvoitor,pressone.ro,0,1,0,1,-1.0,1.0
actor,www.gandul.ro,0,3,5,8,-0.375,0.375
Suceava,www.cotidianul.ro,0,0,4,4,0.0,0.0
Ana Cristina Tinca,adevarul.ro,0,0,2,2,0.0,0.0
Csaba Ferenc Asztalos,adevarul.ro,0,0,2,2,0.0,0.0
Dan Cîmpean,adevarul.ro,0,0,2,2,0.0,0.0
Valentin Alexandru Jucan,adevarul.ro,0,0,2,2,0.0,0.0
Zsombor Vajda,adevarul.ro,0,0,3,3,0.0,0.0
Andrei Marga,a1.ro,0,1,1,2,-0.5,0.5
Daniel Petru Funeriu,a1.ro,0,0,1,1,0.0,0.0
Piatra Neamț,a1.ro,0,0,1,1,0.0,0.0
Pinalti,a1.ro,0,1,0,1,-1.0,1.0
Turcan,a1.ro,0,1,3,4,-0.25,0.25
Valeriu Turcan,a1.ro,0,0,3,3,0.0,0.0
expert,a1.ro,0,0,2,2,0.0,0.0
purtător,a1.ro,0,2,0,2,-1.0,1.0
Editor,www.digi24.ro,0,0,2,2,0.0,0.0
Guran,www.digi24.ro,0,0,2,2,0.0,0.0
Moise Guran,www.digi24.ro,0,1,3,4,-0.25,0.25
Robert Kiss,www.digi24.ro,0,0,5,5,0.0,0.0
actriță,www.antena3.ro,0,0,1,1,0.0,0.0
Darius Vâlcov,www.antena3.ro,0,0,1,1,0.0,0.0
Dej,www.antena3.ro,0,0,1,1,0.0,0.0
Iulian Șandru,www.antena3.ro,0,0,1,1,0.0,0.0
jurnalistă,www.antena3.ro,0,0,1,1,0.0,0.0
Lucia Șandru,www.antena3.ro,0,0,1,1,0.0,0.0
secretar executiv,www.antena3.ro,0,0,1,1,0.0,0.0
Slatina,www.antena3.ro,0,0,2,2,0.0,0.0
Traian Băsescu,www.antena3.ro,0,3,7,10,-0.3,0.3
Târgu,www.antena3.ro,0,0,1,1,0.0,0.0
fiică,www.antena3.ro,1,2,2,5,-0.2,0.2
Gaze,www.antena3.ro,0,1,0,1,-1.0,1.0
secretar,www.antena3.ro,0,0,7,7,0.0,0.0
Anselmo Polanco,www.aktual24.ro,0,0,1,1,0.0,0.0
Giuseppe Menochio,www.aktual24.ro,1,0,0,1,1.0,1.0
Josef Sciberras,www.aktual24.ro,0,0,1,1,0.0,0.0
Mircea Abrudean,www.aktual24.ro,0,0,1,1,0.0,0.0
Monicai,www.aktual24.ro,0,0,1,1,0.0,0.0
Napoleon,www.aktual24.ro,0,1,0,1,-1.0,1.0
oficial,www.aktual24.ro,0,13,5,18,-0.7222222222222222,0.7222222222222222
Robert Francis Prevost,www.aktual24.ro,0,0,1,1,0.0,0.0
Robert Prevost,www.aktual24.ro,0,0,1,1,0.0,0.0
Sciberras,www.aktual24.ro,0,0,1,1,0.0,0.0
Sfantul Agustin,www.aktual24.ro,0,0,1,1,0.0,0.0
Sfântul Augustin,www.aktual24.ro,1,0,0,1,1.0,1.0
Monica,www.aktual24.ro,1,0,0,1,1.0,1.0
Teruel,www.aktual24.ro,0,0,1,1,0.0,0.0
Vatican,www.aktual24.ro,0,0,2,2,0.0,0.0
cardinal,www.aktual24.ro,0,0,1,1,0.0,0.0
credincios,www.aktual24.ro,0,1,2,3,-0.3333333333333333,0.3333333333333333
fericit,www.aktual24.ro,0,1,0,1,-1.0,1.0
fiu,www.aktual24.ro,0,0,7,7,0.0,0.0
ii,www.aktual24.ro,0,1,1,2,-0.5,0.5
papă,www.aktual24.ro,0,1,2,3,-0.3333333333333333,0.3333333333333333
Papa Francisc,www.aktual24.ro,0,0,1,1,0.0,0.0
pene,www.aktual24.ro,0,1,0,1,-1.0,1.0
personalitate,www.aktual24.ro,1,1,2,4,0.0,0.0
postulator general,www.aktual24.ro,0,0,1,1,0.0,0.0
moștenitor,www.aktual24.ro,0,0,1,1,0.0,0.0
șef de stat,www.aktual24.ro,0,0,1,1,0.0,0.0
sfânt,www.aktual24.ro,1,0,1,2,0.5,0.5
suveran,www.aktual24.ro,0,0,1,1,0.0,0.0
Alexandru Costea,www.digi24.ro,0,0,1,1,0.0,0.0
redactor,www.digi24.ro,0,0,4,4,0.0,0.0
Bogdan Huțucă,stirileprotv.ro,0,0,2,2,0.0,0.0
Chelariu,stirileprotv.ro,0,1,0,1,-1.0,1.0
Ermil Chelariu,stirileprotv.ro,0,1,0,1,-1.0,1.0
funcționar,stirileprotv.ro,0,3,0,3,-1.0,1.0
Lupu,stirileprotv.ro,0,1,0,1,-1.0,1.0
Mangalia,stirileprotv.ro,0,1,0,1,-1.0,1.0
Mihai Lupu,stirileprotv.ro,0,1,0,1,-1.0,1.0
Năvodari,stirileprotv.ro,0,1,0,1,-1.0,1.0
om de afaceri,stirileprotv.ro,0,5,3,8,-0.625,0.625
Acarul Păun,www.gandul.ro,0,0,1,1,0.0,0.0
Cristian Popescu Piedone,www.gandul.ro,1,4,7,12,-0.25,0.25
Piedone,www.gandul.ro,0,4,5,9,-0.4444444444444444,0.4444444444444444
sector,www.gandul.ro,0,0,2,2,0.0,0.0
Suceava,www.gandul.ro,0,0,4,4,0.0,0.0
Vlad Piedone,www.gandul.ro,0,0,2,2,0.0,0.0
fiu,www.gandul.ro,2,1,7,10,0.1,0.1
Kelemen,www.cotidianul.ro,0,1,0,1,-1.0,1.0
politică,www.cotidianul.ro,0,1,0,1,-1.0,1.0
Alessandrei Stoicescu,a1.ro,0,0,5,5,0.0,0.0
Lavinia Șandru,a1.ro,0,0,7,7,0.0,0.0
tu,a1.ro,1,0,0,1,1.0,1.0
Adrian Năstase,www.g4media.ro,0,4,4,8,-0.5,0.5
Anamaria Gavrilă,www.g4media.ro,0,1,3,4,-0.25,0.25
austriac,www.g4media.ro,0,0,1,1,0.0,0.0
Claudiu Năsui,www.g4media.ro,0,0,1,1,0.0,0.0
Dl. Peiu,www.g4media.ro,0,1,0,1,-1.0,1.0
Fredi Valută,www.g4media.ro,0,1,0,1,-1.0,1.0
George,www.g4media.ro,0,0,1,1,0.0,0.0
Ghigiu,www.g4media.ro,0,1,0,1,-1.0,1.0
Giordano,www.g4media.ro,0,0,1,1,0.0,0.0
Guvernul Ciolacu,www.g4media.ro,0,1,0,1,-1.0,1.0
Ionuț Moșteanu,www.g4media.ro,0,1,2,3,-0.3333333333333333,0.3333333333333333
Klaus Iohannis,www.g4media.ro,0,9,30,39,-0.23076923076923078,0.23076923076923078
Laura Vicol Ciorbă,www.g4media.ro,0,0,1,1,0.0,0.0
Marcele,www.g4media.ro,0,1,0,1,-1.0,1.0
Mesia,www.g4media.ro,0,1,0,1,-1.0,1.0
Moșteanu,www.g4media.ro,0,0,3,3,0.0,0.0
Năsui,www.g4media.ro,0,1,0,1,-1.0,1.0
Olanda,www.g4media.ro,0,0,1,1,0.0,0.0
Protejata,www.g4media.ro,1,0,0,1,1.0,1.0
Statele Unite,www.g4media.ro,3,0,8,11,0.2727272727272727,0.2727272727272727
Toni Greblă,www.g4media.ro,0,2,0,2,-1.0,1.0
Donald Trump,www.g4media.ro,2,12,9,23,-0.43478260869565216,0.43478260869565216
Ucraina,www.g4media.ro,5,10,11,26,-0.19230769230769232,0.19230769230769232
bunică,www.g4media.ro,0,0,2,2,0.0,0.0
dușman,www.g4media.ro,0,2,0,2,-1.0,1.0
ipocrit,www.g4media.ro,0,1,0,1,-1.0,1.0
istoric,www.g4media.ro,3,1,2,6,0.3333333333333333,0.3333333333333333
lume,www.g4media.ro,0,2,0,2,-1.0,1.0
meditator,www.g4media.ro,0,1,0,1,-1.0,1.0
patriot,www.g4media.ro,0,1,0,1,-1.0,1.0
preot,www.g4media.ro,0,1,2,3,-0.3333333333333333,0.3333333333333333
prieteni,www.g4media.ro,1,1,0,2,0.0,0.0
profet,www.g4media.ro,0,2,0,2,-1.0,1.0
revoluționar,www.g4media.ro,0,1,0,1,-1.0,1.0
semnatar,www.g4media.ro,1,3,5,9,-0.2222222222222222,0.2222222222222222
slugă,www.g4media.ro,0,2,0,2,-1.0,1.0
suveranist,www.g4media.ro,0,2,0,2,-1.0,1.0
trădător,www.g4media.ro,0,1,0,1,-1.0,1.0
Claudiu Năsui,stirileprotv.ro,0,1,3,4,-0.25,0.25
bugetari,stirileprotv.ro,0,1,0,1,-1.0,1.0
cercetător,stirileprotv.ro,1,0,1,2,0.5,0.5
contribuabil,stirileprotv.ro,1,1,0,2,0.0,0.0
politruc,stirileprotv.ro,0,1,0,1,-1.0,1.0
sindicalist,stirileprotv.ro,0,1,0,1,-1.0,1.0
avocat,www.b1tv.ro,0,0,1,1,0.0,0.0
coleg,www.b1tv.ro,4,3,4,11,0.09090909090909091,0.09090909090909091
individ,www.b1tv.ro,1,8,0,9,-0.7777777777777778,0.7777777777777778
Budapesta,www.digi24.ro,0,0,1,1,0.0,0.0
Ungaria,www.digi24.ro,0,1,3,4,-0.25,0.25
Ungarie,www.digi24.ro,0,0,2,2,0.0,0.0
Viktor Orban,www.digi24.ro,0,2,0,2,-1.0,1.0
Abu Dhabi,www.g4media.ro,0,0,1,1,0.0,0.0
Alex Florența,www.g4media.ro,0,1,0,1,-1.0,1.0
Dan Voiculescu,www.g4media.ro,0,7,2,9,-0.7777777777777778,0.7777777777777778
Dragnea,www.g4media.ro,0,2,2,4,-0.5,0.5
Emil Constantinescu,www.g4media.ro,0,0,2,2,0.0,0.0
Gabriel Oprea,www.g4media.ro,0,1,0,1,-1.0,1.0
Gabriel Vlase,www.g4media.ro,0,1,0,1,-1.0,1.0
Kiev,www.g4media.ro,0,0,1,1,0.0,0.0
Laura Codruța Kovesi,www.g4media.ro,0,1,0,1,-1.0,1.0
Liviu Stanciu,www.g4media.ro,0,0,1,1,0.0,0.0
Lucian Pahonțu,www.g4media.ro,0,0,1,1,0.0,0.0
Marian Enache,www.g4media.ro,0,0,2,2,0.0,0.0
Mihai Weber,www.g4media.ro,0,0,1,1,0.0,0.0
Pahonțu,www.g4media.ro,0,0,1,1,0.0,0.0
procuror general,www.g4media.ro,0,1,0,1,-1.0,1.0
Robert Fico,www.g4media.ro,0,1,0,1,-1.0,1.0
Silvestru Șoșoacă,www.g4media.ro,0,1,0,1,-1.0,1.0
Slovacia,www.g4media.ro,0,3,2,5,-0.6,0.6
Slovac,www.g4media.ro,0,0,1,1,0.0,0.0
Ungaria,www.g4media.ro,0,5,3,8,-0.625,0.625
Ungarie,www.g4media.ro,0,2,1,3,-0.6666666666666666,0.6666666666666666
Victor Ciorbea,www.g4media.ro,0,0,1,1,0.0,0.0
Vladimir Putin,www.g4media.ro,0,7,2,9,-0.7777777777777778,0.7777777777777778
Washington,www.g4media.ro,0,2,3,5,-0.4,0.4
doctor,www.g4media.ro,0,1,2,3,-0.3333333333333333,0.3333333333333333
judecător,www.g4media.ro,0,4,7,11,-0.36363636363636365,0.36363636363636365
Ludovic Orban,www.g4media.ro,0,2,1,3,-0.6666666666666666,0.6666666666666666
Iohannis,www.g4media.ro,0,1,1,2,-0.5,0.5
procuror,www.g4media.ro,0,8,1,9,-0.8888888888888888,0.8888888888888888
stat,www.g4media.ro,0,0,1,1,0.0,0.0
șef de stat,www.g4media.ro,0,0,1,1,0.0,0.0
artist,www.luju.ro,0,0,1,1,0.0,0.0
Iolanda Grecu,www.luju.ro,0,1,0,1,-1.0,1.0
Marcel Ciolacu,www.luju.ro,1,17,18,36,-0.4444444444444444,0.4444444444444444
reclamant,www.luju.ro,0,5,6,11,-0.45454545454545453,0.45454545454545453
salariat,www.luju.ro,0,1,0,1,-1.0,1.0
român,observatornews.ro,0,0,1,1,0.0,0.0
om de știință,www.g4media.ro,2,0,0,2,1.0,1.0
Uliana Dmitrieva,www.g4media.ro,0,0,1,1,0.0,0.0
cercetătoare,www.g4media.ro,0,0,1,1,0.0,0.0
ciorbă,www.comisarul.ro,0,0,1,1,0.0,0.0
Viorica Vicol,www.comisarul.ro,0,0,1,1,0.0,0.0
Marian Bejan,www.comisarul.ro,0,1,0,1,-1.0,1.0
Mesia,www.comisarul.ro,0,2,1,3,-0.6666666666666666,0.6666666666666666
Olguța Vasilescu,www.comisarul.ro,0,1,1,2,-0.5,0.5
Recorder,www.comisarul.ro,0,0,1,1,0.0,0.0
Vicol,www.comisarul.ro,0,3,0,3,-1.0,1.0
autoare,www.comisarul.ro,0,1,0,1,-1.0,1.0
cuplu,www.comisarul.ro,1,0,1,2,0.5,0.5
dictator,www.comisarul.ro,0,2,0,2,-1.0,1.0
Grindeanu,www.comisarul.ro,0,1,3,4,-0.25,0.25
Ciorbă,www.comisarul.ro,0,1,0,1,-1.0,1.0
Giorgiana Hosu,www.comisarul.ro,0,0,1,1,0.0,0.0
Gorghiu,www.comisarul.ro,0,1,0,1,-1.0,1.0
interlop,www.comisarul.ro,0,2,0,2,-1.0,1.0
premiu,www.comisarul.ro,0,1,1,2,-0.5,0.5
prietena săritoare,www.comisarul.ro,0,1,0,1,-1.0,1.0
păgubit,www.comisarul.ro,0,1,0,1,-1.0,1.0
salvator,www.comisarul.ro,0,2,0,2,-1.0,1.0
suspect,www.comisarul.ro,0,8,1,9,-0.8888888888888888,0.8888888888888888
șarlatan,www.comisarul.ro,0,1,0,1,-1.0,1.0
Ciprian Ciucu,www.romaniatv.net,0,0,4,4,0.0,0.0
Ciucu,www.romaniatv.net,0,1,1,2,-0.5,0.5
Sebastian Popescu,adevarul.ro,0,1,5,6,-0.16666666666666666,0.16666666666666666
subiect,adevarul.ro,0,0,1,1,0.0,0.0
Baumann,www.antena3.ro,0,1,0,1,-1.0,1.0
Guy Debord,www.antena3.ro,0,0,1,1,0.0,0.0
Israel,www.antena3.ro,0,3,2,5,-0.6,0.6
Sergei Lavrov,www.antena3.ro,0,0,1,1,0.0,0.0
Mark Rutte,www.antena3.ro,0,1,3,4,-0.25,0.25
Meloni,www.antena3.ro,0,1,0,1,-1.0,1.0
New York,www.antena3.ro,0,2,0,2,-1.0,1.0
Péter Szijjártó,www.antena3.ro,0,0,1,1,0.0,0.0
URSS,www.antena3.ro,0,0,2,2,0.0,0.0
a,www.antena3.ro,0,1,0,1,-1.0,1.0
argentină,www.antena3.ro,0,0,1,1,0.0,0.0
băiat,www.antena3.ro,0,2,2,4,-0.5,0.5
deținător,www.antena3.ro,0,1,0,1,-1.0,1.0
ea,www.antena3.ro,0,4,1,5,-0.8,0.8
filosof,www.antena3.ro,0,0,1,1,0.0,0.0
mexican,www.antena3.ro,0,0,1,1,0.0,0.0
Prințesa Diana,www.antena3.ro,0,0,1,1,0.0,0.0
suveran,www.antena3.ro,0,3,0,3,-1.0,1.0
terorist,www.antena3.ro,0,2,0,2,-1.0,1.0
hoț,www.cotidianul.ro,0,1,0,1,-1.0,1.0
salariați,www.cotidianul.ro,0,1,0,1,-1.0,1.0
mincinos,www.cotidianul.ro,0,1,0,1,-1.0,1.0
,www.romaniatv.net,0,1,1,2,-0.5,0.5
CTP,www.romaniatv.net,0,4,3,7,-0.5714285714285714,0.5714285714285714
Federația Rusă,www.romaniatv.net,0,1,0,1,-1.0,1.0
suveran,www.romaniatv.net,0,8,0,8,-1.0,1.0
Votanțiu,www.romaniatv.net,0,1,1,2,-0.5,0.5
boți,www.romaniatv.net,0,1,0,1,-1.0,1.0
favorit,www.romaniatv.net,0,4,0,4,-1.0,1.0
patriot,www.romaniatv.net,0,3,0,3,-1.0,1.0
tânăr,www.romaniatv.net,3,3,11,17,0.0,0.0
Cătălin Predoiu,www.aktual24.ro,0,0,10,10,0.0,0.0
China,www.romaniatv.net,0,1,3,4,-0.25,0.25
George,www.romaniatv.net,0,4,1,5,-0.8,0.8
Londra,www.romaniatv.net,0,0,3,3,0.0,0.0
prieteni,www.romaniatv.net,2,1,1,4,0.25,0.25
stăpân,www.romaniatv.net,0,2,0,2,-1.0,1.0
Cairo,www.mediafax.ro,0,0,2,2,0.0,0.0
Doha,www.mediafax.ro,0,0,1,1,0.0,0.0
Egipt,www.mediafax.ro,0,0,1,1,0.0,0.0
Emiratele Arabe Unite,www.mediafax.ro,0,0,1,1,0.0,0.0
Qatar,www.mediafax.ro,0,0,1,1,0.0,0.0
Andy Warhol,stirileprotv.ro,0,0,1,1,0.0,0.0
Augustin Jianu,stirileprotv.ro,0,0,2,2,0.0,0.0
Bad,stirileprotv.ro,0,1,0,1,-1.0,1.0
Călin Popescu-Tăriceanu,stirileprotv.ro,0,0,3,3,0.0,0.0
Caras Severin,stirileprotv.ro,0,0,1,1,0.0,0.0
Corneliu Baba,stirileprotv.ro,0,0,1,1,0.0,0.0
Daniel Constantin,stirileprotv.ro,0,0,2,2,0.0,0.0
Darius Vâlcov,stirileprotv.ro,0,1,0,1,-1.0,1.0
Eustatiu Stoenescu,stirileprotv.ro,0,0,1,1,0.0,0.0
Gabriel Les,stirileprotv.ro,0,0,1,1,0.0,0.0
Horia Bernea,stirileprotv.ro,0,0,1,1,0.0,0.0
Ion Mocioalca,stirileprotv.ro,0,0,1,1,0.0,0.0
Ionel Arsene,stirileprotv.ro,0,0,3,3,0.0,0.0
Ionuț Vulpescu,stirileprotv.ro,0,0,2,2,0.0,0.0
Marian Neacșu,stirileprotv.ro,0,0,4,4,0.0,0.0
Maricel Popa,stirileprotv.ro,0,0,1,1,0.0,0.0
Nicolae Badalau,stirileprotv.ro,0,0,1,1,0.0,0.0
Nicolae Grigorescu,stirileprotv.ro,0,0,1,1,0.0,0.0
Nicolae Tonitza,stirileprotv.ro,0,0,1,1,0.0,0.0
Pablo Picasso,stirileprotv.ro,0,0,1,1,0.0,0.0
Popa,stirileprotv.ro,0,1,1,2,-0.5,0.5
Samuel Mutzner,stirileprotv.ro,0,0,1,1,0.0,0.0
Sevil Shaidehh,stirileprotv.ro,0,0,1,1,0.0,0.0
Stefan Luchian,stirileprotv.ro,0,0,1,1,0.0,0.0
Tariceanu,stirileprotv.ro,0,1,2,3,-0.3333333333333333,0.3333333333333333
Tudorel Toader,stirileprotv.ro,0,0,2,2,0.0,0.0
Viorel Ștefan,stirileprotv.ro,0,0,1,1,0.0,0.0
acest,stirileprotv.ro,0,1,0,1,-1.0,1.0
altuia,stirileprotv.ro,0,0,1,1,0.0,0.0
bucureștean,stirileprotv.ro,0,1,1,2,-0.5,0.5
fiecare,stirileprotv.ro,0,1,0,1,-1.0,1.0
salariat,stirileprotv.ro,0,0,1,1,0.0,0.0
tânăr,stirileprotv.ro,1,2,0,3,-0.3333333333333333,0.3333333333333333
tovarăși,stirileprotv.ro,0,1,0,1,-1.0,1.0
Cristian Pârvulescu,www.romaniatv.net,0,0,1,1,0.0,0.0
Ludovic Orban,www.romaniatv.net,0,3,2,5,-0.6,0.6
parior,www.romaniatv.net,0,2,0,2,-1.0,1.0
alegător,www.digi24.ro,1,6,4,11,-0.45454545454545453,0.45454545454545453
domn,www.digi24.ro,0,3,4,7,-0.42857142857142855,0.42857142857142855
dansator,www.digi24.ro,0,3,2,5,-0.6,0.6
Rafal Trzaskowski,primanews.ro,1,0,1,2,0.5,0.5
Sławomir Mentzen,primanews.ro,0,0,3,3,0.0,0.0
Karol Nawrocki,primanews.ro,0,1,2,3,-0.3333333333333333,0.3333333333333333
Constantin,www.romaniatv.net,0,0,2,2,0.0,0.0
Mihai Constantin,www.romaniatv.net,0,0,5,5,0.0,0.0
șomer,www.romaniatv.net,0,1,0,1,-1.0,1.0
Ionuț Moșteanu,www.romaniatv.net,0,0,3,3,0.0,0.0
Suciu,www.romaniatv.net,0,0,1,1,0.0,0.0
ales,www.romaniatv.net,0,2,0,2,-1.0,1.0
secretar,www.romaniatv.net,0,3,11,14,-0.21428571428571427,0.21428571428571427
Adrian Țuțuianu,stirileprotv.ro,0,0,1,1,0.0,0.0
Dăncilă,stirileprotv.ro,0,3,2,5,-0.6,0.6
Dănuț Andrușcă,stirileprotv.ro,0,0,1,1,0.0,0.0
Eugen Teodorovici,stirileprotv.ro,0,0,2,2,0.0,0.0
Ploiești,stirileprotv.ro,0,0,1,1,0.0,0.0
Rovana Plumb,stirileprotv.ro,0,1,0,1,-1.0,1.0
Teodor Meleșcanu,stirileprotv.ro,2,0,2,4,0.5,0.5
Teodorovici,stirileprotv.ro,0,0,2,2,0.0,0.0
Victor Negrescu,stirileprotv.ro,0,0,5,5,0.0,0.0
Bulai,pressone.ro,0,4,1,5,-0.8,0.8
Covid,pressone.ro,0,1,0,1,-1.0,1.0
Iulian Bulai,pressone.ro,0,2,2,4,-0.5,0.5
Lucian Bode,pressone.ro,0,4,2,6,-0.6666666666666666,0.6666666666666666
Van Damme,pressone.ro,0,0,1,1,0.0,0.0
agent Smith,pressone.ro,0,1,0,1,-1.0,1.0
eugen,pressone.ro,0,1,0,1,-1.0,1.0
general,pressone.ro,0,10,6,16,-0.625,0.625
patriot,pressone.ro,2,8,1,11,-0.5454545454545454,0.5454545454545454
smintit,pressone.ro,0,1,0,1,-1.0,1.0
stăpân,pressone.ro,0,3,0,3,-1.0,1.0
ă,pressone.ro,0,1,0,1,-1.0,1.0
Grindeanu,www.news.ro,1,3,2,6,-0.3333333333333333,0.3333333333333333
Paul Stănescu,www.news.ro,0,2,0,2,-1.0,1.0
leneș,www.news.ro,0,1,0,1,-1.0,1.0
neveste,www.news.ro,0,1,0,1,-1.0,1.0
ot,www.news.ro,0,1,0,1,-1.0,1.0
pesediști,www.news.ro,0,1,0,1,-1.0,1.0
român,www.news.ro,1,0,1,2,0.5,0.5
hacker,www.g4media.ro,0,2,0,2,-1.0,1.0
Aurelian Mihalache,www.gandul.ro,0,0,1,1,0.0,0.0
Aurel Preda,www.gandul.ro,0,1,0,1,-1.0,1.0
Bartolomeu Săvoiu,www.gandul.ro,0,0,1,1,0.0,0.0
colonel,www.gandul.ro,0,1,1,2,-0.5,0.5
consilier,www.gandul.ro,1,5,18,24,-0.16666666666666666,0.16666666666666666
Decebal Ilina,www.gandul.ro,0,0,1,1,0.0,0.0
Dumitru Preda,www.gandul.ro,0,1,0,1,-1.0,1.0
Dumnezeu,www.gandul.ro,5,0,0,5,1.0,1.0
Florin Ioniță,www.gandul.ro,0,1,0,1,-1.0,1.0
general,www.gandul.ro,0,3,5,8,-0.375,0.375
general de brigadă,www.gandul.ro,0,0,1,1,0.0,0.0
inspector,www.gandul.ro,0,1,1,2,-0.5,0.5
maior,www.gandul.ro,0,0,1,1,0.0,0.0
Mihai Mureșan,www.gandul.ro,0,0,1,1,0.0,0.0
Mihail Țăpârlea,www.gandul.ro,0,1,0,1,-1.0,1.0
militar,www.gandul.ro,1,1,3,5,0.0,0.0
Nicolae Miu,www.gandul.ro,0,0,1,1,0.0,0.0
Patri,www.gandul.ro,1,0,0,1,1.0,1.0
Președintele,www.gandul.ro,0,0,4,4,0.0,0.0
Romulus Hâldan,www.gandul.ro,0,0,1,1,0.0,0.0
semnatar,www.gandul.ro,2,0,0,2,1.0,1.0
Valentin Simion,www.gandul.ro,0,0,1,1,0.0,0.0
ct,www.gandul.ro,0,0,1,1,0.0,0.0
da,www.gandul.ro,0,0,1,1,0.0,0.0
popor,www.gandul.ro,3,1,1,5,0.4,0.4
conducător,www.digi24.ro,0,1,0,1,-1.0,1.0
copil,www.digi24.ro,7,3,9,19,0.21052631578947367,0.21052631578947367
fiică,www.digi24.ro,1,2,0,3,-0.3333333333333333,0.3333333333333333
mamă,www.digi24.ro,0,3,1,4,-0.75,0.75
mine,www.digi24.ro,0,1,0,1,-1.0,1.0
soție,www.digi24.ro,1,0,7,8,0.125,0.125
tată,www.digi24.ro,0,2,1,3,-0.6666666666666666,0.6666666666666666
adversar,www.news.ro,0,6,1,7,-0.8571428571428571,0.8571428571428571
Bucureștean,www.news.ro,0,0,1,1,0.0,0.0
intru,www.news.ro,0,1,0,1,-1.0,1.0
Bănescu,www.realitatea.net,0,0,1,1,0.0,0.0
Vasile Bănescu,www.realitatea.net,0,1,0,1,-1.0,1.0
Argeș,stirileprotv.ro,0,1,2,3,-0.3333333333333333,0.3333333333333333
băcan,stirileprotv.ro,0,0,1,1,0.0,0.0
Brașov,stirileprotv.ro,0,0,2,2,0.0,0.0
Cristian Ghic,stirileprotv.ro,0,0,1,1,0.0,0.0
Cristian Seidler,stirileprotv.ro,0,0,2,2,0.0,0.0
Câmpulung,stirileprotv.ro,0,0,1,1,0.0,0.0
Cătălin Drulă,stirileprotv.ro,0,0,6,6,0.0,0.0
Ionuț Moșteanu,stirileprotv.ro,0,0,5,5,0.0,0.0
Radu Hossu,stirileprotv.ro,0,0,1,1,0.0,0.0
sector,stirileprotv.ro,0,0,1,1,0.0,0.0
Silviu Dehelean,stirileprotv.ro,0,0,1,1,0.0,0.0
Stelian Ion,stirileprotv.ro,0,0,3,3,0.0,0.0
Vasile Filip,stirileprotv.ro,0,0,1,1,0.0,0.0
Vasile Gabriel Filip,stirileprotv.ro,0,0,1,1,0.0,0.0
delegat,stirileprotv.ro,0,0,3,3,0.0,0.0
Cristina Prună,stirileprotv.ro,0,0,2,2,0.0,0.0
Buzău,www.realitatea.net,0,0,1,1,0.0,0.0
făptaș,www.realitatea.net,0,1,0,1,-1.0,1.0
Mihai Belu,www.realitatea.net,0,1,1,2,-0.5,0.5
Roșia Montană,www.realitatea.net,0,1,1,2,-0.5,0.5
Teo Peter,www.realitatea.net,0,1,0,1,-1.0,1.0
adjunct,www.realitatea.net,0,1,0,1,-1.0,1.0
cadru medical,www.realitatea.net,0,0,1,1,0.0,0.0
cadru militar,www.realitatea.net,0,0,1,1,0.0,0.0
cunoscut,www.realitatea.net,0,0,1,1,0.0,0.0
prieten,www.realitatea.net,3,0,2,5,0.6,0.6
profesor,www.realitatea.net,0,0,2,2,0.0,0.0
rebel,www.realitatea.net,1,0,0,1,1.0,1.0
trântor,www.realitatea.net,0,1,0,1,-1.0,1.0
Abraham Lincoln,www.comisarul.ro,0,0,1,1,0.0,0.0
Andrew Jackson,www.comisarul.ro,0,1,0,1,-1.0,1.0
Canadei,www.comisarul.ro,0,1,0,1,-1.0,1.0
George Washington,www.comisarul.ro,0,0,1,1,0.0,0.0
Georgia,www.comisarul.ro,0,0,3,3,0.0,0.0
Gianni Infantino,www.comisarul.ro,0,0,1,1,0.0,0.0
Groenlanda,www.comisarul.ro,0,1,1,2,-0.5,0.5
Jackson,www.comisarul.ro,0,0,1,1,0.0,0.0
James Polk,www.comisarul.ro,0,1,0,1,-1.0,1.0
Polk,www.comisarul.ro,0,1,0,1,-1.0,1.0
Ronald Reagan,www.comisarul.ro,0,0,1,1,0.0,0.0
acesta,www.comisarul.ro,0,0,5,5,0.0,0.0
dezvoltator,www.comisarul.ro,0,6,2,8,-0.75,0.75
inventator,www.comisarul.ro,0,0,1,1,0.0,0.0
predecesor,www.comisarul.ro,0,2,0,2,-1.0,1.0
republican,www.comisarul.ro,0,0,1,1,0.0,0.0
Dumnezeu,www.cotidianul.ro,3,2,2,7,0.14285714285714285,0.14285714285714285
Mesia,www.cotidianul.ro,0,1,0,1,-1.0,1.0
Statele Unite,www.cotidianul.ro,0,2,4,6,-0.3333333333333333,0.3333333333333333
voi,www.cotidianul.ro,0,1,0,1,-1.0,1.0
suveranist,www.cotidianul.ro,0,3,0,3,-1.0,1.0
suveran,www.cotidianul.ro,0,2,0,2,-1.0,1.0
stat,www.cotidianul.ro,0,1,0,1,-1.0,1.0
prim-ministru,www.cotidianul.ro,0,5,4,9,-0.5555555555555556,0.5555555555555556
Cătălin Predoiu,www.cotidianul.ro,0,4,3,7,-0.5714285714285714,0.5714285714285714
Dănuț Pop,www.realitatea.net,2,0,0,2,1.0,1.0
Vicepreședintele,www.realitatea.net,0,0,1,1,0.0,0.0
decident,www.realitatea.net,0,0,1,1,0.0,0.0
naș,www.realitatea.net,0,1,0,1,-1.0,1.0
public,www.realitatea.net,0,1,2,3,-0.3333333333333333,0.3333333333333333
Florin Roman,primanews.ro,0,0,1,1,0.0,0.0
Marcel Ioan Bolos,primanews.ro,0,0,1,1,0.0,0.0
Coreea de Sud,agerpres.ro,0,0,2,2,0.0,0.0
Mihaela Toth,agerpres.ro,0,0,1,1,0.0,0.0
Yoon,agerpres.ro,0,1,0,1,-1.0,1.0
Yoon Suk-yeol,agerpres.ro,0,1,0,1,-1.0,1.0
activist,agerpres.ro,1,1,0,2,0.0,0.0
Maricel Păcurar,www.g4media.ro,0,2,0,2,-1.0,1.0
competitor,www.g4media.ro,0,4,2,6,-0.6666666666666666,0.6666666666666666
mandatar,www.g4media.ro,0,0,2,2,0.0,0.0
mandatar financiar,www.g4media.ro,0,0,1,1,0.0,0.0
Bako,snoop.ro,0,0,1,1,0.0,0.0
capitală,snoop.ro,0,1,5,6,-0.16666666666666666,0.16666666666666666
Cîțu,snoop.ro,0,1,0,1,-1.0,1.0
Dan Popa,snoop.ro,0,1,0,1,-1.0,1.0
Dan Radu Popa,snoop.ro,0,0,1,1,0.0,0.0
David Popovici,snoop.ro,0,0,1,1,0.0,0.0
Novak,snoop.ro,0,1,2,3,-0.3333333333333333,0.3333333333333333
Eduard Novak,snoop.ro,0,0,1,1,0.0,0.0
Elisabeta Lipă,snoop.ro,0,0,2,2,0.0,0.0
Lipă,snoop.ro,0,1,0,1,-1.0,1.0
Miercurea Ciuc,snoop.ro,0,0,2,2,0.0,0.0
Popa,snoop.ro,0,1,0,1,-1.0,1.0
Péter Szijjártó,snoop.ro,0,0,1,1,0.0,0.0
Szabolcs Bako,snoop.ro,0,0,1,1,0.0,0.0
Team Novak,snoop.ro,0,0,1,1,0.0,0.0
Ungarie,snoop.ro,0,0,4,4,0.0,0.0
ambii,snoop.ro,0,0,1,1,0.0,0.0
Karoly Novak,snoop.ro,0,0,1,1,0.0,0.0
campion,snoop.ro,0,0,2,2,0.0,0.0
ciclist,snoop.ro,0,1,0,1,-1.0,1.0
inculpat,snoop.ro,0,4,1,5,-0.8,0.8
judecător,snoop.ro,0,7,8,15,-0.4666666666666667,0.4666666666666667
referent,snoop.ro,0,0,1,1,0.0,0.0
sponsor,snoop.ro,0,0,1,1,0.0,0.0
sportiv,snoop.ro,0,0,2,2,0.0,0.0
succesoare,snoop.ro,0,1,0,1,-1.0,1.0
terț,snoop.ro,0,0,1,1,0.0,0.0
turist,snoop.ro,0,3,0,3,-1.0,1.0
turișt,snoop.ro,0,3,1,4,-0.75,0.75
turiști,snoop.ro,0,2,1,3,-0.6666666666666666,0.6666666666666666
Cristoiu,www.cotidianul.ro,0,0,1,1,0.0,0.0
Ion Cristoiu,www.cotidianul.ro,0,0,3,3,0.0,0.0
gazetar,www.cotidianul.ro,0,0,1,1,0.0,0.0
Timiș,www.digi24.ro,0,0,1,1,0.0,0.0
AU,www.cotidianul.ro,0,1,0,1,-1.0,1.0
Becali,www.cotidianul.ro,0,2,1,3,-0.6666666666666666,0.6666666666666666
Dan Dungaciu,www.cotidianul.ro,0,0,2,2,0.0,0.0
George Becali,www.cotidianul.ro,0,0,3,3,0.0,0.0
Gigi Becali,www.cotidianul.ro,0,3,1,4,-0.75,0.75
latifundiar,www.cotidianul.ro,0,1,0,1,-1.0,1.0
personaj,www.antena3.ro,1,4,1,6,-0.5,0.5
votant,www.antena3.ro,0,2,3,5,-0.4,0.4
Marius Lulea,www.romaniatv.net,0,4,8,12,-0.3333333333333333,0.3333333333333333
Boloș,www.digi24.ro,0,1,0,1,-1.0,1.0
Câciu,www.digi24.ro,0,1,1,2,-0.5,0.5
Marcel Boloș,www.digi24.ro,0,1,3,4,-0.25,0.25
Robert Sighiartău,www.digi24.ro,0,1,0,1,-1.0,1.0
jandarm,www.cotidianul.ro,0,4,1,5,-0.8,0.8
Pompiliu Diplan,www.activenews.ro,0,0,1,1,0.0,0.0
actor,www.activenews.ro,0,1,1,2,-0.5,0.5
electorat,www.activenews.ro,1,5,1,7,-0.5714285714285714,0.5714285714285714
figuranț,www.activenews.ro,0,1,0,1,-1.0,1.0
invitat,www.activenews.ro,1,1,0,2,0.0,0.0
organizator,www.activenews.ro,0,1,0,1,-1.0,1.0
patriot,www.activenews.ro,7,0,0,7,1.0,1.0
suveranist,www.activenews.ro,0,5,0,5,-1.0,1.0
Anca Simina,recorder.ro,0,0,1,1,0.0,0.0
Andreea Pocotilă,recorder.ro,0,0,2,2,0.0,0.0
Andrei Udișteanu,recorder.ro,0,0,2,2,0.0,0.0
Cristian Delcea,recorder.ro,0,0,2,2,0.0,0.0
Isabela Pop,recorder.ro,0,0,1,1,0.0,0.0
Laurențiu Ungureanu,recorder.ro,0,0,2,2,0.0,0.0
Mihai Voinea,recorder.ro,0,0,1,1,0.0,0.0
Sergiu Dimitriu,recorder.ro,0,0,1,1,0.0,0.0
parlamentar,primanews.ro,0,12,8,20,-0.6,0.6
stat,primanews.ro,0,2,0,2,-1.0,1.0
Șerban Ciprian Constantin,primanews.ro,0,0,1,1,0.0,0.0
susținător,www.mediafax.ro,1,6,4,11,-0.45454545454545453,0.45454545454545453
Henry Cavill,a1.ro,0,0,1,1,0.0,0.0
Barack Obama,a1.ro,1,1,5,7,0.0,0.0
Bill Clinton,a1.ro,0,0,1,1,0.0,0.0
George W. Bush,a1.ro,0,1,1,2,-0.5,0.5
Jimmy Carter,a1.ro,0,0,1,1,0.0,0.0
Joe Biden,a1.ro,0,2,1,3,-0.6666666666666666,0.6666666666666666
Sebastian Stan,a1.ro,0,0,1,1,0.0,0.0
Statele Unite ale Americii,a1.ro,0,0,4,4,0.0,0.0
omolog,a1.ro,0,1,0,1,-1.0,1.0
tată,a1.ro,1,2,12,15,-0.06666666666666667,0.06666666666666667
Călimănești,www.gandul.ro,0,0,1,1,0.0,0.0
Dorinel Umbrărescu,www.gandul.ro,0,0,1,1,0.0,0.0
Drulă,www.gandul.ro,0,1,0,1,-1.0,1.0
Florin Barbu,www.gandul.ro,0,0,2,2,0.0,0.0
Vrancea,www.gandul.ro,0,0,1,1,0.0,0.0
constructor,www.gandul.ro,2,0,1,3,0.6666666666666666,0.6666666666666666
fermier,www.gandul.ro,1,0,1,2,0.5,0.5
lucrător,www.gandul.ro,0,1,0,1,-1.0,1.0
victimă,www.gandul.ro,0,1,2,3,-0.3333333333333333,0.3333333333333333
vinovat,www.gandul.ro,0,2,0,2,-1.0,1.0
alegător,www.gandul.ro,0,3,14,17,-0.17647058823529413,0.17647058823529413
Austria,www.gandul.ro,0,1,3,4,-0.25,0.25
Malta,www.gandul.ro,0,0,2,2,0.0,0.0
Marius Bodea,www.gandul.ro,0,0,1,1,0.0,0.0
Mihail Pintilei,www.gandul.ro,0,0,1,1,0.0,0.0
Tudor Ciuhodaru,www.gandul.ro,0,0,1,1,0.0,0.0
personal,www.gandul.ro,0,1,4,5,-0.2,0.2
poses,www.gandul.ro,0,1,0,1,-1.0,1.0
responsabil,www.gandul.ro,0,1,0,1,-1.0,1.0
solicitant,www.gandul.ro,0,0,2,2,0.0,0.0
Adinei Valean,a1.ro,0,0,1,1,0.0,0.0
Bruxelles,a1.ro,0,0,6,6,0.0,0.0
Ilie Sarbu,a1.ro,0,1,0,1,-1.0,1.0
Buzău,www.activenews.ro,0,0,2,2,0.0,0.0
contracandidat,www.activenews.ro,0,4,0,4,-1.0,1.0
procuror general,www.activenews.ro,0,3,0,3,-1.0,1.0
Alex Florin Florența,www.activenews.ro,0,0,1,1,0.0,0.0
Valerian Stan,www.activenews.ro,1,1,2,4,0.0,0.0
Săpoca,www.activenews.ro,0,0,1,1,0.0,0.0
sociolog,www.realitatea.net,0,0,3,3,0.0,0.0
Vasile Dâncu,www.realitatea.net,0,0,1,1,0.0,0.0
funcționar,www.realitatea.net,0,1,0,1,-1.0,1.0
Andrei Țărnea,www.antena3.ro,0,0,2,2,0.0,0.0
Hurezeanu,www.antena3.ro,0,0,2,2,0.0,0.0
miliardar,www.antena3.ro,0,1,0,1,-1.0,1.0
purtător de cuvânt,www.antena3.ro,0,0,3,3,0.0,0.0
Argeș,a1.ro,0,2,4,6,-0.3333333333333333,0.3333333333333333
Gabriel Oprea,a1.ro,0,1,0,1,-1.0,1.0
Georgiu Gingaras,a1.ro,0,0,1,1,0.0,0.0
Gingaras,a1.ro,0,0,1,1,0.0,0.0
Iliescu,a1.ro,0,4,2,6,-0.6666666666666666,0.6666666666666666
Luminita Gheorghiu,a1.ro,0,0,1,1,0.0,0.0
Luminița Iordache,a1.ro,0,0,2,2,0.0,0.0
Nastase,a1.ro,0,2,3,5,-0.4,0.4
Bruxelles,www.antena3.ro,0,2,7,9,-0.2222222222222222,0.2222222222222222
Budapesta,www.antena3.ro,0,1,1,2,-0.5,0.5
Estonia,www.antena3.ro,0,0,2,2,0.0,0.0
Luxemburg,www.antena3.ro,0,0,1,1,0.0,0.0
Margus Tsahkna,www.antena3.ro,0,0,1,1,0.0,0.0
Moscova,www.antena3.ro,0,5,0,5,-1.0,1.0
Polonia,www.antena3.ro,0,1,5,6,-0.16666666666666666,0.16666666666666666
Radoslav Sikorski,www.antena3.ro,0,0,2,2,0.0,0.0
Tsahkna,www.antena3.ro,0,0,1,1,0.0,0.0
Ungaria,www.antena3.ro,1,3,2,6,-0.3333333333333333,0.3333333333333333
Viktor Orban,www.antena3.ro,0,1,1,2,-0.5,0.5
miniștri,www.antena3.ro,0,2,1,3,-0.6666666666666666,0.6666666666666666
Beniamin Netanyahu,www.euronews.ro,0,1,3,4,-0.25,0.25
Chișinău,www.euronews.ro,0,2,2,4,-0.5,0.5
Evghenia Guțul,www.euronews.ro,0,1,0,1,-1.0,1.0
Evghenie Guțul,www.euronews.ro,0,1,0,1,-1.0,1.0
Guvernatoare,www.euronews.ro,0,1,0,1,-1.0,1.0
Găgăuzia,www.euronews.ro,0,0,1,1,0.0,0.0
Istanbul,www.euronews.ro,0,0,5,5,0.0,0.0
Vladimir Putin,www.euronews.ro,0,6,7,13,-0.46153846153846156,0.46153846153846156
Ribera,www.euronews.ro,0,0,1,1,0.0,0.0
Teresa Ribera,www.euronews.ro,0,0,1,1,0.0,0.0
Vicepreședintele,www.euronews.ro,0,0,1,1,0.0,0.0
bașcană,www.euronews.ro,0,1,0,1,-1.0,1.0
edil,www.euronews.ro,0,2,7,9,-0.2222222222222222,0.2222222222222222
ostatic,www.euronews.ro,0,5,1,6,-0.8333333333333334,0.8333333333333334
Cristina Trăilă,www.digi24.ro,0,0,1,1,0.0,0.0
Mircea Abrudean,www.digi24.ro,0,0,3,3,0.0,0.0
Belgrad,observatornews.ro,0,1,5,6,-0.16666666666666666,0.16666666666666666
Dinescu,observatornews.ro,0,1,0,1,-1.0,1.0
George Becali,observatornews.ro,0,1,0,1,-1.0,1.0
Mircea Dinescu,observatornews.ro,0,1,0,1,-1.0,1.0
unit,www.antena3.ro,0,1,0,1,-1.0,1.0
personal,www.romaniatv.net,1,3,6,10,-0.2,0.2
stat,www.romaniatv.net,0,1,0,1,-1.0,1.0
Lavric,www.romaniatv.net,0,0,1,1,0.0,0.0
Sorin Lavric,www.romaniatv.net,0,0,1,1,0.0,0.0
Andreea Marinescu,agerpres.ro,0,0,6,6,0.0,0.0
George Bănciulea,agerpres.ro,0,0,3,3,0.0,0.0
Dominic Fritz,primanews.ro,0,0,3,3,0.0,0.0
dumnealui,www.cotidianul.ro,0,0,1,1,0.0,0.0
Kivu,adevarul.ro,0,0,1,1,0.0,0.0
Mircea Kivu,adevarul.ro,0,0,6,6,0.0,0.0
Radu Magdin,adevarul.ro,1,0,6,7,0.14285714285714285,0.14285714285714285
Turcan,adevarul.ro,0,0,4,4,0.0,0.0
Valeriu Turcan,adevarul.ro,0,0,5,5,0.0,0.0
adversar,adevarul.ro,0,13,0,13,-1.0,1.0
sider,adevarul.ro,0,0,1,1,0.0,0.0
Câmpulung,www.gandul.ro,1,0,2,3,0.3333333333333333,0.3333333333333333
Câmpulung Muscel,www.gandul.ro,0,0,1,1,0.0,0.0
Elena,www.gandul.ro,1,1,0,2,0.0,0.0
Kamala,www.gandul.ro,1,0,1,2,0.5,0.5
Mehedinți,www.gandul.ro,0,0,1,1,0.0,0.0
blondă,www.gandul.ro,0,0,1,1,0.0,0.0
primăriță,www.gandul.ro,0,1,1,2,-0.5,0.5
Cluj,stirileprotv.ro,0,0,3,3,0.0,0.0
Dragoș Pâslaru,stirileprotv.ro,0,0,1,1,0.0,0.0
Mirabela Amarandei,stirileprotv.ro,0,0,1,1,0.0,0.0
Dominic Fritz,www.comisarul.ro,0,0,1,1,0.0,0.0
Domnic Fritz,www.comisarul.ro,0,0,1,1,0.0,0.0
Ionuț Moșteanu,www.comisarul.ro,0,2,6,8,-0.25,0.25
câștigător,www.romaniatv.net,0,1,5,6,-0.16666666666666666,0.16666666666666666
Belarus,www.comisarul.ro,0,2,0,2,-1.0,1.0
Câmpulung,www.comisarul.ro,0,0,1,1,0.0,0.0
Daniel David,www.comisarul.ro,0,0,4,4,0.0,0.0
Federația Rusă,www.comisarul.ro,0,3,2,5,-0.6,0.6
Ludovic Orban,www.comisarul.ro,0,0,1,1,0.0,0.0
Matei Păun,www.comisarul.ro,1,1,1,3,0.0,0.0
Nicușor Dan Lasconi,www.comisarul.ro,0,1,0,1,-1.0,1.0
Radu Delicote,www.comisarul.ro,0,0,4,4,0.0,0.0
Lucian Romașcanu,agerpres.ro,0,1,4,5,-0.2,0.2
Romeo Lungu,agerpres.ro,0,0,6,6,0.0,0.0
Cehoslovacia,www.comisarul.ro,0,0,1,1,0.0,0.0
Iugoslavia,www.comisarul.ro,0,1,0,1,-1.0,1.0
nostalgic,www.comisarul.ro,0,2,0,2,-1.0,1.0
cizmar,www.comisarul.ro,0,1,0,1,-1.0,1.0
internaut,www.comisarul.ro,0,1,1,2,-0.5,0.5
vânzătoare,www.comisarul.ro,0,1,0,1,-1.0,1.0
Claudiu Năsui,www.gandul.ro,0,0,2,2,0.0,0.0
Cotroceni,www.gandul.ro,0,0,4,4,0.0,0.0
Fritz,www.gandul.ro,0,5,2,7,-0.7142857142857143,0.7142857142857143
George Gârbacea,www.gandul.ro,0,0,2,2,0.0,0.0
Lasconi,www.gandul.ro,1,5,15,21,-0.19047619047619047,0.19047619047619047
Mihaela Pițigoi,www.gandul.ro,0,0,2,2,0.0,0.0
Oana Anghel,www.gandul.ro,0,0,2,2,0.0,0.0
Ciprian Necula,www.gandul.ro,0,0,4,4,0.0,0.0
Emmanuel Macron,www.comisarul.ro,0,1,4,5,-0.2,0.2
Alina Păduraru,recorder.ro,0,0,1,1,0.0,0.0
Aurelian Bădulescu,recorder.ro,0,1,1,2,-0.5,0.5
Avram,recorder.ro,0,1,0,1,-1.0,1.0
capitală,recorder.ro,0,3,2,5,-0.6,0.6
Cehia,recorder.ro,0,1,0,1,-1.0,1.0
Cosmin Râță,recorder.ro,0,0,1,1,0.0,0.0
Helly,recorder.ro,0,1,0,1,-1.0,1.0
Iran,recorder.ro,0,1,2,3,-0.3333333333333333,0.3333333333333333
Liban,recorder.ro,0,3,2,5,-0.6,0.6
Magor Csibi,recorder.ro,0,0,1,1,0.0,0.0
Mozart,recorder.ro,0,0,1,1,0.0,0.0
Pantelimon,recorder.ro,0,3,0,3,-1.0,1.0
Petru Avram,recorder.ro,0,1,1,2,-0.5,0.5
Radu Predescu,recorder.ro,0,0,1,1,0.0,0.0
Record,recorder.ro,1,0,1,2,0.5,0.5
Sam Altman,recorder.ro,1,0,0,1,1.0,1.0
Severance,recorder.ro,0,1,0,1,-1.0,1.0
Sibiu,recorder.ro,2,0,9,11,0.18181818181818182,0.18181818181818182
Sorin Frunzăverde,recorder.ro,0,0,1,1,0.0,0.0
stat,recorder.ro,0,2,0,2,-1.0,1.0
Vlase,recorder.ro,0,1,0,1,-1.0,1.0
Meryl Streep,recorder.ro,0,0,1,1,0.0,0.0
an,recorder.ro,0,1,2,3,-0.3333333333333333,0.3333333333333333
arhitect,recorder.ro,1,0,2,3,0.3333333333333333,0.3333333333333333
cercetător,recorder.ro,1,0,6,7,0.14285714285714285,0.14285714285714285
deținut,recorder.ro,0,3,2,5,-0.6,0.6
familia Iohannis,recorder.ro,0,1,0,1,-1.0,1.0
mascaț,recorder.ro,0,1,0,1,-1.0,1.0
muzician,recorder.ro,1,0,1,2,0.5,0.5
plagiator,recorder.ro,0,1,0,1,-1.0,1.0
poștaș,recorder.ro,0,1,0,1,-1.0,1.0
purtător,recorder.ro,0,2,0,2,-1.0,1.0
trădător,recorder.ro,0,1,0,1,-1.0,1.0
vatman,recorder.ro,0,1,0,1,-1.0,1.0
știu,recorder.ro,0,1,0,1,-1.0,1.0
Călin Popescu Tăriceanu,www.comisarul.ro,0,0,1,1,0.0,0.0
fondator,www.comisarul.ro,0,1,6,7,-0.14285714285714285,0.14285714285714285
miner,www.romaniatv.net,0,1,0,1,-1.0,1.0
minier,www.romaniatv.net,0,1,0,1,-1.0,1.0
oponent,www.romaniatv.net,0,1,0,1,-1.0,1.0
Miron Cozma,www.digi24.ro,0,1,1,2,-0.5,0.5
Președintele,www.digi24.ro,0,0,4,4,0.0,0.0
Eugen Sechila,www.romaniatv.net,0,1,0,1,-1.0,1.0
Iliescu,observatornews.ro,0,2,3,5,-0.4,0.4
Ion Iliescu,observatornews.ro,0,0,8,8,0.0,0.0
procuror,observatornews.ro,0,16,5,21,-0.7619047619047619,0.7619047619047619
interlocutor,observatornews.ro,0,2,1,3,-0.6666666666666666,0.6666666666666666
minier,observatornews.ro,0,2,0,2,-1.0,1.0
mort,observatornews.ro,0,2,0,2,-1.0,1.0
Abrudean,agerpres.ro,0,0,3,3,0.0,0.0
Nadia Cerva,agerpres.ro,0,0,1,1,0.0,0.0
constructor,primanews.ro,0,0,2,2,0.0,0.0
Salon,primanews.ro,0,0,1,1,0.0,0.0
Ungaria,primanews.ro,1,1,3,5,0.0,0.0
Oradea,a1.ro,0,0,3,3,0.0,0.0
Cristian Poteras,stirileprotv.ro,0,0,1,1,0.0,0.0
Poteras,stirileprotv.ro,0,1,0,1,-1.0,1.0
Danut Liga,stirileprotv.ro,0,1,0,1,-1.0,1.0
Băile Herculane,www.gandul.ro,0,0,1,1,0.0,0.0
Ciolpani,www.gandul.ro,0,0,1,1,0.0,0.0
Marcian Bleahu,www.gandul.ro,0,0,1,1,0.0,0.0
Potra,www.gandul.ro,0,0,1,1,0.0,0.0
Theodor Stolojan,www.gandul.ro,0,0,1,1,0.0,0.0
critic,www.gandul.ro,0,3,0,3,-1.0,1.0
internaut,www.gandul.ro,0,1,0,1,-1.0,1.0
istoric,www.gandul.ro,0,0,1,1,0.0,0.0
outsider,www.gandul.ro,0,1,0,1,-1.0,1.0
promotor,www.gandul.ro,0,2,0,2,-1.0,1.0
Armean,pressone.ro,0,0,1,1,0.0,0.0
bihorean,pressone.ro,0,0,1,1,0.0,0.0
Florian Dorel Bodog,pressone.ro,0,1,0,1,-1.0,1.0
Gabriel Oprea,pressone.ro,0,7,8,15,-0.4666666666666667,0.4666666666666667
Lucia Daina,pressone.ro,0,0,4,4,0.0,0.0
decan,pressone.ro,0,1,4,5,-0.2,0.2
Mihai C. Demetrescu,pressone.ro,0,0,1,1,0.0,0.0
Gheorghe Ionescu,pressone.ro,0,0,1,1,0.0,0.0
Petru Armean,pressone.ro,0,0,2,2,0.0,0.0
Armand,www.gandul.ro,0,2,2,4,-0.5,0.5
Moșteanu,www.gandul.ro,0,2,3,5,-0.4,0.4
activist,adevarul.ro,1,3,4,8,-0.25,0.25
Alfred Simonis,adevarul.ro,0,2,3,5,-0.4,0.4
Daniel Fenechiu,adevarul.ro,0,1,0,1,-1.0,1.0
Focșani,adevarul.ro,0,0,1,1,0.0,0.0
Imperiul Țarist,adevarul.ro,0,1,0,1,-1.0,1.0
politică,adevarul.ro,0,1,0,1,-1.0,1.0
Virgil Popescu,adevarul.ro,0,2,0,2,-1.0,1.0
Vrancea,adevarul.ro,0,0,5,5,0.0,0.0
non grat,adevarul.ro,0,1,0,1,-1.0,1.0
Șerban Nicolae,adevarul.ro,0,1,2,3,-0.3333333333333333,0.3333333333333333
unionist,adevarul.ro,0,1,0,1,-1.0,1.0
afacerist,snoop.ro,0,11,2,13,-0.8461538461538461,0.8461538461538461
Baia Sprie,snoop.ro,0,0,1,1,0.0,0.0
Boc,snoop.ro,0,1,0,1,-1.0,1.0
Cherecheș,snoop.ro,0,1,0,1,-1.0,1.0
Cătălin Cherecheș,snoop.ro,0,1,0,1,-1.0,1.0
dezvoltator,snoop.ro,0,3,2,5,-0.6,0.6
Emil Boc,snoop.ro,0,1,1,2,-0.5,0.5
Ioan Rus,snoop.ro,0,0,2,2,0.0,0.0
Maramureș,snoop.ro,0,0,6,6,0.0,0.0
Mohammad Murad,snoop.ro,0,0,2,2,0.0,0.0
Pușcaș,snoop.ro,0,2,0,2,-1.0,1.0
Romeo Dunca,snoop.ro,0,0,3,3,0.0,0.0
Sile Pușcaș,snoop.ro,0,0,1,1,0.0,0.0
Simion Sile Pușcaș,snoop.ro,0,0,1,1,0.0,0.0
Vasile Dîncu,snoop.ro,0,0,2,2,0.0,0.0
Vasile Pușcaș,snoop.ro,0,0,2,2,0.0,0.0
asociat,snoop.ro,0,2,7,9,-0.2222222222222222,0.2222222222222222
președinte interimar,stirileprotv.ro,0,1,1,2,-0.5,0.5
Andreei Pocotilă,recorder.ro,0,1,0,1,-1.0,1.0
Hamas,recorder.ro,0,1,0,1,-1.0,1.0
Khan Younis,recorder.ro,0,1,0,1,-1.0,1.0
Papa Francisc,recorder.ro,0,0,3,3,0.0,0.0
Rafah,recorder.ro,0,0,1,1,0.0,0.0
Sebastian Burcă,recorder.ro,0,1,0,1,-1.0,1.0
civil,recorder.ro,0,7,4,11,-0.6363636363636364,0.6363636363636364
lunetist,recorder.ro,0,1,0,1,-1.0,1.0
personal medical,recorder.ro,1,1,2,4,0.0,0.0
soldat,recorder.ro,0,6,5,11,-0.5454545454545454,0.5454545454545454
î,recorder.ro,0,0,1,1,0.0,0.0
,snoop.ro,0,2,4,6,-0.3333333333333333,0.3333333333333333
Alexandru Rafila,snoop.ro,0,0,8,8,0.0,0.0
Andrei Ciolacu,snoop.ro,0,0,1,1,0.0,0.0
Balș,snoop.ro,0,0,1,1,0.0,0.0
Ciolacu Jr,snoop.ro,0,1,1,2,-0.5,0.5
coordonator,snoop.ro,0,3,10,13,-0.23076923076923078,0.23076923076923078
Călărași,snoop.ro,0,1,4,5,-0.2,0.2
Felix Stroe,snoop.ro,0,0,1,1,0.0,0.0
Filip Andrei Ciolacu,snoop.ro,0,2,0,2,-1.0,1.0
Filip Ciolacu,snoop.ro,0,0,1,1,0.0,0.0
Hârșova,snoop.ro,0,0,1,1,0.0,0.0
Matei Balș,snoop.ro,0,1,0,1,-1.0,1.0
Medicul Ciolacu,snoop.ro,0,1,0,1,-1.0,1.0
Mehedințu,snoop.ro,0,1,0,1,-1.0,1.0
Mihai Mehedințu,snoop.ro,0,0,1,1,0.0,0.0
Rafila,snoop.ro,0,1,4,5,-0.2,0.2
Monaco,snoop.ro,0,0,1,1,0.0,0.0
Măcin,snoop.ro,0,0,1,1,0.0,0.0
Negrești,snoop.ro,0,0,1,1,0.0,0.0
Nelu Tătaru,snoop.ro,0,1,0,1,-1.0,1.0
Nisa,snoop.ro,0,0,1,1,0.0,0.0
Panciu,snoop.ro,0,0,1,1,0.0,0.0
Adrian Man,snoop.ro,0,0,2,2,0.0,0.0
Rareș Vrîncianu,snoop.ro,0,0,2,2,0.0,0.0
Târgu,snoop.ro,0,0,2,2,0.0,0.0
Vrîncianu,snoop.ro,0,0,1,1,0.0,0.0
Vrîncianu Ciolacu,snoop.ro,0,1,0,1,-1.0,1.0
coordonator-șef,snoop.ro,0,1,0,1,-1.0,1.0
Andrei Filip Ciolacu,snoop.ro,0,0,1,1,0.0,0.0
economist,snoop.ro,0,0,1,1,0.0,0.0
medic rezident,snoop.ro,0,0,1,1,0.0,0.0
Man,snoop.ro,0,0,1,1,0.0,0.0
nepot,snoop.ro,0,2,4,6,-0.3333333333333333,0.3333333333333333
olac,snoop.ro,0,0,1,1,0.0,0.0
pasager,snoop.ro,0,0,4,4,0.0,0.0
unchi,snoop.ro,0,1,1,2,-0.5,0.5
veri,snoop.ro,0,1,1,2,-0.5,0.5
Adi Iacob,www.comisarul.ro,0,0,2,2,0.0,0.0
Alexandra Nistor,www.comisarul.ro,0,0,2,2,0.0,0.0
Bulgaria,www.comisarul.ro,0,0,5,5,0.0,0.0
Ciocoii,www.comisarul.ro,0,2,0,2,-1.0,1.0
Cristela Georgescu,www.comisarul.ro,0,0,4,4,0.0,0.0
Călin,www.comisarul.ro,1,0,1,2,0.5,0.5
David Leonard Bularca,www.comisarul.ro,0,0,2,2,0.0,0.0
Dan Mihai Bălănescu,www.comisarul.ro,0,0,2,2,0.0,0.0
Laurențiu Ungureanu,www.comisarul.ro,0,0,2,2,0.0,0.0
manifestant,www.comisarul.ro,0,6,4,10,-0.6,0.6
Nicolae Cotruț,www.comisarul.ro,0,0,2,2,0.0,0.0
organizator,www.comisarul.ro,0,2,5,7,-0.2857142857142857,0.2857142857142857
protestatar,www.comisarul.ro,0,3,22,25,-0.12,0.12
Soții Georgescu,www.comisarul.ro,0,1,1,2,-0.5,0.5
cititor,www.comisarul.ro,0,0,3,3,0.0,0.0
manifestanț,www.comisarul.ro,0,3,2,5,-0.6,0.6
manifestație,www.comisarul.ro,0,1,1,2,-0.5,0.5
olac,www.comisarul.ro,0,1,0,1,-1.0,1.0
participant,www.comisarul.ro,0,1,7,8,-0.125,0.125
securist,www.comisarul.ro,0,2,0,2,-1.0,1.0
magistrat,observatornews.ro,0,5,1,6,-0.8333333333333334,0.8333333333333334
nu,www.gandul.ro,0,1,0,1,-1.0,1.0
Aldous Huxley,recorder.ro,0,0,1,1,0.0,0.0
Colchester,recorder.ro,0,0,1,1,0.0,0.0
Essex,recorder.ro,0,0,1,1,0.0,0.0
fetele,recorder.ro,1,1,0,2,0.0,0.0
Lawrence Freedman,recorder.ro,0,0,2,2,0.0,0.0
Michael Ende,recorder.ro,0,0,1,1,0.0,0.0
Radu Mihail,recorder.ro,0,0,1,1,0.0,0.0
Roma,recorder.ro,0,0,2,2,0.0,0.0
Simina Tulbu,recorder.ro,0,0,1,1,0.0,0.0
Suceava,recorder.ro,0,2,6,8,-0.25,0.25
Toader Ciuta,recorder.ro,0,0,1,1,0.0,0.0
Valentin Ilie Făgărășian,recorder.ro,0,0,1,1,0.0,0.0
Viorel Badea,recorder.ro,0,0,1,1,0.0,0.0
barman,recorder.ro,0,0,2,2,0.0,0.0
diasporă,recorder.ro,0,1,1,2,-0.5,0.5
dușman,recorder.ro,0,3,0,3,-1.0,1.0
proferor,recorder.ro,0,1,0,1,-1.0,1.0
stagiar,recorder.ro,0,0,4,4,0.0,0.0
Ștefan Iulian Lorincz,recorder.ro,0,0,1,1,0.0,0.0
Livia Popescu,agerpres.ro,0,0,19,19,0.0,0.0
Maramureș,agerpres.ro,1,0,0,1,1.0,1.0
Eugen Tomac,adevarul.ro,0,0,4,4,0.0,0.0
Tomac,adevarul.ro,0,0,2,2,0.0,0.0
prim-ministru,a1.ro,1,2,6,9,-0.1111111111111111,0.1111111111111111
Andrei Cruceru,www.realitatea.net,0,1,0,1,-1.0,1.0
Belgrad,www.realitatea.net,0,1,6,7,-0.14285714285714285,0.14285714285714285
beneficiar,www.realitatea.net,1,1,0,2,0.0,0.0
Giorgia Bordușanu,www.realitatea.net,0,0,1,1,0.0,0.0
Ploiești,www.realitatea.net,0,0,1,1,0.0,0.0
angajat,www.realitatea.net,0,0,4,4,0.0,0.0
colaborator,www.realitatea.net,0,1,0,1,-1.0,1.0
director,www.realitatea.net,0,2,2,4,-0.5,0.5
fugar,www.realitatea.net,0,3,0,3,-1.0,1.0
inspector,www.realitatea.net,0,1,0,1,-1.0,1.0
penal,www.realitatea.net,0,2,0,2,-1.0,1.0
Adrian Echert,www.antena3.ro,0,0,1,1,0.0,0.0
Andreea Dumitrache,www.antena3.ro,0,0,3,3,0.0,0.0
Marius Pieleanu,www.antena3.ro,0,0,4,4,0.0,0.0
Pieleanu,www.antena3.ro,0,0,1,1,0.0,0.0
Sibiu,www.antena3.ro,0,0,3,3,0.0,0.0
America,adevarul.ro,1,2,3,6,-0.16666666666666666,0.16666666666666666
secretar general,adevarul.ro,0,1,25,26,-0.038461538461538464,0.038461538461538464
Andrei Roman,www.comisarul.ro,0,0,4,4,0.0,0.0
primar general,www.comisarul.ro,0,4,0,4,-1.0,1.0
Mihail Neamțu,www.comisarul.ro,0,1,0,1,-1.0,1.0
Neamțu,www.comisarul.ro,0,1,0,1,-1.0,1.0
Negrea,www.comisarul.ro,0,1,0,1,-1.0,1.0
Sorin Constantinescu,www.comisarul.ro,0,1,2,3,-0.3333333333333333,0.3333333333333333
Stelian Negrea,www.comisarul.ro,0,1,1,2,-0.5,0.5
Alexandru Cojocaru,agerpres.ro,0,0,9,9,0.0,0.0
Președintele,agerpres.ro,0,0,2,2,0.0,0.0
Anatol Șalaru,www.g4media.ro,0,0,2,2,0.0,0.0
Cernăuți,www.g4media.ro,0,1,0,1,-1.0,1.0
Republica Moldova,www.g4media.ro,1,3,7,11,-0.18181818181818182,0.18181818181818182
spion,www.g4media.ro,0,1,0,1,-1.0,1.0
șalar,www.g4media.ro,0,0,1,1,0.0,0.0
America,www.gandul.ro,0,0,4,4,0.0,0.0
Dan Dugaciu,www.gandul.ro,0,0,1,1,0.0,0.0
Dan Dungaciu,www.gandul.ro,0,0,5,5,0.0,0.0
Statele Unite,www.gandul.ro,4,3,15,22,0.045454545454545456,0.045454545454545456
Bucresti,www.realitatea.net,0,0,1,1,0.0,0.0
J.D. Vance,www.realitatea.net,0,1,0,1,-1.0,1.0
Musk,www.realitatea.net,1,1,1,3,0.0,0.0
Washington,www.realitatea.net,0,1,2,3,-0.3333333333333333,0.3333333333333333
Claudiu Tarziu,www.realitatea.net,0,1,0,1,-1.0,1.0
tată,www.realitatea.net,0,0,2,2,0.0,0.0
Daniel Ghiță,recorder.ro,0,2,0,2,-1.0,1.0
Eduard Hellvig,recorder.ro,0,0,3,3,0.0,0.0
inițiator,recorder.ro,2,4,3,9,-0.2222222222222222,0.2222222222222222
Mihai Lasca,recorder.ro,0,0,1,1,0.0,0.0
Tik,recorder.ro,0,1,0,1,-1.0,1.0
cel,recorder.ro,0,0,2,2,0.0,0.0
Șoșoacă,recorder.ro,0,1,1,2,-0.5,0.5
Djuvara,www.gandul.ro,0,1,0,1,-1.0,1.0
Neagu Djuvara,www.gandul.ro,0,0,1,1,0.0,0.0
Moșteanu,www.comisarul.ro,0,0,2,2,0.0,0.0
Aleș,www.mediafax.ro,0,1,1,2,-0.5,0.5
Alfred Simonis,www.mediafax.ro,0,0,2,2,0.0,0.0
Eugen Teodorovici,www.mediafax.ro,0,2,5,7,-0.2857142857142857,0.2857142857142857
Tudorel Toader,www.mediafax.ro,0,1,3,4,-0.25,0.25
Alina Gorghiu,www.euronews.ro,1,0,3,4,0.25,0.25
Canadei,www.euronews.ro,1,0,0,1,1.0,1.0
Dan Șucu,www.euronews.ro,0,0,1,1,0.0,0.0
acționar,www.euronews.ro,0,0,2,2,0.0,0.0
judecător,www.euronews.ro,0,7,7,14,-0.5,0.5
proprietar,www.euronews.ro,0,1,0,1,-1.0,1.0
Anamaria Gavrila,www.luju.ro,0,1,3,4,-0.25,0.25
Gavrila,www.luju.ro,0,0,1,1,0.0,0.0
Ion Iliescu,www.luju.ro,0,2,1,3,-0.6666666666666666,0.6666666666666666
Mahatma Gandhi,www.luju.ro,1,0,0,1,1.0,1.0
Statele Unite,www.luju.ro,0,3,10,13,-0.23076923076923078,0.23076923076923078
celorlalți,www.luju.ro,0,2,0,2,-1.0,1.0
politică,www.luju.ro,0,1,0,1,-1.0,1.0
președintă,www.luju.ro,0,3,8,11,-0.2727272727272727,0.2727272727272727
soldat,www.luju.ro,0,1,0,1,-1.0,1.0
Cristian Pîrvulescu,observatornews.ro,0,0,18,18,0.0,0.0
Diana Sosoacă,observatornews.ro,0,0,1,1,0.0,0.0
grec,observatornews.ro,0,1,0,1,-1.0,1.0
Lavinia Șandru,primanews.ro,0,0,3,3,0.0,0.0
Claudiu,pressone.ro,1,0,0,1,1.0,1.0
Claudiu Nă,pressone.ro,1,0,0,1,1.0,1.0
Crimeea,pressone.ro,0,3,0,3,-1.0,1.0
Cristian Ghinea,pressone.ro,0,1,2,3,-0.3333333333333333,0.3333333333333333
Câmpulung,pressone.ro,0,2,1,3,-0.6666666666666666,0.6666666666666666
Frank Underwood,pressone.ro,0,1,0,1,-1.0,1.0
Kremlin,pressone.ro,0,2,0,2,-1.0,1.0
libertarian,pressone.ro,0,2,1,3,-0.6666666666666666,0.6666666666666666
Năsui,pressone.ro,0,1,1,2,-0.5,0.5
Scaraoțchi,pressone.ro,0,1,0,1,-1.0,1.0
acești,pressone.ro,0,1,0,1,-1.0,1.0
adept,pressone.ro,0,8,0,8,-1.0,1.0
colaborator,pressone.ro,1,7,5,13,-0.46153846153846156,0.46153846153846156
dictator,pressone.ro,0,4,0,4,-1.0,1.0
economișt,pressone.ro,0,3,0,3,-1.0,1.0
liber,pressone.ro,0,0,2,2,0.0,0.0
milionar,pressone.ro,0,3,0,3,-1.0,1.0
niciunul,pressone.ro,0,6,0,6,-1.0,1.0
omuleț,pressone.ro,0,1,0,1,-1.0,1.0
sui,pressone.ro,0,0,1,1,0.0,0.0
tovarăș,pressone.ro,0,1,1,2,-0.5,0.5
Arad,www.romaniatv.net,0,0,3,3,0.0,0.0
Ciolos,www.romaniatv.net,0,1,0,1,-1.0,1.0
cioloș,www.romaniatv.net,0,0,1,1,0.0,0.0
Dacian Cioloș,www.romaniatv.net,0,0,2,2,0.0,0.0
Florin Citu,www.romaniatv.net,0,1,0,1,-1.0,1.0
George Soros,www.romaniatv.net,0,1,0,1,-1.0,1.0
Gheorghe Falcă,www.romaniatv.net,0,0,2,2,0.0,0.0
Luminița Odobescu,www.romaniatv.net,0,0,2,2,0.0,0.0
Mohammad Murad,www.romaniatv.net,0,0,1,1,0.0,0.0
Monica Macovei,www.romaniatv.net,0,1,0,1,-1.0,1.0
Nicolae Ciucă,www.romaniatv.net,0,2,16,18,-0.1111111111111111,0.1111111111111111
Odobescu,www.romaniatv.net,0,0,1,1,0.0,0.0
Oradea,www.romaniatv.net,0,0,2,2,0.0,0.0
Resita,www.romaniatv.net,0,0,1,1,0.0,0.0
Sandra Pralong,www.romaniatv.net,0,1,0,1,-1.0,1.0
Tulcea,www.romaniatv.net,0,0,3,3,0.0,0.0
aliat,www.romaniatv.net,0,3,2,5,-0.6,0.6
ambasador,www.romaniatv.net,0,1,5,6,-0.16666666666666666,0.16666666666666666
Siegfried Mureșan,www.romaniatv.net,0,1,0,1,-1.0,1.0
locotenent,www.romaniatv.net,0,0,1,1,0.0,0.0
pescar,www.romaniatv.net,0,1,0,1,-1.0,1.0
prim-vicepreședinte,www.romaniatv.net,0,1,0,1,-1.0,1.0
Claudiu Târziu,agerpres.ro,0,0,9,9,0.0,0.0
Alin Fumurescu,pressone.ro,0,0,3,3,0.0,0.0
Anglia,pressone.ro,0,1,4,5,-0.2,0.2
Aristotel,pressone.ro,0,0,1,1,0.0,0.0
Celui,pressone.ro,0,1,0,1,-1.0,1.0
Chantal Delsol,pressone.ro,1,0,0,1,1.0,1.0
Chopin,pressone.ro,0,0,1,1,0.0,0.0
DomMa,pressone.ro,0,1,0,1,-1.0,1.0
Augustin,pressone.ro,0,0,1,1,0.0,0.0
Henry Clay,pressone.ro,1,0,0,1,1.0,1.0
Hobbes,pressone.ro,0,1,0,1,-1.0,1.0
John Morley,pressone.ro,0,0,1,1,0.0,0.0
Jordan,pressone.ro,0,0,1,1,0.0,0.0
Locke,pressone.ro,0,1,0,1,-1.0,1.0
Michael Jordan,pressone.ro,0,0,1,1,0.0,0.0
Oz,pressone.ro,1,0,0,1,1.0,1.0
Platon,pressone.ro,0,0,1,1,0.0,0.0
Profet,pressone.ro,0,1,0,1,-1.0,1.0
părinte fondator,pressone.ro,1,0,0,1,1.0,1.0
Sever Voinescu,pressone.ro,0,0,1,1,0.0,0.0
adolescent,pressone.ro,0,2,2,4,-0.5,0.5
asistent social,pressone.ro,0,0,1,1,0.0,0.0
egal,pressone.ro,0,0,1,1,0.0,0.0
gânditor,pressone.ro,0,1,1,2,-0.5,0.5
homosexual,pressone.ro,0,1,1,2,-0.5,0.5
monstru,pressone.ro,0,1,0,1,-1.0,1.0
pitic,pressone.ro,0,1,0,1,-1.0,1.0
Doru Căstăian,pressone.ro,0,0,1,1,0.0,0.0
sine,pressone.ro,0,1,0,1,-1.0,1.0
talanț,pressone.ro,0,1,0,1,-1.0,1.0
tâmpit,pressone.ro,0,2,0,2,-1.0,1.0
vrăjitor,pressone.ro,0,1,0,1,-1.0,1.0
Ă,pressone.ro,0,0,1,1,0.0,0.0
Ăștia,pressone.ro,0,2,0,2,-1.0,1.0
Burnete,www.gandul.ro,0,0,2,2,0.0,0.0
director executiv,www.gandul.ro,0,0,2,2,0.0,0.0
Guvern,www.gandul.ro,0,0,1,1,0.0,0.0
Radu Burnete,www.gandul.ro,0,0,1,1,0.0,0.0
guvernant,www.gandul.ro,0,1,0,1,-1.0,1.0
om de afaceri,www.gandul.ro,0,4,5,9,-0.4444444444444444,0.4444444444444444
Șucu,www.gandul.ro,0,0,1,1,0.0,0.0
Krzysztof Gawkowski,primanews.ro,0,0,2,2,0.0,0.0
Varșovia,primanews.ro,0,0,3,3,0.0,0.0
Andrew,www.comisarul.ro,0,0,1,1,0.0,0.0
Cristina Dumitrescu,www.cotidianul.ro,0,0,2,2,0.0,0.0
Matei Ștefănescu,www.cotidianul.ro,0,0,1,1,0.0,0.0
Silvestru Șoșoacă,www.cotidianul.ro,0,1,0,1,-1.0,1.0
Silvestru Șoșoască,www.cotidianul.ro,0,1,0,1,-1.0,1.0
Valentin Florea,www.cotidianul.ro,0,0,1,1,0.0,0.0
Vasile Dîncu,www.cotidianul.ro,0,0,4,4,0.0,0.0
apropiat,www.cotidianul.ro,0,7,1,8,-0.875,0.875
avocat,www.cotidianul.ro,0,4,1,5,-0.8,0.8
polițist,www.cotidianul.ro,0,4,3,7,-0.5714285714285714,0.5714285714285714
Chitila,recorder.ro,0,1,0,1,-1.0,1.0
căcâna,recorder.ro,0,2,1,3,-0.6666666666666666,0.6666666666666666
Dan Puric,recorder.ro,0,0,1,1,0.0,0.0
eu,recorder.ro,0,0,2,2,0.0,0.0
electorat,recorder.ro,1,13,6,20,-0.6,0.6
Mizil,recorder.ro,0,1,1,2,-0.5,0.5
prost,recorder.ro,0,1,0,1,-1.0,1.0
Soros,recorder.ro,0,1,0,1,-1.0,1.0
Săpânța,recorder.ro,0,0,1,1,0.0,0.0
bugetar,recorder.ro,0,12,2,14,-0.8571428571428571,0.8571428571428571
cleric,recorder.ro,0,2,0,2,-1.0,1.0
complici,recorder.ro,0,1,0,1,-1.0,1.0
făptaș,recorder.ro,0,2,0,2,-1.0,1.0
hipiot,recorder.ro,0,1,0,1,-1.0,1.0
român,recorder.ro,0,1,1,2,-0.5,0.5
tehnocrat,recorder.ro,0,1,0,1,-1.0,1.0
tătuc,recorder.ro,0,1,0,1,-1.0,1.0
vinovat,recorder.ro,0,1,0,1,-1.0,1.0
Alba Iulia,pressone.ro,0,0,6,6,0.0,0.0
Andrei Teodorescu,pressone.ro,0,0,2,2,0.0,0.0
Augustin Lazăr,pressone.ro,0,2,3,5,-0.4,0.4
Barbara Deppert,pressone.ro,0,0,1,1,0.0,0.0
Boston,pressone.ro,0,0,1,1,0.0,0.0
Dan Dimăncescu,pressone.ro,0,0,1,1,0.0,0.0
Decebal,pressone.ro,0,0,1,1,0.0,0.0
Elveția,pressone.ro,0,0,6,6,0.0,0.0
Frankfurt,pressone.ro,0,0,1,1,0.0,0.0
investigator,pressone.ro,0,0,1,1,0.0,0.0
Iulian Ceia,pressone.ro,0,0,1,1,0.0,0.0
Lucia Marinescu,pressone.ro,0,0,1,1,0.0,0.0
Protagonist,pressone.ro,0,0,1,1,0.0,0.0
regizor,pressone.ro,0,0,3,3,0.0,0.0
Sarmizegetusa,pressone.ro,0,0,1,1,0.0,0.0
Serbia,pressone.ro,0,7,3,10,-0.7,0.7
Viorica Luncan,pressone.ro,0,0,1,1,0.0,0.0
colecționar,pressone.ro,1,1,1,3,0.0,0.0
cămătar,pressone.ro,0,2,0,2,-1.0,1.0
căutător,pressone.ro,0,0,1,1,0.0,0.0
hunedorean,pressone.ro,0,1,0,1,-1.0,1.0
interlop,pressone.ro,0,9,0,9,-1.0,1.0
Radu Tora,pressone.ro,0,0,1,1,0.0,0.0
localnic,pressone.ro,0,6,2,8,-0.75,0.75
oră,pressone.ro,0,0,1,1,0.0,0.0
suspect,pressone.ro,0,9,0,9,-1.0,1.0
nebun,www.realitatea.net,0,1,0,1,-1.0,1.0
Miruță,www.b1tv.ro,0,1,0,1,-1.0,1.0
Drulă,stirileprotv.ro,0,0,2,2,0.0,0.0
denunțător,a1.ro,0,1,0,1,-1.0,1.0
Dumitru Rusu,a1.ro,0,1,0,1,-1.0,1.0
localnic,a1.ro,0,1,1,2,-0.5,0.5
Bruxelles,www.activenews.ro,0,6,2,8,-0.75,0.75
Cristian Diaconescu,www.activenews.ro,0,1,0,1,-1.0,1.0
Diaconeascu,www.activenews.ro,0,1,0,1,-1.0,1.0
Diaconescu,www.activenews.ro,0,1,0,1,-1.0,1.0
Hurezeanu,www.activenews.ro,0,1,0,1,-1.0,1.0
Paris,www.activenews.ro,0,0,3,3,0.0,0.0
Riad,www.activenews.ro,0,0,1,1,0.0,0.0
Vance,www.activenews.ro,1,0,1,2,0.5,0.5
cavaler,www.activenews.ro,0,1,0,1,-1.0,1.0
idioți,www.activenews.ro,0,1,0,1,-1.0,1.0
președinte interimar,www.activenews.ro,0,2,0,2,-1.0,1.0
traseist,www.activenews.ro,0,1,0,1,-1.0,1.0
șofer,www.activenews.ro,0,1,0,1,-1.0,1.0
J.D. Vance,www.activenews.ro,0,1,0,1,-1.0,1.0
Anastase,www.aktual24.ro,0,2,0,2,-1.0,1.0
Andrei Volosevici,www.aktual24.ro,0,0,1,1,0.0,0.0
Bogdan Nica,www.aktual24.ro,0,0,1,1,0.0,0.0
Cătălin,www.aktual24.ro,0,0,1,1,0.0,0.0
Cristian Ganea,www.aktual24.ro,0,0,1,1,0.0,0.0
Dan Nicodim,www.aktual24.ro,0,0,1,1,0.0,0.0
Gabriel Tudoran,www.aktual24.ro,0,0,1,1,0.0,0.0
Iulian Dumitrescu,www.aktual24.ro,0,1,0,1,-1.0,1.0
Madalina Lupea,www.aktual24.ro,0,1,0,1,-1.0,1.0
Mircea Rosca,www.aktual24.ro,0,1,0,1,-1.0,1.0
Oana Tanasica,www.aktual24.ro,0,0,1,1,0.0,0.0
Ploiești,www.aktual24.ro,0,1,3,4,-0.25,0.25
Prahova,www.aktual24.ro,0,0,1,1,0.0,0.0
Roberta Anastase,www.aktual24.ro,0,1,0,1,-1.0,1.0
Robert Anastase,www.aktual24.ro,0,1,0,1,-1.0,1.0
Rosca,www.aktual24.ro,0,1,0,1,-1.0,1.0
Viorel Dosaru,www.aktual24.ro,0,1,0,1,-1.0,1.0
Viorica Dancila,www.aktual24.ro,0,1,5,6,-0.16666666666666666,0.16666666666666666
interimar,www.aktual24.ro,0,0,1,1,0.0,0.0
prefect,www.aktual24.ro,0,1,1,2,-0.5,0.5
sest,www.aktual24.ro,0,1,0,1,-1.0,1.0
Andreea Cosma,www.cotidianul.ro,0,0,1,1,0.0,0.0
cumpărător,www.cotidianul.ro,0,2,0,2,-1.0,1.0
Ioana Băsescu,www.cotidianul.ro,0,0,1,1,0.0,0.0
Laura Vicol,www.cotidianul.ro,0,1,0,1,-1.0,1.0
Laurei Vicol,www.cotidianul.ro,0,1,0,1,-1.0,1.0
Mircea Cosma,www.cotidianul.ro,0,0,1,1,0.0,0.0
Prahova,www.cotidianul.ro,0,0,1,1,0.0,0.0
Păgubiții,www.cotidianul.ro,0,1,0,1,-1.0,1.0
Recorder,www.cotidianul.ro,0,0,1,1,0.0,0.0
Vladimir Ciorbă,www.cotidianul.ro,0,1,0,1,-1.0,1.0
actor,www.cotidianul.ro,2,2,3,7,0.0,0.0
administrator,www.cotidianul.ro,1,0,1,2,0.5,0.5
client,www.cotidianul.ro,0,2,1,3,-0.6666666666666666,0.6666666666666666
consumator,www.cotidianul.ro,0,3,0,3,-1.0,1.0
creditor,www.cotidianul.ro,0,1,0,1,-1.0,1.0
dezvoltator,www.cotidianul.ro,0,3,0,3,-1.0,1.0
fiică,www.cotidianul.ro,0,0,1,1,0.0,0.0
fondator,www.cotidianul.ro,0,1,2,3,-0.3333333333333333,0.3333333333333333
judecător,www.cotidianul.ro,1,5,1,7,-0.5714285714285714,0.5714285714285714
notar,www.cotidianul.ro,0,3,0,3,-1.0,1.0
om de afaceri,www.cotidianul.ro,0,1,4,5,-0.2,0.2
păgubit,www.cotidianul.ro,0,1,0,1,-1.0,1.0
păgub,www.cotidianul.ro,0,1,0,1,-1.0,1.0
păgubitor,www.cotidianul.ro,0,1,0,1,-1.0,1.0
,www.news.ro,0,3,0,3,-1.0,1.0
alegător,www.news.ro,0,6,2,8,-0.75,0.75
doamna Lasconi,www.news.ro,0,0,1,1,0.0,0.0
doamnă,www.news.ro,0,1,2,3,-0.3333333333333333,0.3333333333333333
dânș,www.news.ro,0,1,0,1,-1.0,1.0
pontiști,www.news.ro,0,1,0,1,-1.0,1.0
pontoman,www.news.ro,0,1,0,1,-1.0,1.0
Fota,www.b1tv.ro,0,0,1,1,0.0,0.0
birocrație,www.b1tv.ro,0,1,0,1,-1.0,1.0
lume,www.b1tv.ro,0,5,2,7,-0.7142857142857143,0.7142857142857143
popor,www.b1tv.ro,2,0,0,2,1.0,1.0
Bihor,www.euronews.ro,0,0,3,3,0.0,0.0
Bolojan,www.euronews.ro,1,1,11,13,0.0,0.0
jucător,www.euronews.ro,0,1,0,1,-1.0,1.0
lume,www.euronews.ro,0,4,1,5,-0.8,0.8
Ăștia,www.euronews.ro,0,1,0,1,-1.0,1.0
Alba,www.gandul.ro,1,0,1,2,0.5,0.5
Blaj,www.gandul.ro,0,0,1,1,0.0,0.0
eurodeputat,www.gandul.ro,1,0,1,2,0.5,0.5
Galda de Jos,www.gandul.ro,0,0,1,1,0.0,0.0
Ocna Mureș,www.gandul.ro,0,0,1,1,0.0,0.0
Victor Negrescu,www.gandul.ro,0,0,8,8,0.0,0.0
senior,www.gandul.ro,0,0,1,1,0.0,0.0
Al Madani,www.comisarul.ro,0,1,1,2,-0.5,0.5
Alep,www.comisarul.ro,0,0,1,1,0.0,0.0
Ayman Al Madani,www.comisarul.ro,0,0,1,1,0.0,0.0
Craiova,www.comisarul.ro,0,0,3,3,0.0,0.0
Dolj,www.comisarul.ro,0,0,2,2,0.0,0.0
Ion Iordache,www.comisarul.ro,0,0,2,2,0.0,0.0
Mihaela Al Madani,www.comisarul.ro,0,1,0,1,-1.0,1.0
Novaci,www.comisarul.ro,0,0,1,1,0.0,0.0
Runcu,www.comisarul.ro,0,0,1,1,0.0,0.0
Târgu Jiu,www.comisarul.ro,0,0,1,1,0.0,0.0
asistent manager,www.comisarul.ro,0,0,1,1,0.0,0.0
Șomeră,www.comisarul.ro,0,1,0,1,-1.0,1.0
Lituania,www.euronews.ro,0,0,1,1,0.0,0.0
șofer,www.euronews.ro,0,5,2,7,-0.7142857142857143,0.7142857142857143
primar general,www.b1tv.ro,0,1,2,3,-0.3333333333333333,0.3333333333333333
Mircea Diaconu,adevarul.ro,0,0,2,2,0.0,0.0
Predoiu,agerpres.ro,0,0,3,3,0.0,0.0
popor,agerpres.ro,2,2,3,7,0.0,0.0
trimit,agerpres.ro,0,0,1,1,0.0,0.0
Adrian Cozma,www.mediafax.ro,0,0,1,1,0.0,0.0
Daniel Fenechiu,www.mediafax.ro,0,0,1,1,0.0,0.0
Gabriel Andronache,www.mediafax.ro,0,0,1,1,0.0,0.0
Secretar General,observatornews.ro,0,0,1,1,0.0,0.0
Buzaru,www.aktual24.ro,0,1,0,1,-1.0,1.0
Buzatu,www.aktual24.ro,0,1,1,2,-0.5,0.5
Creti,www.aktual24.ro,0,1,0,1,-1.0,1.0
Cretu,www.aktual24.ro,0,1,0,1,-1.0,1.0
Dumitru Buzatu,www.aktual24.ro,0,0,1,1,0.0,0.0
Gabriela Cretu,www.aktual24.ro,0,0,2,2,0.0,0.0
senatoare,www.aktual24.ro,0,0,1,1,0.0,0.0
Tudor Buzatu,www.aktual24.ro,0,0,1,1,0.0,0.0
funcționar,www.aktual24.ro,0,1,2,3,-0.3333333333333333,0.3333333333333333
mulți,www.antena3.ro,0,1,0,1,-1.0,1.0
Aura Vasile,a1.ro,0,1,0,1,-1.0,1.0
Popoviciu,a1.ro,0,1,0,1,-1.0,1.0
comentator,a1.ro,0,1,0,1,-1.0,1.0
coprezentator,a1.ro,0,0,1,1,0.0,0.0
lume,www.realitatea.net,0,4,1,5,-0.8,0.8
Grindeanu,www.realitatea.net,0,0,1,1,0.0,0.0
Sorin Grindeanu,www.realitatea.net,0,0,1,1,0.0,0.0
miniștri,www.realitatea.net,0,2,1,3,-0.6666666666666666,0.6666666666666666
Becali,www.antena3.ro,0,3,3,6,-0.5,0.5
DJ,www.antena3.ro,0,1,0,1,-1.0,1.0
George Becali,www.antena3.ro,0,3,2,5,-0.6,0.6
Gigi Becali,www.antena3.ro,0,6,4,10,-0.6,0.6
Mustață,www.antena3.ro,0,1,0,1,-1.0,1.0
Palada,www.antena3.ro,0,1,0,1,-1.0,1.0
parlamentar,www.antena3.ro,0,15,8,23,-0.6521739130434783,0.6521739130434783
Soroș,www.antena3.ro,0,1,0,1,-1.0,1.0
găină,www.antena3.ro,0,1,0,1,-1.0,1.0
homosexual,www.antena3.ro,0,1,0,1,-1.0,1.0
nouă,www.antena3.ro,0,1,0,1,-1.0,1.0
polițist,www.antena3.ro,0,2,1,3,-0.6666666666666666,0.6666666666666666
specialist,www.antena3.ro,1,0,1,2,0.5,0.5
trădător,www.antena3.ro,0,1,0,1,-1.0,1.0
un,www.antena3.ro,0,1,0,1,-1.0,1.0
Ăștia,www.antena3.ro,0,1,0,1,-1.0,1.0
Corlățean,www.mediafax.ro,0,1,0,1,-1.0,1.0
Titus Corlățean,www.mediafax.ro,0,1,1,2,-0.5,0.5
Emil Chițac,www.mediafax.ro,0,1,0,1,-1.0,1.0
CTP,www.comisarul.ro,0,2,5,7,-0.2857142857142857,0.2857142857142857
Cristian Tudor Popescu,www.comisarul.ro,0,0,9,9,0.0,0.0
gazetar,www.comisarul.ro,0,3,4,7,-0.42857142857142855,0.42857142857142855
Angel Tîlvăr,www.digi24.ro,0,0,2,2,0.0,0.0
Rubio,www.digi24.ro,0,0,1,1,0.0,0.0
Daniel Funeriu,stirileprotv.ro,0,0,2,2,0.0,0.0
Ilie Sarbu,stirileprotv.ro,0,0,1,1,0.0,0.0
Puiu Hasotti,stirileprotv.ro,0,1,1,2,-0.5,0.5
Valeriu Turcan,stirileprotv.ro,0,1,0,1,-1.0,1.0
Niculina Stelea,www.comisarul.ro,0,0,2,2,0.0,0.0
senatoare,www.comisarul.ro,0,0,1,1,0.0,0.0
Claudiu Tarziu,www.romaniatv.net,0,0,1,1,0.0,0.0
Mănăstire,www.romaniatv.net,0,0,1,1,0.0,0.0
țar,www.romaniatv.net,0,1,0,1,-1.0,1.0
public,www.romaniatv.net,0,5,4,9,-0.5555555555555556,0.5555555555555556
Dan Andronic,adevarul.ro,0,0,1,1,0.0,0.0
Robert Turcescu,adevarul.ro,0,0,1,1,0.0,0.0
Steven Seagal,adevarul.ro,0,0,1,1,0.0,0.0
vecin,adevarul.ro,1,1,0,2,0.0,0.0
victima,adevarul.ro,0,4,2,6,-0.6666666666666666,0.6666666666666666
autor,www.antena3.ro,0,4,0,4,-1.0,1.0
Mircea Geoană,stirileprotv.ro,0,2,5,7,-0.2857142857142857,0.2857142857142857
Daniel Popescu,agerpres.ro,0,0,1,1,0.0,0.0
Maria Krause,agerpres.ro,0,0,2,2,0.0,0.0
Septimius Pârvu,agerpres.ro,0,0,1,1,0.0,0.0
vorbitor,agerpres.ro,0,0,2,2,0.0,0.0
Candid,www.gandul.ro,0,0,1,1,0.0,0.0
Mizil,www.gandul.ro,0,1,0,1,-1.0,1.0
Tanczos Barna,www.news.ro,0,0,4,4,0.0,0.0
Adrian Toni Neacsu,www.luju.ro,2,4,4,10,-0.2,0.2
Toni Neacsu,www.luju.ro,0,1,0,1,-1.0,1.0
castigator,www.luju.ro,1,2,0,3,-0.3333333333333333,0.3333333333333333
Adina Lupea,www.luju.ro,0,1,0,1,-1.0,1.0
Neacsu,www.luju.ro,0,1,2,3,-0.3333333333333333,0.3333333333333333
Adina Vălean,www.g4media.ro,0,0,3,3,0.0,0.0
Belgia,www.g4media.ro,0,0,4,4,0.0,0.0
Doina Cornea,www.g4media.ro,3,0,0,3,1.0,1.0
Liechtenstein,www.g4media.ro,0,0,3,3,0.0,0.0
Liviu Dragnea,www.g4media.ro,0,3,3,6,-0.5,0.5
Lucian Boia,www.g4media.ro,1,0,2,3,0.3333333333333333,0.3333333333333333
Neagu Djuvara,www.g4media.ro,0,0,3,3,0.0,0.0
Niculițel,www.g4media.ro,0,0,3,3,0.0,0.0
Roșia Montană,www.g4media.ro,0,3,0,3,-1.0,1.0
Solești,www.g4media.ro,0,0,3,3,0.0,0.0
Tulcea,www.g4media.ro,0,0,5,5,0.0,0.0
Viktor Orban,www.g4media.ro,0,5,3,8,-0.625,0.625
Virgil Măgureanu,www.g4media.ro,0,3,0,3,-1.0,1.0
adept,www.g4media.ro,2,1,2,5,0.2,0.2
copreședinte,www.g4media.ro,0,0,5,5,0.0,0.0
figură,www.g4media.ro,3,1,0,4,0.5,0.5
Ion Antonescu,www.g4media.ro,0,3,3,6,-0.5,0.5
muzeograf,www.g4media.ro,0,0,3,3,0.0,0.0
sportiv,www.g4media.ro,3,0,0,3,1.0,1.0
Călin Gerogescu,www.digi24.ro,0,0,1,1,0.0,0.0
Cătălin Dumitru,www.digi24.ro,0,1,0,1,-1.0,1.0
Răzvan Săndulescu,www.digi24.ro,0,0,1,1,0.0,0.0
cer,www.digi24.ro,0,0,1,1,0.0,0.0
creator,www.digi24.ro,0,0,1,1,0.0,0.0
influencer,www.digi24.ro,0,1,3,4,-0.25,0.25
Adrian Mocanu,recorder.ro,0,0,1,1,0.0,0.0
Agatha Christie,recorder.ro,1,0,0,1,1.0,1.0
Andi Cristea,recorder.ro,0,0,1,1,0.0,0.0
Boboc,recorder.ro,0,0,1,1,0.0,0.0
Bobocu,recorder.ro,0,0,1,1,0.0,0.0
Buzău,recorder.ro,0,5,12,17,-0.29411764705882354,0.29411764705882354
Claudia Benchescu,recorder.ro,0,0,1,1,0.0,0.0
Dăncilă,recorder.ro,0,4,1,5,-0.8,0.8
Evgheni Vodolazkin,recorder.ro,0,0,1,1,0.0,0.0
Focșani,recorder.ro,0,0,1,1,0.0,0.0
Gabriel Avrămescu,recorder.ro,0,0,1,1,0.0,0.0
John,recorder.ro,0,0,1,1,0.0,0.0
Laurențiu Țepeluș,recorder.ro,0,0,1,1,0.0,0.0
Lisa Feldman Barrett,recorder.ro,0,0,1,1,0.0,0.0
Marian Voicu,recorder.ro,0,0,1,1,0.0,0.0
Octavian Stănășilă,recorder.ro,0,0,1,1,0.0,0.0
republică,recorder.ro,0,0,1,1,0.0,0.0
Romeo Lungu,recorder.ro,0,0,1,1,0.0,0.0
Râmnicu Sărat,recorder.ro,0,0,2,2,0.0,0.0
Steinbeck Gabriel Petrea,recorder.ro,0,0,1,1,0.0,0.0
Vlad Mircea Pufu,recorder.ro,0,0,1,1,0.0,0.0
Vălenii de Munte,recorder.ro,1,0,0,1,1.0,1.0
actorii,recorder.ro,1,0,2,3,0.3333333333333333,0.3333333333333333
asistent medical,recorder.ro,2,0,4,6,0.3333333333333333,0.3333333333333333
decident,recorder.ro,0,4,1,5,-0.8,0.8
economișt,recorder.ro,0,2,5,7,-0.2857142857142857,0.2857142857142857
instructor,recorder.ro,0,0,2,2,0.0,0.0
pedagog,recorder.ro,0,1,0,1,-1.0,1.0
posesor,recorder.ro,0,1,0,1,-1.0,1.0
redactor,recorder.ro,0,1,5,6,-0.16666666666666666,0.16666666666666666
sexolog,recorder.ro,0,0,2,2,0.0,0.0
vorbitor,recorder.ro,0,0,1,1,0.0,0.0
Elon Musk,www.aktual24.ro,1,0,3,4,0.25,0.25
Musk,www.aktual24.ro,0,1,1,2,-0.5,0.5
Wisconsin,www.aktual24.ro,0,0,1,1,0.0,0.0
politician,primanews.ro,0,8,0,8,-1.0,1.0
Abrudean,www.digi24.ro,0,0,1,1,0.0,0.0
Hurezeanu,www.digi24.ro,1,0,2,3,0.3333333333333333,0.3333333333333333
Mihai Sprînceană,www.digi24.ro,0,1,1,2,-0.5,0.5
Cilacu,observatornews.ro,0,0,1,1,0.0,0.0
"Csoma Botond, deputat",observatornews.ro,0,0,1,1,0.0,0.0
Dragoș Sprânceană,observatornews.ro,0,1,0,1,-1.0,1.0
Dragoș Sprînceană,observatornews.ro,0,0,1,1,0.0,0.0
Lucian Romașcanu,observatornews.ro,0,0,4,4,0.0,0.0
om de afaceri,observatornews.ro,0,1,7,8,-0.125,0.125
Sprînceană,observatornews.ro,0,0,1,1,0.0,0.0
Statele Unite,observatornews.ro,3,0,5,8,0.375,0.375
Valentin Naunescu,observatornews.ro,0,0,1,1,0.0,0.0
emisar,observatornews.ro,0,2,0,2,-1.0,1.0
oficial,observatornews.ro,0,6,3,9,-0.6666666666666666,0.6666666666666666
Ankara,primanews.ro,0,0,3,3,0.0,0.0
Doha,primanews.ro,0,0,2,2,0.0,0.0
Istanbul,primanews.ro,0,0,14,14,0.0,0.0
Maria Zaharova,primanews.ro,0,0,2,2,0.0,0.0
Qatar,primanews.ro,0,0,5,5,0.0,0.0
Recep Tayyip Erdogan,primanews.ro,0,0,6,6,0.0,0.0
Turciei,primanews.ro,0,0,2,2,0.0,0.0
Zaharova,primanews.ro,0,1,0,1,-1.0,1.0
pmolog,primanews.ro,0,1,0,1,-1.0,1.0
purtătoare de cuvânt,primanews.ro,0,0,1,1,0.0,0.0
șef de stat,primanews.ro,0,1,5,6,-0.16666666666666666,0.16666666666666666
Cîțu,primanews.ro,0,1,1,2,-0.5,0.5
Florin Cîțu,primanews.ro,0,3,4,7,-0.42857142857142855,0.42857142857142855
Adina Buzatu,a1.ro,1,0,3,4,0.25,0.25
Mirabela,a1.ro,0,0,3,3,0.0,0.0
altcineva,a1.ro,0,2,0,2,-1.0,1.0
șomer,a1.ro,0,1,0,1,-1.0,1.0
Abrudean,www.romaniatv.net,0,0,1,1,0.0,0.0
Mircea Abrudean,www.romaniatv.net,0,0,3,3,0.0,0.0
Simona Bucura-Oprescu,www.romaniatv.net,0,0,2,2,0.0,0.0
Sorin Grindeanu,www.mediafax.ro,0,1,8,9,-0.1111111111111111,0.1111111111111111
Cristian Pantazi,www.g4media.ro,0,0,2,2,0.0,0.0
Lasconi,www.g4media.ro,1,2,4,7,-0.14285714285714285,0.14285714285714285
oportunist,www.g4media.ro,0,1,0,1,-1.0,1.0
tehnocrat,www.g4media.ro,0,1,1,2,-0.5,0.5
învingător,www.g4media.ro,0,1,0,1,-1.0,1.0
Șoșoacă,www.g4media.ro,0,5,0,5,-1.0,1.0
Eugen Sechila,www.aktual24.ro,0,1,0,1,-1.0,1.0
Marcel Bourous,www.aktual24.ro,0,1,0,1,-1.0,1.0
Teodosie,www.aktual24.ro,0,1,0,1,-1.0,1.0
Zoe Radulescu,www.aktual24.ro,0,1,0,1,-1.0,1.0
fiică,www.aktual24.ro,0,2,5,7,-0.2857142857142857,0.2857142857142857
legionar,www.aktual24.ro,0,1,0,1,-1.0,1.0
Stefan Mindea,www.aktual24.ro,0,1,0,1,-1.0,1.0
om de afaceri,www.aktual24.ro,0,4,0,4,-1.0,1.0
pro,www.aktual24.ro,0,1,0,1,-1.0,1.0
soacră,www.aktual24.ro,0,1,0,1,-1.0,1.0
Bruxelles,www.mediafax.ro,0,1,2,3,-0.3333333333333333,0.3333333333333333
Cezar Preda,www.mediafax.ro,0,0,3,3,0.0,0.0
Aleksandar Vucic,snoop.ro,0,0,1,1,0.0,0.0
Alexander Nix Călin Georgescu,snoop.ro,0,0,1,1,0.0,0.0
Avrămescu,snoop.ro,0,0,1,1,0.0,0.0
beneficiar,snoop.ro,2,3,5,10,-0.1,0.1
Bogdan Marin,snoop.ro,0,0,1,1,0.0,0.0
Chelaru,snoop.ro,0,1,0,1,-1.0,1.0
Claudiu Târziu,snoop.ro,0,1,0,1,-1.0,1.0
Cluj,snoop.ro,0,0,9,9,0.0,0.0
Corneliu Zelea Codreanu,snoop.ro,0,1,0,1,-1.0,1.0
Cosmin Teodor Iosub,snoop.ro,0,0,1,1,0.0,0.0
Cristina Dumitrescu,snoop.ro,0,0,1,1,0.0,0.0
Dan Diaconescu,snoop.ro,0,0,2,2,0.0,0.0
Dan Ricardo Filimon,snoop.ro,0,1,0,1,-1.0,1.0
Daniel Răzvan Biro,snoop.ro,0,0,1,1,0.0,0.0
Dunca,snoop.ro,0,0,2,2,0.0,0.0
Filimon,snoop.ro,0,1,0,1,-1.0,1.0
Gheorghe Simion,snoop.ro,0,1,0,1,-1.0,1.0
George,snoop.ro,0,0,1,1,0.0,0.0
George Becali,snoop.ro,0,0,3,3,0.0,0.0
George Simon,snoop.ro,0,0,1,1,0.0,0.0
Gianina Șerban,snoop.ro,0,0,3,3,0.0,0.0
Gigi Becali,snoop.ro,0,2,0,2,-1.0,1.0
Ilfov,snoop.ro,0,0,6,6,0.0,0.0
Ilinca Simion,snoop.ro,0,0,1,1,0.0,0.0
Istanbul,snoop.ro,0,0,2,2,0.0,0.0
Kyriakos Mitsotakis,snoop.ro,0,0,1,1,0.0,0.0
Lovin,snoop.ro,0,0,1,1,0.0,0.0
Lucian Despoiu,snoop.ro,0,0,1,1,0.0,0.0
Marius Dorin Lulea,snoop.ro,0,1,3,4,-0.25,0.25
Maria Braluș,snoop.ro,0,0,1,1,0.0,0.0
Marian Munteanu,snoop.ro,0,0,1,1,0.0,0.0
Maricel Păcurar,snoop.ro,0,1,0,1,-1.0,1.0
Maricel Păcuraru,snoop.ro,0,0,2,2,0.0,0.0
Marin,snoop.ro,0,0,2,2,0.0,0.0
Marine Le Pen,snoop.ro,0,1,0,1,-1.0,1.0
Marius Lulea,snoop.ro,0,0,3,3,0.0,0.0
Mirela Daniela Irindea,snoop.ro,0,0,1,1,0.0,0.0
Murad,snoop.ro,0,0,1,1,0.0,0.0
Neamț,snoop.ro,0,1,1,2,-0.5,0.5
Paul Păcuraru,snoop.ro,0,1,0,1,-1.0,1.0
Radu Vasile,snoop.ro,0,0,1,1,0.0,0.0
Raluca Brăluș,snoop.ro,0,0,1,1,0.0,0.0
Ramona Lăpuște,snoop.ro,0,0,1,1,0.0,0.0
Ramona Lovin,snoop.ro,0,0,1,1,0.0,0.0
Robert Turcescu,snoop.ro,0,0,1,1,0.0,0.0
Simion Ciolacu,snoop.ro,0,0,1,1,0.0,0.0
Simion Georgescu,snoop.ro,0,0,1,1,0.0,0.0
Sorin Constantinescu,snoop.ro,0,0,3,3,0.0,0.0
Spania,snoop.ro,0,0,6,6,0.0,0.0
Târziu,snoop.ro,0,1,0,1,-1.0,1.0
Vol,snoop.ro,0,0,1,1,0.0,0.0
adversar,snoop.ro,0,2,0,2,-1.0,1.0
aliat,snoop.ro,0,2,0,2,-1.0,1.0
antreprenor,snoop.ro,1,1,3,5,0.0,0.0
ar,snoop.ro,0,1,0,1,-1.0,1.0
asistent universitar,snoop.ro,0,0,1,1,0.0,0.0
candidați,snoop.ro,0,4,1,5,-0.8,0.8
cofondator,snoop.ro,0,0,1,1,0.0,0.0
consultant,snoop.ro,0,4,9,13,-0.3076923076923077,0.3076923076923077
copreședinte,snoop.ro,0,2,0,2,-1.0,1.0
cuplu,snoop.ro,0,0,1,1,0.0,0.0
Dan Tanasă,snoop.ro,0,1,0,1,-1.0,1.0
eră,snoop.ro,0,0,1,1,0.0,0.0
Adrian George Axinia,snoop.ro,0,0,1,1,0.0,0.0
favorit,snoop.ro,0,1,0,1,-1.0,1.0
ginere,snoop.ro,0,1,3,4,-0.25,0.25
inițiator,snoop.ro,1,1,1,3,0.0,0.0
intermediar,snoop.ro,0,1,2,3,-0.3333333333333333,0.3333333333333333
interpuși,snoop.ro,0,1,0,1,-1.0,1.0
Cătălin Striblea,snoop.ro,0,0,1,1,0.0,0.0
Laurențiu Ungureanu,snoop.ro,0,0,3,3,0.0,0.0
Kos Mitsotakis,snoop.ro,0,0,1,1,0.0,0.0
lobbyist,snoop.ro,0,3,0,3,-1.0,1.0
mareșal,snoop.ro,0,1,0,1,-1.0,1.0
naș,snoop.ro,0,2,0,2,-1.0,1.0
om politic,snoop.ro,0,3,1,4,-0.75,0.75
ok,snoop.ro,0,0,1,1,0.0,0.0
oop,snoop.ro,0,0,1,1,0.0,0.0
outsider,snoop.ro,0,1,0,1,-1.0,1.0
premiu,snoop.ro,0,1,0,1,-1.0,1.0
Klaus Iohannis,snoop.ro,1,2,6,9,-0.1111111111111111,0.1111111111111111
rezervist,snoop.ro,0,2,1,3,-0.6666666666666666,0.6666666666666666
Petrișor Peiu,snoop.ro,0,0,1,1,0.0,0.0
ul,snoop.ro,0,1,3,4,-0.25,0.25
Ovidiu Hurduzeu,snoop.ro,0,1,0,1,-1.0,1.0
zidar,snoop.ro,0,0,1,1,0.0,0.0
ziu,snoop.ro,0,0,1,1,0.0,0.0
Șerban,snoop.ro,0,0,1,1,0.0,0.0
Ștefan Avrămescu,snoop.ro,0,0,1,1,0.0,0.0
Estonia,www.digi24.ro,0,0,1,1,0.0,0.0
Andrada Cilibiu,www.gandul.ro,0,0,1,1,0.0,0.0
Denise Rifai,www.gandul.ro,0,2,1,3,-0.6666666666666666,0.6666666666666666
Gojira,www.gandul.ro,0,1,0,1,-1.0,1.0
Oreste,www.gandul.ro,0,1,0,1,-1.0,1.0
Daniel Morar,www.mediafax.ro,0,1,1,2,-0.5,0.5
Miron Mitrea,www.mediafax.ro,0,1,2,3,-0.3333333333333333,0.3333333333333333
Mitrea,www.mediafax.ro,0,0,1,1,0.0,0.0
Năstase,www.mediafax.ro,0,1,3,4,-0.25,0.25
procuror șef,www.mediafax.ro,0,1,0,1,-1.0,1.0
Adrian Năstase,www.comisarul.ro,0,1,2,3,-0.3333333333333333,0.3333333333333333
Bogdan Chirieac,www.comisarul.ro,0,0,1,1,0.0,0.0
Codrin Unici,www.comisarul.ro,0,0,1,1,0.0,0.0
Marian Neacșu,www.comisarul.ro,0,0,3,3,0.0,0.0
Peiu,www.comisarul.ro,0,0,1,1,0.0,0.0
Petrișor Peiu,www.comisarul.ro,0,2,4,6,-0.3333333333333333,0.3333333333333333
R,www.comisarul.ro,0,0,1,1,0.0,0.0
analist,www.comisarul.ro,0,2,14,16,-0.125,0.125
asociație,www.comisarul.ro,0,0,1,1,0.0,0.0
iu,www.comisarul.ro,0,1,0,1,-1.0,1.0
Radu Vasile,www.comisarul.ro,0,0,1,1,0.0,0.0
proprietar,www.comisarul.ro,0,2,1,3,-0.6666666666666666,0.6666666666666666
Andrei Țăranu,www.comisarul.ro,0,0,1,1,0.0,0.0
Sorin Lavric,www.comisarul.ro,0,2,1,3,-0.6666666666666666,0.6666666666666666
prezidențiabil,www.comisarul.ro,0,2,1,3,-0.6666666666666666,0.6666666666666666
Andronache,agerpres.ro,0,1,0,1,-1.0,1.0
Gabriel Andronache,agerpres.ro,0,0,1,1,0.0,0.0
liberal,agerpres.ro,0,2,0,2,-1.0,1.0
Gabriela Firea,www.romaniatv.net,0,1,6,7,-0.14285714285714285,0.14285714285714285
interlop,www.romaniatv.net,0,1,0,1,-1.0,1.0
Adrian Dohotaru,recorder.ro,0,1,1,2,-0.5,0.5
Dohotaru,recorder.ro,0,2,0,2,-1.0,1.0
ai,recorder.ro,0,2,0,2,-1.0,1.0
Șerban Nicolae,recorder.ro,0,1,2,3,-0.3333333333333333,0.3333333333333333
grangur,recorder.ro,0,1,0,1,-1.0,1.0
sărac,recorder.ro,0,1,0,1,-1.0,1.0
ăia,recorder.ro,0,1,0,1,-1.0,1.0
Anton Lungu,adevarul.ro,0,2,0,2,-1.0,1.0
Braileanul,adevarul.ro,0,0,1,1,0.0,0.0
Brailei,adevarul.ro,0,1,0,1,-1.0,1.0
Gheorghe Lupascu,adevarul.ro,0,0,3,3,0.0,0.0
Turn,adevarul.ro,0,1,0,1,-1.0,1.0
umanist,adevarul.ro,0,3,1,4,-0.75,0.75
Dorin Recean,primanews.ro,0,0,1,1,0.0,0.0
Mihai Busuioc,primanews.ro,0,0,2,2,0.0,0.0
Republica Moldova,primanews.ro,2,0,5,7,0.2857142857142857,0.2857142857142857
Toni Greblă,primanews.ro,0,2,1,3,-0.6666666666666666,0.6666666666666666
agent,primanews.ro,0,2,1,3,-0.6666666666666666,0.6666666666666666
Negrescu,www.g4media.ro,0,1,1,2,-0.5,0.5
Victor Negrescu,www.g4media.ro,0,0,11,11,0.0,0.0
Alba,www.romaniatv.net,0,0,3,3,0.0,0.0
Sibiu,www.romaniatv.net,0,0,6,6,0.0,0.0
Victor Ciutacu,www.romaniatv.net,0,0,9,9,0.0,0.0
Viena,www.romaniatv.net,0,0,2,2,0.0,0.0
Cristian Popescu-Piedone,primanews.ro,0,0,1,1,0.0,0.0
Cătălin Cîrstoiu,primanews.ro,0,1,2,3,-0.3333333333333333,0.3333333333333333
Administrația Bolojan,recorder.ro,1,0,0,1,1.0,1.0
Adrian Madar,recorder.ro,0,0,1,1,0.0,0.0
Aurel Mohan,recorder.ro,0,0,1,1,0.0,0.0
Bihor,recorder.ro,0,0,4,4,0.0,0.0
Călin Popescu Tăriceanu,recorder.ro,0,0,1,1,0.0,0.0
Daniel Palaghianu,recorder.ro,0,0,1,1,0.0,0.0
Florin Birta,recorder.ro,0,1,1,2,-0.5,0.5
Secretar General,recorder.ro,0,0,1,1,0.0,0.0
Bolojan,recorder.ro,1,1,1,3,0.0,0.0
Cătălin Predoiu,www.antena3.ro,0,1,5,6,-0.16666666666666666,0.16666666666666666
Laurențiu Dan Leoreanu,agerpres.ro,0,0,1,1,0.0,0.0
Leoreanu,agerpres.ro,0,0,1,1,0.0,0.0
consilier prezidențial,adevarul.ro,0,0,5,5,0.0,0.0
Antony Blinken,www.antena3.ro,0,1,2,3,-0.3333333333333333,0.3333333333333333
Maia Sandu,www.antena3.ro,0,0,2,2,0.0,0.0
Moldova,www.antena3.ro,1,1,4,6,0.0,0.0
Tucker Carlson,www.antena3.ro,0,1,0,1,-1.0,1.0
agent,www.antena3.ro,0,2,1,3,-0.6666666666666666,0.6666666666666666
global,www.antena3.ro,0,1,0,1,-1.0,1.0
lume,www.antena3.ro,0,1,1,2,-0.5,0.5
președintele Kennedy,www.antena3.ro,1,0,0,1,1.0,1.0
slu,www.antena3.ro,0,1,0,1,-1.0,1.0
competitor,www.cotidianul.ro,0,1,0,1,-1.0,1.0
utilizator,www.cotidianul.ro,1,1,0,2,0.0,0.0
America,snoop.ro,0,0,4,4,0.0,0.0
Bariz,snoop.ro,0,1,0,1,-1.0,1.0
Cehia,snoop.ro,0,0,6,6,0.0,0.0
Cezar Irimia,snoop.ro,0,0,2,2,0.0,0.0
Danemarca,snoop.ro,0,0,1,1,0.0,0.0
Dumnezeu,snoop.ro,2,1,0,3,0.3333333333333333,0.3333333333333333
Dănciulescu,snoop.ro,0,1,0,1,-1.0,1.0
Grigorescu,snoop.ro,0,0,1,1,0.0,0.0
Ka,snoop.ro,0,0,1,1,0.0,0.0
Lituania,snoop.ro,0,0,1,1,0.0,0.0
Luca Li Bassi,snoop.ro,0,0,1,1,0.0,0.0
Mihaela Dănciulescu,snoop.ro,0,0,2,2,0.0,0.0
Mihăiță,snoop.ro,0,0,2,2,0.0,0.0
Mihăiță Bariz,snoop.ro,0,0,1,1,0.0,0.0
oncolog,snoop.ro,0,0,2,2,0.0,0.0
Roma,snoop.ro,0,1,0,1,-1.0,1.0
Sabine Vogler,snoop.ro,0,0,1,1,0.0,0.0
Viena,snoop.ro,0,0,2,2,0.0,0.0
Vlad Voiculescu,snoop.ro,0,0,1,1,0.0,0.0
medic pneumolog,snoop.ro,0,0,1,1,0.0,0.0
negociator,snoop.ro,0,0,2,2,0.0,0.0
oficial,snoop.ro,0,4,1,5,-0.8,0.8
Alexandru Grigorescu,snoop.ro,0,0,3,3,0.0,0.0
prietenă,snoop.ro,0,0,2,2,0.0,0.0
supraviețuitor,snoop.ro,0,0,1,1,0.0,0.0
Corneliu Tudor,www.news.ro,0,0,1,1,0.0,0.0
Lidia Vadim Tudor,www.news.ro,0,0,1,1,0.0,0.0
Simion,www.news.ro,0,5,8,13,-0.38461538461538464,0.38461538461538464
fiică,www.news.ro,1,2,1,4,-0.25,0.25
om de afaceri,www.news.ro,1,2,2,5,-0.2,0.2
Livia Stanciu,www.antena3.ro,0,0,1,1,0.0,0.0
Croația,www.comisarul.ro,0,0,2,2,0.0,0.0
Andreea Ambroze,observatornews.ro,0,0,1,1,0.0,0.0
Constanța,observatornews.ro,0,0,2,2,0.0,0.0
Dumitru Focșa,observatornews.ro,0,3,0,3,-1.0,1.0
Marian Vasilache,observatornews.ro,0,0,1,1,0.0,0.0
polițist,observatornews.ro,0,7,1,8,-0.875,0.875
soție,observatornews.ro,0,4,1,5,-0.8,0.8
Titi Stoica,observatornews.ro,0,1,1,2,-0.5,0.5
bărbat,observatornews.ro,0,2,6,8,-0.25,0.25
cuplu,observatornews.ro,0,0,2,2,0.0,0.0
deputat,observatornews.ro,0,18,19,37,-0.4864864864864865,0.4864864864864865
Focșa,observatornews.ro,0,1,0,1,-1.0,1.0
fetiță,observatornews.ro,0,0,1,1,0.0,0.0
fată,observatornews.ro,0,0,1,1,0.0,0.0
reporter,observatornews.ro,0,1,1,2,-0.5,0.5
vecin,observatornews.ro,0,1,0,1,-1.0,1.0
vecină,observatornews.ro,0,1,0,1,-1.0,1.0
Cotroceni,www.activenews.ro,0,1,0,1,-1.0,1.0
Laura Vicol,www.activenews.ro,0,2,3,5,-0.4,0.4
Monaco,www.activenews.ro,0,0,2,2,0.0,0.0
Moscova,www.activenews.ro,0,3,1,4,-0.75,0.75
Nisa,www.activenews.ro,0,0,2,2,0.0,0.0
princip,www.activenews.ro,0,1,0,1,-1.0,1.0
corupt,www.activenews.ro,0,1,0,1,-1.0,1.0
demnitar,www.activenews.ro,0,2,0,2,-1.0,1.0
escroc,www.activenews.ro,0,1,0,1,-1.0,1.0
familie,www.activenews.ro,7,5,5,17,0.11764705882352941,0.11764705882352941
impostor,www.activenews.ro,0,1,0,1,-1.0,1.0
Țiriac,www.activenews.ro,0,0,2,2,0.0,0.0
coordonator,stirileprotv.ro,0,0,4,4,0.0,0.0
Cosmescu,stirileprotv.ro,0,0,1,1,0.0,0.0
Gherghina,stirileprotv.ro,0,0,1,1,0.0,0.0
Ioan Gherghina,stirileprotv.ro,0,0,1,1,0.0,0.0
Marius Cosmescu,stirileprotv.ro,0,0,1,1,0.0,0.0
Mircea Coșea,stirileprotv.ro,0,0,1,1,0.0,0.0
Neculai Onțanu,stirileprotv.ro,0,0,1,1,0.0,0.0
Onțanu,stirileprotv.ro,0,0,1,1,0.0,0.0
Marilen Gabriel Pirtea,agerpres.ro,0,0,1,1,0.0,0.0
Marilen Pirtea,agerpres.ro,0,0,1,1,0.0,0.0
Otilia Halunga,agerpres.ro,0,0,2,2,0.0,0.0
rector,agerpres.ro,0,1,0,1,-1.0,1.0
Ghiță,www.b1tv.ro,0,1,0,1,-1.0,1.0
Ghiță Mureșan,www.b1tv.ro,0,0,1,1,0.0,0.0
Nicu Șetfănuță,www.b1tv.ro,0,1,0,1,-1.0,1.0
Shiță Mureșan,www.b1tv.ro,0,0,1,1,0.0,0.0
antrenor,www.b1tv.ro,0,0,1,1,0.0,0.0
Adolf,recorder.ro,0,1,0,1,-1.0,1.0
Cosmin Bumbuț,recorder.ro,0,0,1,1,0.0,0.0
Elena Stancu,recorder.ro,0,0,1,1,0.0,0.0
Kursk,recorder.ro,0,2,1,3,-0.6666666666666666,0.6666666666666666
Vlad Voiculescu,recorder.ro,0,2,3,5,-0.4,0.4
Zaporojie,recorder.ro,0,2,1,3,-0.6666666666666666,0.6666666666666666
Zelea Codreanu,recorder.ro,0,0,1,1,0.0,0.0
aliat,recorder.ro,0,2,3,5,-0.4,0.4
directoare,recorder.ro,0,1,1,2,-0.5,0.5
față,recorder.ro,0,1,0,1,-1.0,1.0
Sebastian Zachmann,recorder.ro,0,0,2,2,0.0,0.0
politică,recorder.ro,0,3,0,3,-1.0,1.0
Fiordean,www.aktual24.ro,0,0,1,1,0.0,0.0
Gianina Fiordean,www.aktual24.ro,0,0,1,1,0.0,0.0
Paris,www.aktual24.ro,0,1,8,9,-0.1111111111111111,0.1111111111111111
mană,www.aktual24.ro,0,1,0,1,-1.0,1.0
Florentin Pandele,a1.ro,0,1,0,1,-1.0,1.0
Silviu Prigoana,a1.ro,0,2,0,2,-1.0,1.0
ana,a1.ro,0,0,1,1,0.0,0.0
curios,a1.ro,0,1,1,2,-0.5,0.5
iu,a1.ro,0,1,0,1,-1.0,1.0
câștigător,www.luju.ro,1,0,1,2,0.5,0.5
Ciolacu,www.luju.ro,1,11,0,12,-0.8333333333333334,0.8333333333333334
Crin Laurentiu,www.luju.ro,0,0,1,1,0.0,0.0
Cristian Terheș,www.luju.ro,0,0,1,1,0.0,0.0
Daniel Funeriu,www.luju.ro,0,0,1,1,0.0,0.0
Elena Lasconi,www.luju.ro,0,2,8,10,-0.2,0.2
Lavinia Sandru,www.luju.ro,0,0,1,1,0.0,0.0
Marcel,www.luju.ro,0,0,1,1,0.0,0.0
prim-ministru,www.luju.ro,0,3,1,4,-0.75,0.75
Sebastian Popescu,www.luju.ro,0,0,1,1,0.0,0.0
Silviu Predoiu,www.luju.ro,0,0,1,1,0.0,0.0
Cezar Preda,stirileprotv.ro,0,0,2,2,0.0,0.0
inițiator,www.cotidianul.ro,0,1,2,3,-0.3333333333333333,0.3333333333333333
Belarus,primanews.ro,0,1,0,1,-1.0,1.0
Donețk,primanews.ro,0,1,0,1,-1.0,1.0
Herson,primanews.ro,0,1,0,1,-1.0,1.0
Lugansk,primanews.ro,0,0,1,1,0.0,0.0
Occident,primanews.ro,0,1,0,1,-1.0,1.0
Sergei Lavrov,primanews.ro,0,0,2,2,0.0,0.0
URSS,primanews.ro,0,0,1,1,0.0,0.0
Zaporojie,primanews.ro,0,0,1,1,0.0,0.0
aliat,primanews.ro,0,0,4,4,0.0,0.0
sk,primanews.ro,0,1,0,1,-1.0,1.0
vorbitor,primanews.ro,0,1,0,1,-1.0,1.0
elodiu,www.luju.ro,0,1,0,1,-1.0,1.0
Iacob,www.luju.ro,0,0,1,1,0.0,0.0
Marius Iacob,www.luju.ro,0,3,2,5,-0.6,0.6
Nicolae Ceaușescu,www.luju.ro,0,1,0,1,-1.0,1.0
Ogoranu,www.luju.ro,0,0,1,1,0.0,0.0
Petru Groza,www.luju.ro,0,1,0,1,-1.0,1.0
Richard Nixon,www.luju.ro,0,1,0,1,-1.0,1.0
Valentina,www.luju.ro,0,0,1,1,0.0,0.0
Valentin Busuioc,www.luju.ro,0,2,5,7,-0.2857142857142857,0.2857142857142857
luptător,www.luju.ro,0,0,1,1,0.0,0.0
Maresalul Ion Antonescu,www.luju.ro,0,1,0,1,-1.0,1.0
Albania,www.realitatea.net,0,0,1,1,0.0,0.0
ambasador,www.realitatea.net,0,1,3,4,-0.25,0.25
George,www.realitatea.net,0,1,0,1,-1.0,1.0
George Soros,www.realitatea.net,0,3,1,4,-0.75,0.75
Soros,www.realitatea.net,0,4,0,4,-1.0,1.0
Vasile Dîncu,www.realitatea.net,1,0,1,2,0.5,0.5
vicepreședinte,www.realitatea.net,0,1,5,6,-0.16666666666666666,0.16666666666666666
activist,www.realitatea.net,0,3,0,3,-1.0,1.0
europarlamentar,www.realitatea.net,1,0,3,4,0.25,0.25
oș,www.realitatea.net,0,1,0,1,-1.0,1.0
capitală,www.comisarul.ro,0,1,5,6,-0.16666666666666666,0.16666666666666666
Eduard Nicolae Popa,www.comisarul.ro,0,0,2,2,0.0,0.0
Andrei Caramitru,www.comisarul.ro,0,0,2,2,0.0,0.0
economist,www.comisarul.ro,0,1,2,3,-0.3333333333333333,0.3333333333333333
Bolojan,www.comisarul.ro,1,5,6,12,-0.3333333333333333,0.3333333333333333
Ceașcă,www.comisarul.ro,0,1,0,1,-1.0,1.0
Coreea de Nord,www.comisarul.ro,0,1,0,1,-1.0,1.0
Crin,www.comisarul.ro,1,1,1,3,0.0,0.0
Dușmanii,www.comisarul.ro,0,1,0,1,-1.0,1.0
Firea,www.comisarul.ro,0,1,1,2,-0.5,0.5
Meloni,www.comisarul.ro,1,1,1,3,0.0,0.0
Simon,www.comisarul.ro,0,1,1,2,-0.5,0.5
Venezuela,www.comisarul.ro,0,1,1,2,-0.5,0.5
alcoolizat,www.comisarul.ro,0,1,0,1,-1.0,1.0
consilier politic,www.comisarul.ro,0,1,0,1,-1.0,1.0
domn,www.comisarul.ro,1,1,4,6,0.0,0.0
general,www.comisarul.ro,0,2,2,4,-0.5,0.5
ideolog,www.comisarul.ro,0,3,0,3,-1.0,1.0
noi,www.comisarul.ro,0,1,0,1,-1.0,1.0
soros,www.comisarul.ro,0,1,0,1,-1.0,1.0
vinovat,www.comisarul.ro,0,3,0,3,-1.0,1.0
Elena Tănăsescu,adevarul.ro,0,1,0,1,-1.0,1.0
George Soros,adevarul.ro,0,4,2,6,-0.6666666666666666,0.6666666666666666
Georgiana Teodorescu,adevarul.ro,0,0,1,1,0.0,0.0
Marian Enache,adevarul.ro,0,1,2,3,-0.3333333333333333,0.3333333333333333
Mario Nawfal,adevarul.ro,0,1,2,3,-0.3333333333333333,0.3333333333333333
Musk,adevarul.ro,0,0,3,3,0.0,0.0
Răzvan Biro,www.realitatea.net,0,0,1,1,0.0,0.0
Tiberiu Bărsan,www.realitatea.net,0,0,1,1,0.0,0.0
criminal,www.realitatea.net,0,2,0,2,-1.0,1.0
Rareș Petru Stan,www.realitatea.net,0,1,0,1,-1.0,1.0
rezișit,www.realitatea.net,0,3,0,3,-1.0,1.0
șefă,www.realitatea.net,0,1,1,2,-0.5,0.5
Allen Coliban,primanews.ro,0,0,1,1,0.0,0.0
Bistrița,primanews.ro,0,0,1,1,0.0,0.0
Brașov,primanews.ro,0,1,0,1,-1.0,1.0
Clotilde Armand,primanews.ro,0,1,0,1,-1.0,1.0
Craiova,primanews.ro,0,0,1,1,0.0,0.0
Cristian Popescu Piedone,primanews.ro,0,0,1,1,0.0,0.0
Dragnea,primanews.ro,0,3,0,3,-1.0,1.0
Drulă,primanews.ro,0,1,0,1,-1.0,1.0
Gheorghe Flutur,primanews.ro,0,2,1,3,-0.6666666666666666,0.6666666666666666
Iulian Dumitrescu,primanews.ro,0,1,0,1,-1.0,1.0
Liviu Dragnea,primanews.ro,0,2,0,2,-1.0,1.0
Piatra,primanews.ro,0,1,0,1,-1.0,1.0
Pitești,primanews.ro,0,1,1,2,-0.5,0.5
Prahova,primanews.ro,0,1,1,2,-0.5,0.5
Radu Mihaiu,primanews.ro,0,1,0,1,-1.0,1.0
Rareș Hopincă,primanews.ro,0,0,1,1,0.0,0.0
Romeo Dunca,primanews.ro,0,1,0,1,-1.0,1.0
Timișoara,primanews.ro,1,0,1,2,0.5,0.5
câștigător,primanews.ro,2,0,6,8,0.25,0.25
electorat,primanews.ro,1,1,4,6,0.0,0.0
eurodeputat,primanews.ro,0,0,1,1,0.0,0.0
fiu,primanews.ro,0,1,2,3,-0.3333333333333333,0.3333333333333333
fondator,primanews.ro,0,0,3,3,0.0,0.0
vârstnic,primanews.ro,0,1,0,1,-1.0,1.0
colaborator,stirileprotv.ro,0,1,2,3,-0.3333333333333333,0.3333333333333333
general,stirileprotv.ro,0,2,2,4,-0.5,0.5
secretar general adjunct,primanews.ro,0,0,1,1,0.0,0.0
Lucian Bode,stirileprotv.ro,0,0,3,3,0.0,0.0
Salaj,stirileprotv.ro,0,0,1,1,0.0,0.0
Silvania,stirileprotv.ro,0,0,1,1,0.0,0.0
Bucureștean,a1.ro,0,0,4,4,0.0,0.0
Cosmin Georgescu,a1.ro,0,0,5,5,0.0,0.0
primar general,a1.ro,0,2,2,4,-0.5,0.5
bucureștean,a1.ro,1,1,4,6,0.0,0.0
prieten,a1.ro,3,2,2,7,0.14285714285714285,0.14285714285714285
Callum,www.comisarul.ro,0,0,2,2,0.0,0.0
Sarah,www.comisarul.ro,0,1,0,1,-1.0,1.0
abonat,www.comisarul.ro,0,0,1,1,0.0,0.0
turișt,www.comisarul.ro,0,1,3,4,-0.25,0.25
Andrei Țăranu,pressone.ro,0,0,10,10,0.0,0.0
Nicolae-Ionel Ciucă,pressone.ro,0,1,0,1,-1.0,1.0
Drulă,pressone.ro,0,0,2,2,0.0,0.0
Ghinea,pressone.ro,0,0,1,1,0.0,0.0
Le Pen,pressone.ro,0,3,2,5,-0.6,0.6
Marine Le Pen,pressone.ro,0,1,5,6,-0.16666666666666666,0.16666666666666666
Mihail Kogălniceanu,pressone.ro,0,0,1,1,0.0,0.0
Roberto Michels,pressone.ro,0,0,1,1,0.0,0.0
Slovenia,pressone.ro,0,0,2,2,0.0,0.0
dvs,pressone.ro,0,0,4,4,0.0,0.0
favorit,pressone.ro,0,2,2,4,-0.5,0.5
junior,pressone.ro,0,1,3,4,-0.25,0.25
oligarh,pressone.ro,0,1,0,1,-1.0,1.0
Andrei Novac,adevarul.ro,0,0,1,1,0.0,0.0
cabinet,adevarul.ro,0,0,1,1,0.0,0.0
stat,adevarul.ro,0,1,0,1,-1.0,1.0
Celuilalt,pressone.ro,0,1,0,1,-1.0,1.0
Cirică,pressone.ro,0,0,1,1,0.0,0.0
Doljul,pressone.ro,0,1,0,1,-1.0,1.0
Recep Tayyip Erdogan,pressone.ro,0,3,1,4,-0.75,0.75
Giurgiul,pressone.ro,0,1,1,2,-0.5,0.5
huligan,pressone.ro,0,3,0,3,-1.0,1.0
Nicolae Cirică,pressone.ro,0,0,1,1,0.0,0.0
boxer,pressone.ro,0,0,1,1,0.0,0.0
burghez,pressone.ro,0,1,0,1,-1.0,1.0
demonstrant,pressone.ro,0,5,0,5,-1.0,1.0
golan,pressone.ro,0,1,0,1,-1.0,1.0
grup,pressone.ro,0,1,1,2,-0.5,0.5
interlocutor,pressone.ro,1,1,1,3,0.0,0.0
nici,pressone.ro,0,1,1,2,-0.5,0.5
obișnuit,pressone.ro,0,1,0,1,-1.0,1.0
parazit,pressone.ro,0,1,0,1,-1.0,1.0
pradă,pressone.ro,0,1,0,1,-1.0,1.0
ragne,pressone.ro,0,1,0,1,-1.0,1.0
șobolan,pressone.ro,0,1,0,1,-1.0,1.0
Rodeanu,www.mediafax.ro,0,0,1,1,0.0,0.0
Bogdan Rodeanu,www.mediafax.ro,0,0,1,1,0.0,0.0
Cătălin Toma,observatornews.ro,0,2,0,2,-1.0,1.0
Focșani,observatornews.ro,0,0,1,1,0.0,0.0
Ion Ștefan,observatornews.ro,1,0,1,2,0.5,0.5
Ionuț Filimon,observatornews.ro,0,0,1,1,0.0,0.0
consilier,observatornews.ro,2,4,16,22,-0.09090909090909091,0.09090909090909091
Andy Ogles,stirileprotv.ro,0,0,1,1,0.0,0.0
Anna Paulina Luna,stirileprotv.ro,0,0,1,1,0.0,0.0
Austin,stirileprotv.ro,0,0,1,1,0.0,0.0
Capitol,stirileprotv.ro,0,1,0,1,-1.0,1.0
critic,stirileprotv.ro,0,3,0,3,-1.0,1.0
Dina Titus,stirileprotv.ro,0,0,1,1,0.0,0.0
Doggett,stirileprotv.ro,0,0,1,1,0.0,0.0
Dunn,stirileprotv.ro,0,0,1,1,0.0,0.0
Florida,stirileprotv.ro,0,0,1,1,0.0,0.0
Ilhan Omar,stirileprotv.ro,0,0,1,1,0.0,0.0
Lloyd Alton Doggett,stirileprotv.ro,0,0,1,1,0.0,0.0
Lloyd Doggett,stirileprotv.ro,0,0,1,1,0.0,0.0
Luna,stirileprotv.ro,0,0,1,1,0.0,0.0
Minneapolis,stirileprotv.ro,0,0,1,1,0.0,0.0
Minnesota,stirileprotv.ro,0,0,1,1,0.0,0.0
Neal Dunn,stirileprotv.ro,0,0,1,1,0.0,0.0
Nevada,stirileprotv.ro,0,0,1,1,0.0,0.0
Ogles,stirileprotv.ro,0,1,0,1,-1.0,1.0
Panama,stirileprotv.ro,0,0,1,1,0.0,0.0
Pennsylvania,stirileprotv.ro,0,1,0,1,-1.0,1.0
Vern Buchanan,stirileprotv.ro,0,1,1,2,-0.5,0.5
Somalia,stirileprotv.ro,0,0,1,1,0.0,0.0
Ted,stirileprotv.ro,1,0,0,1,1.0,1.0
Ted Lieu,stirileprotv.ro,0,0,1,1,0.0,0.0
Tennessee,stirileprotv.ro,0,0,1,1,0.0,0.0
Texas,stirileprotv.ro,0,0,1,1,0.0,0.0
Titus,stirileprotv.ro,0,0,1,1,0.0,0.0
Donald Trump,stirileprotv.ro,0,5,1,6,-0.8333333333333334,0.8333333333333334
avocat,stirileprotv.ro,0,3,6,9,-0.3333333333333333,0.3333333333333333
chirurg,stirileprotv.ro,0,0,1,1,0.0,0.0
copil,stirileprotv.ro,3,1,6,10,0.2,0.2
copreședinte,stirileprotv.ro,0,0,2,2,0.0,0.0
dei,stirileprotv.ro,0,1,0,1,-1.0,1.0
femeie,stirileprotv.ro,1,0,1,2,0.5,0.5
guvernator,stirileprotv.ro,0,0,1,1,0.0,0.0
medic,stirileprotv.ro,0,0,3,3,0.0,0.0
or,stirileprotv.ro,0,0,1,1,0.0,0.0
organizator,stirileprotv.ro,0,0,1,1,0.0,0.0
profesor,stirileprotv.ro,1,0,3,4,0.25,0.25
Maury,stirileprotv.ro,0,0,1,1,0.0,0.0
veteran,stirileprotv.ro,2,0,0,2,1.0,1.0
vorbitor,stirileprotv.ro,0,0,1,1,0.0,0.0
Eugen Tomac,observatornews.ro,0,1,3,4,-0.25,0.25
Siegfried Mureșan,observatornews.ro,0,0,1,1,0.0,0.0
Viorica Dăncilă,observatornews.ro,0,0,6,6,0.0,0.0
Luminița Odobescu,www.digi24.ro,0,0,2,2,0.0,0.0
Odobescu,www.digi24.ro,0,0,1,1,0.0,0.0
Marcel Boloș,www.gandul.ro,0,0,3,3,0.0,0.0
Victor Ciutacu,www.gandul.ro,0,0,1,1,0.0,0.0
adversar,www.gandul.ro,0,3,0,3,-1.0,1.0
babă,www.gandul.ro,0,1,0,1,-1.0,1.0
incompetent,www.gandul.ro,0,1,0,1,-1.0,1.0
Gabriel Zetea,www.news.ro,0,0,2,2,0.0,0.0
Diana Șoșoacă,www.news.ro,0,0,4,4,0.0,0.0
Zetea,www.news.ro,0,0,1,1,0.0,0.0
Mihai Bellu,www.realitatea.net,0,0,1,1,0.0,0.0
Alba Iulia,www.g4media.ro,0,0,2,2,0.0,0.0
Alexandru Radu,www.g4media.ro,0,1,1,2,-0.5,0.5
Alexandru Vereș,www.g4media.ro,0,0,1,1,0.0,0.0
Apuseni,www.g4media.ro,0,0,1,1,0.0,0.0
Claudiu Răcuci,www.g4media.ro,0,0,1,1,0.0,0.0
Clement Negruț,www.g4media.ro,0,0,2,2,0.0,0.0
Corina Rotar,www.g4media.ro,0,0,1,1,0.0,0.0
Cristian Barb,www.g4media.ro,0,0,1,1,0.0,0.0
Cristian Costea,www.g4media.ro,0,0,1,1,0.0,0.0
Daniel Breaz,www.g4media.ro,0,0,3,3,0.0,0.0
Florin Roman,www.g4media.ro,0,0,3,3,0.0,0.0
Mariana Pereanu,www.g4media.ro,0,0,1,1,0.0,0.0
Sebeș,www.g4media.ro,0,0,3,3,0.0,0.0
Silviu Ponoran,www.g4media.ro,0,0,1,1,0.0,0.0
Zlatna,www.g4media.ro,0,1,0,1,-1.0,1.0
secretar de stat,www.g4media.ro,0,0,4,4,0.0,0.0
Tăriceanu,stirileprotv.ro,0,4,3,7,-0.5714285714285714,0.5714285714285714
Dragnea,www.realitatea.net,0,1,0,1,-1.0,1.0
Franța,adevarul.ro,2,1,14,17,0.058823529411764705,0.058823529411764705
salariat,adevarul.ro,0,0,1,1,0.0,0.0
Băsescu,www.luju.ro,0,3,0,3,-1.0,1.0
Codruta Kovesi,www.luju.ro,0,1,0,1,-1.0,1.0
domnule,www.luju.ro,0,0,1,1,0.0,0.0
Gheorghe Simion,www.luju.ro,1,0,0,1,1.0,1.0
Gabriel Marin,www.luju.ro,0,1,5,6,-0.16666666666666666,0.16666666666666666
Petrov,www.luju.ro,0,2,0,2,-1.0,1.0
vorbitor,www.luju.ro,0,1,0,1,-1.0,1.0
antreprenor,www.luju.ro,2,2,1,5,0.0,0.0
aparator,www.luju.ro,1,0,1,2,0.5,0.5
doctor,www.luju.ro,0,0,2,2,0.0,0.0
exponent,www.luju.ro,0,1,0,1,-1.0,1.0
finanțator,www.luju.ro,0,1,0,1,-1.0,1.0
general,www.luju.ro,0,7,2,9,-0.7777777777777778,0.7777777777777778
om de afaceri,www.luju.ro,1,5,2,8,-0.5,0.5
populație,www.luju.ro,0,3,0,3,-1.0,1.0
turnător,www.luju.ro,0,2,0,2,-1.0,1.0
Eugen Tomac,stirileprotv.ro,0,1,5,6,-0.16666666666666666,0.16666666666666666
corupt,stirileprotv.ro,0,1,0,1,-1.0,1.0
B,pressone.ro,0,1,0,1,-1.0,1.0
fundamentalist,pressone.ro,0,1,0,1,-1.0,1.0
Moscova,pressone.ro,0,9,1,10,-0.9,0.9
artizan,pressone.ro,1,1,0,2,0.0,0.0
de,pressone.ro,0,0,1,1,0.0,0.0
Stroe,pressone.ro,0,2,0,2,-1.0,1.0
dumneală,pressone.ro,0,1,0,1,-1.0,1.0
mamelor,pressone.ro,0,1,0,1,-1.0,1.0
minoritate,pressone.ro,0,2,2,4,-0.5,0.5
participanț,pressone.ro,1,1,1,3,0.0,0.0
preten,pressone.ro,0,1,0,1,-1.0,1.0
purtător,pressone.ro,0,2,0,2,-1.0,1.0
Agigea,recorder.ro,0,1,0,1,-1.0,1.0
Bogdan Alexandru Bola,recorder.ro,0,0,1,1,0.0,0.0
Bogdan Huțucă,recorder.ro,0,0,1,1,0.0,0.0
Cehov,recorder.ro,0,0,1,1,0.0,0.0
Cernavodă,recorder.ro,0,1,0,1,-1.0,1.0
Constănțean,recorder.ro,0,0,1,1,0.0,0.0
Cristina Rizea,recorder.ro,0,0,1,1,0.0,0.0
Daniel Keyes,recorder.ro,0,0,2,2,0.0,0.0
Dobrogea,recorder.ro,1,0,1,2,0.5,0.5
Dumitru Lungoci,recorder.ro,0,0,1,1,0.0,0.0
Eforie Nord,recorder.ro,0,1,0,1,-1.0,1.0
Eforie Sud,recorder.ro,0,0,1,1,0.0,0.0
Elena Băsescu,recorder.ro,0,1,1,2,-0.5,0.5
Eugen Negoi,recorder.ro,0,0,1,1,0.0,0.0
Fata,recorder.ro,0,0,1,1,0.0,0.0
Felix Stroe,recorder.ro,0,1,0,1,-1.0,1.0
Frank Herbert,recorder.ro,0,0,1,1,0.0,0.0
George Sergiu Niculescu,recorder.ro,0,0,1,1,0.0,0.0
Cristina Dumitrache,recorder.ro,0,0,1,1,0.0,0.0
Joe Navarro,recorder.ro,0,0,1,1,0.0,0.0
Henry Kissinger,recorder.ro,0,0,3,3,0.0,0.0
Liviu Brăiloiu,recorder.ro,0,0,1,1,0.0,0.0
Marian Crușoveanu,recorder.ro,0,0,1,1,0.0,0.0
Marius Țuțuianu,recorder.ro,0,0,1,1,0.0,0.0
Mircea Banias,recorder.ro,0,0,1,1,0.0,0.0
Mircea Dobre,recorder.ro,0,0,1,1,0.0,0.0
Muriel Barbery,recorder.ro,0,0,1,1,0.0,0.0
Nicușor Constantinescu,recorder.ro,0,1,0,1,-1.0,1.0
Peter Collet,recorder.ro,0,0,1,1,0.0,0.0
Radu Mazăre,recorder.ro,0,1,1,2,-0.5,0.5
Sam Carpenter,recorder.ro,0,0,1,1,0.0,0.0
Samuel Phillips Huntington,recorder.ro,0,0,1,1,0.0,0.0
Septimiu Bourceanu,recorder.ro,0,0,1,1,0.0,0.0
Sorin Mihai,recorder.ro,0,0,1,1,0.0,0.0
Stelian Ion,recorder.ro,0,0,1,1,0.0,0.0
Techirghiol,recorder.ro,0,0,1,1,0.0,0.0
Tuzla,recorder.ro,0,1,0,1,-1.0,1.0
adult,recorder.ro,1,0,2,3,0.3333333333333333,0.3333333333333333
bolnav,recorder.ro,0,5,5,10,-0.5,0.5
comisar,recorder.ro,0,2,5,7,-0.2857142857142857,0.2857142857142857
cumpărător,recorder.ro,0,1,1,2,-0.5,0.5
diriginte,recorder.ro,0,2,2,4,-0.5,0.5
fin,recorder.ro,0,2,0,2,-1.0,1.0
ofițer,recorder.ro,0,2,8,10,-0.2,0.2
ospătar,recorder.ro,0,1,1,2,-0.5,0.5
veri,recorder.ro,0,1,0,1,-1.0,1.0
verișoară,recorder.ro,0,1,0,1,-1.0,1.0
veteran,recorder.ro,0,0,3,3,0.0,0.0
vânzător,recorder.ro,0,1,1,2,-0.5,0.5
Hunor,www.digi24.ro,0,1,1,2,-0.5,0.5
Viena,www.digi24.ro,0,0,1,1,0.0,0.0
revoluționar,www.digi24.ro,0,0,1,1,0.0,0.0
împărat,www.digi24.ro,0,0,1,1,0.0,0.0
Adriean Videanu,snoop.ro,0,2,1,3,-0.6666666666666666,0.6666666666666666
Cosmin Prelipceanu,snoop.ro,0,1,1,2,-0.5,0.5
Costel Bucur,snoop.ro,0,0,1,1,0.0,0.0
Daiana Al Bitar,snoop.ro,0,0,1,1,0.0,0.0
Doctor Cîrstoiu,snoop.ro,0,0,1,1,0.0,0.0
Florin Nicolae Muntean,snoop.ro,0,1,0,1,-1.0,1.0
Ignatenko,snoop.ro,0,1,0,1,-1.0,1.0
MA,snoop.ro,0,0,1,1,0.0,0.0
Mamaia Nord,snoop.ro,0,0,1,1,0.0,0.0
Mogoșoaia,snoop.ro,0,0,1,1,0.0,0.0
Nela Păvăloiu,snoop.ro,0,1,0,1,-1.0,1.0
Raul Doicescu,snoop.ro,0,1,0,1,-1.0,1.0
Robert Negoiță,snoop.ro,0,1,3,4,-0.25,0.25
Tetelman,snoop.ro,0,1,0,1,-1.0,1.0
Vasile Blaga,snoop.ro,0,0,2,2,0.0,0.0
Videanu,snoop.ro,0,2,0,2,-1.0,1.0
Voicu,snoop.ro,0,1,0,1,-1.0,1.0
domn,snoop.ro,0,0,2,2,0.0,0.0
elia,snoop.ro,0,1,0,1,-1.0,1.0
nașă,snoop.ro,0,1,0,1,-1.0,1.0
Dan Adamescu,snoop.ro,0,1,0,1,-1.0,1.0
șofer,snoop.ro,0,8,7,15,-0.5333333333333333,0.5333333333333333
Lasconi,stirileprotv.ro,0,3,4,7,-0.42857142857142855,0.42857142857142855
Antonio Costa,www.euronews.ro,0,0,5,5,0.0,0.0
Biden,www.euronews.ro,0,0,4,4,0.0,0.0
Budapestei,www.euronews.ro,0,0,2,2,0.0,0.0
Conan,www.euronews.ro,0,1,0,1,-1.0,1.0
Londra,www.euronews.ro,0,0,1,1,0.0,0.0
Los Angeles,www.euronews.ro,0,0,2,2,0.0,0.0
Marco Rubio,www.euronews.ro,0,0,1,1,0.0,0.0
Netanyahu,www.euronews.ro,0,4,1,5,-0.8,0.8
Orban,www.euronews.ro,0,0,6,6,0.0,0.0
Republica Islamică,www.euronews.ro,0,1,0,1,-1.0,1.0
Secretar de stat,www.euronews.ro,0,0,1,1,0.0,0.0
Ungaria,www.euronews.ro,0,0,8,8,0.0,0.0
Ungarie,www.euronews.ro,0,0,5,5,0.0,0.0
Viktor Orban,www.euronews.ro,0,0,5,5,0.0,0.0
câștigător,www.euronews.ro,1,0,4,5,0.2,0.2
prezentator,www.euronews.ro,0,1,1,2,-0.5,0.5
Daniel Băluță,www.comisarul.ro,0,0,9,9,0.0,0.0
Tudose,www.comisarul.ro,0,0,2,2,0.0,0.0
Antal Lóránt,primanews.ro,0,0,1,1,0.0,0.0
Cătălin Drula,www.aktual24.ro,0,0,3,3,0.0,0.0
Vicepreședintele,www.digi24.ro,0,1,3,4,-0.25,0.25
cuplu,www.digi24.ro,0,2,1,3,-0.6666666666666666,0.6666666666666666
Elon Musk,www.digi24.ro,0,1,4,5,-0.2,0.2
oponent,www.digi24.ro,0,1,0,1,-1.0,1.0
pilot,www.digi24.ro,0,0,1,1,0.0,0.0
contracandidați,www.aktual24.ro,0,4,2,6,-0.6666666666666666,0.6666666666666666
independent,www.aktual24.ro,2,1,2,5,0.2,0.2
primar general,www.aktual24.ro,0,1,1,2,-0.5,0.5
Becali,adevarul.ro,0,3,6,9,-0.3333333333333333,0.3333333333333333
Gigi Becali,adevarul.ro,0,7,3,10,-0.7,0.7
Pipera,adevarul.ro,0,1,0,1,-1.0,1.0
Viorel Hrebenciuc,adevarul.ro,0,1,0,1,-1.0,1.0
apropiat,adevarul.ro,0,7,7,14,-0.5,0.5
Eba,adevarul.ro,0,0,1,1,0.0,0.0
domn,adevarul.ro,0,2,5,7,-0.2857142857142857,0.2857142857142857
Hrebenciuc,adevarul.ro,0,1,0,1,-1.0,1.0
dansator,adevarul.ro,0,1,0,1,-1.0,1.0
idiot,adevarul.ro,0,1,0,1,-1.0,1.0
latifundiar,adevarul.ro,0,1,0,1,-1.0,1.0
microbist,adevarul.ro,0,1,0,1,-1.0,1.0
Alice Weidel,adevarul.ro,0,1,0,1,-1.0,1.0
Boris Pistorius,adevarul.ro,0,0,1,1,0.0,0.0
J. D. Vance,adevarul.ro,0,1,1,2,-0.5,0.5
Vance,adevarul.ro,0,2,0,2,-1.0,1.0
Vicepreședintele,adevarul.ro,1,1,0,2,0.0,0.0
aliaț,adevarul.ro,0,3,2,5,-0.6,0.6
Olaf Scholz,adevarul.ro,0,0,1,1,0.0,0.0
Lulea,www.cotidianul.ro,0,1,0,1,-1.0,1.0
Marius Lulea,www.cotidianul.ro,0,2,1,3,-0.6666666666666666,0.6666666666666666
Bogdan Ivan,www.comisarul.ro,0,0,4,4,0.0,0.0
Paul Stănescu,www.comisarul.ro,0,2,8,10,-0.2,0.2
Petre Florin Manole,www.comisarul.ro,0,0,2,2,0.0,0.0
Victor Negrescu,www.comisarul.ro,0,0,10,10,0.0,0.0
Victoria Stoiciu,www.comisarul.ro,1,0,9,10,0.1,0.1
titular,www.comisarul.ro,0,1,0,1,-1.0,1.0
corabie,www.luju.ro,0,0,1,1,0.0,0.0
Dolj,www.luju.ro,0,1,0,1,-1.0,1.0
Elena,www.luju.ro,0,0,1,1,0.0,0.0
Gheorghe Popa,www.luju.ro,0,1,1,2,-0.5,0.5
Mehedinti,www.luju.ro,0,0,2,2,0.0,0.0
Mischii,www.luju.ro,0,1,0,1,-1.0,1.0
Olt,www.luju.ro,0,0,1,1,0.0,0.0
Sorin Popa,www.luju.ro,0,1,0,1,-1.0,1.0
Timișoara,www.luju.ro,0,0,1,1,0.0,0.0
consultant,www.luju.ro,0,2,1,3,-0.6666666666666666,0.6666666666666666
fiu,www.luju.ro,0,0,1,1,0.0,0.0
junior,www.luju.ro,0,1,0,1,-1.0,1.0
proprietar,www.luju.ro,0,0,1,1,0.0,0.0
soție,www.luju.ro,0,0,1,1,0.0,0.0
suspect,www.luju.ro,0,10,2,12,-0.8333333333333334,0.8333333333333334
Donețk,recorder.ro,0,0,2,2,0.0,0.0
Luhansk,recorder.ro,0,0,1,1,0.0,0.0
Vladimir Medinski,recorder.ro,0,0,1,1,0.0,0.0
semințe,recorder.ro,0,0,1,1,0.0,0.0
strateg,recorder.ro,0,1,1,2,-0.5,0.5
voi,recorder.ro,0,1,1,2,-0.5,0.5
Adrian,pressone.ro,0,0,1,1,0.0,0.0
Adrian Anton,pressone.ro,0,0,1,1,0.0,0.0
Adrian Tudor,pressone.ro,0,0,2,2,0.0,0.0
Adămiță,pressone.ro,0,0,1,1,0.0,0.0
Andreea Călin,pressone.ro,0,0,2,2,0.0,0.0
Badea,pressone.ro,0,0,1,1,0.0,0.0
Cristian Dogaru,pressone.ro,0,0,3,3,0.0,0.0
Călin,pressone.ro,0,0,3,3,0.0,0.0
Dragoș Simion,pressone.ro,0,1,2,3,-0.3333333333333333,0.3333333333333333
Gogoși,pressone.ro,0,1,0,1,-1.0,1.0
Hillerin,pressone.ro,0,0,1,1,0.0,0.0
Horia,pressone.ro,0,1,1,2,-0.5,0.5
Horia Teodorescu,pressone.ro,0,0,2,2,0.0,0.0
Irinel Călin,pressone.ro,0,0,2,2,0.0,0.0
Iris Ionescu,pressone.ro,0,0,1,1,0.0,0.0
Liliana Boioglu,pressone.ro,0,0,1,1,0.0,0.0
Lucian Simion,pressone.ro,0,0,2,2,0.0,0.0
Moldoveanu,pressone.ro,0,0,1,1,0.0,0.0
Niculae Adămița,pressone.ro,0,0,1,1,0.0,0.0
Niculae Adămiță,pressone.ro,0,1,0,1,-1.0,1.0
Ovidiu Munteanu,pressone.ro,0,0,1,1,0.0,0.0
Patrick Andre de Hillerin,pressone.ro,0,0,1,1,0.0,0.0
Patrick de Hillerin,pressone.ro,0,0,1,1,0.0,0.0
Paul Cononov,pressone.ro,0,0,1,1,0.0,0.0
Petre Badea,pressone.ro,0,1,3,4,-0.25,0.25
Petre Badea Cine,pressone.ro,0,1,0,1,-1.0,1.0
Robert Berbecel,pressone.ro,0,0,1,1,0.0,0.0
Soții Boioglu,pressone.ro,0,0,1,1,0.0,0.0
Teo,pressone.ro,0,0,1,1,0.0,0.0
Teodorescu,pressone.ro,0,0,2,2,0.0,0.0
Topdog,pressone.ro,0,1,0,1,-1.0,1.0
Tudor,pressone.ro,0,0,2,2,0.0,0.0
Tulcea,pressone.ro,0,0,4,4,0.0,0.0
V. Epilog,pressone.ro,0,0,1,1,0.0,0.0
Valentin Moldoveanu,pressone.ro,0,0,1,1,0.0,0.0
Viorel Dima,pressone.ro,0,0,1,1,0.0,0.0
consilier județean,pressone.ro,0,0,2,2,0.0,0.0
edil,pressone.ro,0,5,1,6,-0.8333333333333334,0.8333333333333334
Cristian Andrei,pressone.ro,0,0,2,2,0.0,0.0
licean,pressone.ro,0,1,0,1,-1.0,1.0
ospătăriță,pressone.ro,0,0,1,1,0.0,0.0
sponsor,pressone.ro,0,0,5,5,0.0,0.0
sărac,pressone.ro,0,1,0,1,-1.0,1.0
tulcean,pressone.ro,0,1,0,1,-1.0,1.0
Mihai Voicu,stirileprotv.ro,0,0,1,1,0.0,0.0
Mihai Ungureanu,stirileprotv.ro,0,1,1,2,-0.5,0.5
Botoșani,www.realitatea.net,0,0,1,1,0.0,0.0
Suceava,www.realitatea.net,0,0,1,1,0.0,0.0
vinovat,agerpres.ro,0,1,0,1,-1.0,1.0
Kelemen Hunor,www.g4media.ro,1,1,8,10,0.0,0.0
Paul Stănescu,www.g4media.ro,0,0,5,5,0.0,0.0
demnitar,www.digi24.ro,0,10,1,11,-0.9090909090909091,0.9090909090909091
asimilat,www.digi24.ro,0,0,1,1,0.0,0.0
participanț,www.digi24.ro,0,1,1,2,-0.5,0.5
personal,www.digi24.ro,1,1,2,4,0.0,0.0
stat,www.digi24.ro,0,0,1,1,0.0,0.0
subprefect,www.digi24.ro,0,0,1,1,0.0,0.0
subsecretar,www.digi24.ro,0,0,2,2,0.0,0.0
superior ierarhic,www.digi24.ro,0,0,1,1,0.0,0.0
înlocuitor,www.digi24.ro,0,2,0,2,-1.0,1.0
actriță,www.digi24.ro,3,0,1,4,0.75,0.75
director general,www.digi24.ro,0,0,1,1,0.0,0.0
DC,www.digi24.ro,0,0,1,1,0.0,0.0
Frederick Kempe,www.digi24.ro,0,0,1,1,0.0,0.0
Christopher G. Cavoli,www.digi24.ro,1,0,0,1,1.0,1.0
Gina M. Raimondo,www.digi24.ro,1,0,0,1,1.0,1.0
Rhode Island,www.digi24.ro,0,0,1,1,0.0,0.0
Stephen J. Hadley,www.digi24.ro,0,0,1,1,0.0,0.0
Washington,www.digi24.ro,1,1,4,6,0.0,0.0
destinatar,www.digi24.ro,0,0,1,1,0.0,0.0
guvernator,www.digi24.ro,0,2,2,4,-0.5,0.5
laureat,www.digi24.ro,1,0,0,1,1.0,1.0
Michelle Yeoh,www.digi24.ro,2,0,0,2,1.0,1.0
exponenț,www.g4media.ro,0,1,0,1,-1.0,1.0
Sălciua,www.romaniatv.net,0,0,1,1,0.0,0.0
Timiș,www.romaniatv.net,0,0,5,5,0.0,0.0
Valeriu Tabără,www.romaniatv.net,0,0,1,1,0.0,0.0
Văcăroiu,www.romaniatv.net,0,0,1,1,0.0,0.0
Cristian Rizea,pressone.ro,0,4,0,4,-1.0,1.0
Cătălin Predoiu,pressone.ro,0,1,3,4,-0.25,0.25
Emilia Șercan,pressone.ro,0,5,2,7,-0.7142857142857143,0.7142857142857143
Fugarul,pressone.ro,0,1,0,1,-1.0,1.0
Maia Sandu,pressone.ro,0,0,3,3,0.0,0.0
Recruții,pressone.ro,0,5,0,5,-1.0,1.0
Rizea,pressone.ro,0,3,0,3,-1.0,1.0
Stefano Bottoni,pressone.ro,0,0,7,7,0.0,0.0
Maricel Păcuraru,pressone.ro,0,1,0,1,-1.0,1.0
condamnat,pressone.ro,0,2,0,2,-1.0,1.0
dumneavoastră,pressone.ro,0,1,1,2,-0.5,0.5
intermediar,pressone.ro,0,2,1,3,-0.6666666666666666,0.6666666666666666
ofițer,pressone.ro,0,4,10,14,-0.2857142857142857,0.2857142857142857
om de cuvânt,pressone.ro,0,1,0,1,-1.0,1.0
Natalia Gavriliță,pressone.ro,0,1,0,1,-1.0,1.0
Adriana Cojocaru,recorder.ro,0,1,0,1,-1.0,1.0
Alfred Bulai,recorder.ro,0,0,1,1,0.0,0.0
Atena,recorder.ro,0,0,1,1,0.0,0.0
Camelia Potec,recorder.ro,1,0,0,1,1.0,1.0
David Popovici,recorder.ro,1,0,0,1,1.0,1.0
Ion,recorder.ro,0,0,1,1,0.0,0.0
Gabriel Nicolae,recorder.ro,1,0,1,2,0.5,0.5
Luke Hobson,recorder.ro,0,0,1,1,0.0,0.0
Matthew Richards,recorder.ro,0,0,1,1,0.0,0.0
Popovici,recorder.ro,1,0,1,2,0.5,0.5
celebritate,recorder.ro,0,0,1,1,0.0,0.0
escroc,recorder.ro,0,3,0,3,-1.0,1.0
hoț,recorder.ro,0,3,0,3,-1.0,1.0
Dragoș Pătraru,recorder.ro,0,1,0,1,-1.0,1.0
prezentator,recorder.ro,0,0,1,1,0.0,0.0
înotător,recorder.ro,1,0,0,1,1.0,1.0
Țiriac,recorder.ro,0,1,0,1,-1.0,1.0
Brătian,www.digi24.ro,0,1,0,1,-1.0,1.0
Carol I,www.digi24.ro,0,0,2,2,0.0,0.0
Cristian Preda,www.digi24.ro,0,0,1,1,0.0,0.0
Gheorghe Grigore Cantacuzino,www.digi24.ro,0,0,1,1,0.0,0.0
Lascăr Catargiu,www.digi24.ro,0,0,1,1,0.0,0.0
Radu Rosetti,www.digi24.ro,0,0,1,1,0.0,0.0
boier,www.digi24.ro,2,0,0,2,1.0,1.0
cunoscător,www.digi24.ro,1,0,1,2,0.5,0.5
Lucian Iorga,www.digi24.ro,0,0,1,1,0.0,0.0
Daniel Pîslaru,www.romaniatv.net,0,0,1,1,0.0,0.0
Galați,www.romaniatv.net,0,0,4,4,0.0,0.0
Gigel Știrbu,www.romaniatv.net,0,1,1,2,-0.5,0.5
Prahova,www.romaniatv.net,0,0,3,3,0.0,0.0
Scornicești,www.romaniatv.net,0,0,1,1,0.0,0.0
observator,www.romaniatv.net,0,1,3,4,-0.25,0.25
Știrbu,www.romaniatv.net,0,1,0,1,-1.0,1.0
America,observatornews.ro,0,1,1,2,-0.5,0.5
Andy Ogles,observatornews.ro,0,1,1,2,-0.5,0.5
Anna Paulina Luna,observatornews.ro,0,0,2,2,0.0,0.0
Biden,observatornews.ro,0,1,0,1,-1.0,1.0
Buchanan,observatornews.ro,0,0,1,1,0.0,0.0
Cosmin Corendea,observatornews.ro,0,0,1,1,0.0,0.0
Danemarca,observatornews.ro,0,0,1,1,0.0,0.0
Dunn,observatornews.ro,0,1,0,1,-1.0,1.0
Florida,observatornews.ro,0,0,2,2,0.0,0.0
Groenlanda,observatornews.ro,0,1,1,2,-0.5,0.5
Joe Biden,observatornews.ro,0,1,4,5,-0.2,0.2
Neal Dunn,observatornews.ro,0,0,1,1,0.0,0.0
Ogles,observatornews.ro,0,1,0,1,-1.0,1.0
Tennessee,observatornews.ro,0,0,1,1,0.0,0.0
Vern Buchanan,observatornews.ro,0,0,2,2,0.0,0.0
congresman,observatornews.ro,0,2,2,4,-0.5,0.5
fondator,observatornews.ro,1,0,2,3,0.3333333333333333,0.3333333333333333
reprezentantă,observatornews.ro,0,1,1,2,-0.5,0.5
susținătoare,observatornews.ro,0,1,0,1,-1.0,1.0
susținător,observatornews.ro,2,2,12,16,0.0,0.0
veteran,observatornews.ro,1,0,0,1,1.0,1.0
Cristian Terheș,observatornews.ro,0,0,1,1,0.0,0.0
Drulă,observatornews.ro,0,1,3,4,-0.25,0.25
Dulă,observatornews.ro,0,1,0,1,-1.0,1.0
Petre Lăzăroiu,observatornews.ro,0,0,1,1,0.0,0.0
Președintele,observatornews.ro,1,0,2,3,0.3333333333333333,0.3333333333333333
Sebastian Constantin Popescu,observatornews.ro,0,0,1,1,0.0,0.0
Sebastian Popescu,observatornews.ro,0,1,0,1,-1.0,1.0
Terheș,observatornews.ro,0,0,1,1,0.0,0.0
contestatar,observatornews.ro,0,1,1,2,-0.5,0.5
politician,observatornews.ro,0,6,3,9,-0.6666666666666666,0.6666666666666666
Boiko Borisov,recorder.ro,0,0,1,1,0.0,0.0
Dan Motreanu,recorder.ro,0,1,2,3,-0.3333333333333333,0.3333333333333333
Florin Țugui,recorder.ro,0,2,0,2,-1.0,1.0
Mihai Tudose,recorder.ro,0,1,7,8,-0.125,0.125
Rareș Bogdan,recorder.ro,0,3,3,6,-0.5,0.5
Rumen Radev,recorder.ro,0,0,1,1,0.0,0.0
Vicovu de Jos,recorder.ro,0,1,1,2,-0.5,0.5
inculpat,recorder.ro,0,3,1,4,-0.75,0.75
traficant,recorder.ro,0,2,0,2,-1.0,1.0
Oltenia,pressone.ro,1,0,1,2,0.5,0.5
Republica de la Weimar,pressone.ro,0,0,1,1,0.0,0.0
Claudiu Târziu,observatornews.ro,0,0,2,2,0.0,0.0
Dominic Fritz,observatornews.ro,0,0,5,5,0.0,0.0
expert,observatornews.ro,0,2,1,3,-0.6666666666666666,0.6666666666666666
Timișoara,observatornews.ro,1,0,7,8,0.125,0.125
Dan,primanews.ro,1,0,4,5,0.2,0.2
specialist,primanews.ro,0,0,2,2,0.0,0.0
vizitator,recorder.ro,0,1,10,11,-0.09090909090909091,0.09090909090909091
donator,recorder.ro,0,1,3,4,-0.25,0.25
titular,recorder.ro,0,1,0,1,-1.0,1.0
utilizator,recorder.ro,0,0,2,2,0.0,0.0
Adrian Țuțuianu,pressone.ro,0,2,1,3,-0.6666666666666666,0.6666666666666666
James Bond,pressone.ro,0,0,1,1,0.0,0.0
Sevid Shhaideh,pressone.ro,0,1,0,1,-1.0,1.0
amândoi,pressone.ro,0,1,2,3,-0.3333333333333333,0.3333333333333333
chestor,pressone.ro,0,1,3,4,-0.25,0.25
internaut,pressone.ro,0,1,0,1,-1.0,1.0
klingonian,pressone.ro,0,1,0,1,-1.0,1.0
predecesor,pressone.ro,0,4,2,6,-0.6666666666666666,0.6666666666666666
premiu,pressone.ro,0,1,1,2,-0.5,0.5
utiliza,pressone.ro,0,1,0,1,-1.0,1.0
Țuțuianu,pressone.ro,0,1,0,1,-1.0,1.0
Sebastian Ghita,www.aktual24.ro,0,4,1,5,-0.8,0.8
Sebia,www.aktual24.ro,0,0,1,1,0.0,0.0
Angel Tilvar,www.luju.ro,0,2,1,3,-0.6666666666666666,0.6666666666666666
George Tar,www.luju.ro,0,1,0,1,-1.0,1.0
Nibilul Ministrul,www.luju.ro,0,1,0,1,-1.0,1.0
Radu Theodoru,www.luju.ro,0,1,1,2,-0.5,0.5
Tilvar,www.luju.ro,0,1,0,1,-1.0,1.0
internaut,www.luju.ro,0,1,0,1,-1.0,1.0
secretar,www.luju.ro,0,2,6,8,-0.25,0.25
veteran,www.luju.ro,0,1,1,2,-0.5,0.5
Noua Zeelandă,adevarul.ro,0,0,5,5,0.0,0.0
Bihor,a1.ro,0,0,2,2,0.0,0.0
Vadu Crișului,a1.ro,0,0,1,1,0.0,0.0
America,www.aktual24.ro,0,0,1,1,0.0,0.0
Baneasa,www.aktual24.ro,0,0,1,1,0.0,0.0
Boia,www.aktual24.ro,0,0,1,1,0.0,0.0
Brucan,www.aktual24.ro,0,1,1,2,-0.5,0.5
Canadei,www.aktual24.ro,0,0,2,2,0.0,0.0
Caraman,www.aktual24.ro,0,1,0,1,-1.0,1.0
Cătălin Ranco Pitu,www.aktual24.ro,0,0,1,1,0.0,0.0
Cehoslovacia,www.aktual24.ro,0,0,1,1,0.0,0.0
Cristi Preda,www.aktual24.ro,0,0,1,1,0.0,0.0
Fota,www.aktual24.ro,0,1,2,3,-0.3333333333333333,0.3333333333333333
Eltin,www.aktual24.ro,0,1,0,1,-1.0,1.0
Gorbaciov,www.aktual24.ro,0,0,1,1,0.0,0.0
Adolf Hitler,www.aktual24.ro,0,4,0,4,-1.0,1.0
Iliescu,www.aktual24.ro,0,3,0,3,-1.0,1.0
Ion Iliescu,www.aktual24.ro,1,1,2,4,0.0,0.0
Ionita,www.aktual24.ro,0,1,1,2,-0.5,0.5
Magureanu,www.aktual24.ro,0,0,1,1,0.0,0.0
Manfred Worner,www.aktual24.ro,0,1,0,1,-1.0,1.0
Mazilu,www.aktual24.ro,0,1,0,1,-1.0,1.0
Mihai Caraman,www.aktual24.ro,0,3,0,3,-1.0,1.0
Militaru,www.aktual24.ro,0,1,0,1,-1.0,1.0
Pacepa,www.aktual24.ro,0,1,0,1,-1.0,1.0
părinte,www.aktual24.ro,1,2,6,9,-0.1111111111111111,0.1111111111111111
Plesita,www.aktual24.ro,0,1,0,1,-1.0,1.0
Pragai,www.aktual24.ro,0,0,1,1,0.0,0.0
prim-ministru,www.aktual24.ro,0,7,8,15,-0.4666666666666667,0.4666666666666667
Primakov,www.aktual24.ro,0,1,0,1,-1.0,1.0
RDG,www.aktual24.ro,0,0,1,1,0.0,0.0
Romanică,www.aktual24.ro,0,1,0,1,-1.0,1.0
Stefan Andrei,www.aktual24.ro,0,0,1,1,0.0,0.0
Todor Jivkov,www.aktual24.ro,0,1,0,1,-1.0,1.0
Toti,www.aktual24.ro,0,1,1,2,-0.5,0.5
Varșovia,www.aktual24.ro,0,1,3,4,-0.25,0.25
ală,www.aktual24.ro,0,2,0,2,-1.0,1.0
Patilinet,www.aktual24.ro,0,1,0,1,-1.0,1.0
astia,www.aktual24.ro,0,1,0,1,-1.0,1.0
badaran,www.aktual24.ro,0,1,0,1,-1.0,1.0
baiat,www.aktual24.ro,0,3,0,3,-1.0,1.0
căpitan,www.aktual24.ro,0,0,1,1,0.0,0.0
civil,www.aktual24.ro,0,1,1,2,-0.5,0.5
comandant,www.aktual24.ro,0,2,1,3,-0.6666666666666666,0.6666666666666666
complotist,www.aktual24.ro,0,1,0,1,-1.0,1.0
conspirator,www.aktual24.ro,0,1,0,1,-1.0,1.0
Mihai Ionescu,www.aktual24.ro,0,0,1,1,0.0,0.0
loditor,www.aktual24.ro,0,1,0,1,-1.0,1.0
maior,www.aktual24.ro,0,0,1,1,0.0,0.0
muncitor,www.aktual24.ro,0,1,0,1,-1.0,1.0
Nica Nicu,www.aktual24.ro,0,1,0,1,-1.0,1.0
noroac,www.aktual24.ro,0,1,0,1,-1.0,1.0
ofițer,www.aktual24.ro,0,1,0,1,-1.0,1.0
partener,www.aktual24.ro,1,6,3,10,-0.5,0.5
Popieluszko,www.aktual24.ro,0,1,0,1,-1.0,1.0
profesoară,www.aktual24.ro,0,1,1,2,-0.5,0.5
securist,www.aktual24.ro,0,2,0,2,-1.0,1.0
spion,www.aktual24.ro,0,1,0,1,-1.0,1.0
suveranist,www.aktual24.ro,0,4,0,4,-1.0,1.0
tip,www.aktual24.ro,1,1,0,2,0.0,0.0
tro,www.aktual24.ro,0,1,0,1,-1.0,1.0
tuturor,www.aktual24.ro,1,0,0,1,1.0,1.0
ule,www.aktual24.ro,0,1,0,1,-1.0,1.0
victima,www.aktual24.ro,1,2,0,3,-0.3333333333333333,0.3333333333333333
Florentina Peia,agerpres.ro,0,0,8,8,0.0,0.0
Cîrstoiu,www.comisarul.ro,0,1,0,1,-1.0,1.0
Cătălin Cîrstoiu,www.comisarul.ro,0,1,0,1,-1.0,1.0
Diana Șoșoacă,www.comisarul.ro,1,7,2,10,-0.6,0.6
Simonis,www.comisarul.ro,0,1,1,2,-0.5,0.5
dl Simonis,www.comisarul.ro,0,1,0,1,-1.0,1.0
Șoșoacă,www.comisarul.ro,0,2,0,2,-1.0,1.0
oaie,www.comisarul.ro,0,1,0,1,-1.0,1.0
pesediști,www.comisarul.ro,0,1,0,1,-1.0,1.0
puști,www.comisarul.ro,0,1,0,1,-1.0,1.0
tulpină,www.comisarul.ro,0,1,0,1,-1.0,1.0
victimă,www.comisarul.ro,0,5,2,7,-0.7142857142857143,0.7142857142857143
învingător,www.comisarul.ro,0,1,1,2,-0.5,0.5
învins,www.comisarul.ro,0,1,0,1,-1.0,1.0
învinșit,www.comisarul.ro,0,1,0,1,-1.0,1.0
șo,www.comisarul.ro,0,0,1,1,0.0,0.0
Crin Antonscu,www.news.ro,0,0,1,1,0.0,0.0
agent,www.news.ro,0,1,0,1,-1.0,1.0
capitală,stirileprotv.ro,0,0,3,3,0.0,0.0
Anamaria Gavrilă,agerpres.ro,0,3,0,3,-1.0,1.0
Ciprian Șerban,agerpres.ro,0,0,4,4,0.0,0.0
Coarnă,agerpres.ro,0,1,0,1,-1.0,1.0
Daniel Fenechiu,agerpres.ro,0,1,2,3,-0.3333333333333333,0.3333333333333333
Diana Șoșoacă,agerpres.ro,0,2,0,2,-1.0,1.0
Dumitru Coarnă,agerpres.ro,0,1,0,1,-1.0,1.0
Fenechiu,agerpres.ro,0,2,2,4,-0.5,0.5
Gavrilă,agerpres.ro,0,3,0,3,-1.0,1.0
Klaus Iohannis,agerpres.ro,0,4,3,7,-0.5714285714285714,0.5714285714285714
Mihai Poziom,agerpres.ro,0,0,1,1,0.0,0.0
Mihai Poziumschi,agerpres.ro,0,0,2,2,0.0,0.0
Mihai Enache,agerpres.ro,0,1,0,1,-1.0,1.0
Moscova,agerpres.ro,0,2,0,2,-1.0,1.0
personaj,agerpres.ro,0,0,1,1,0.0,0.0
slugă,agerpres.ro,0,1,0,1,-1.0,1.0
Ștefan Pălărie,agerpres.ro,0,0,2,2,0.0,0.0
Jules Verne,www.euronews.ro,0,0,1,1,0.0,0.0
Belarus,www.cotidianul.ro,0,1,0,1,-1.0,1.0
Braun,www.cotidianul.ro,0,1,0,1,-1.0,1.0
Szymon Holownia,www.cotidianul.ro,0,0,1,1,0.0,0.0
Donald Tusk,www.cotidianul.ro,0,2,2,4,-0.5,0.5
Elon Musk,www.cotidianul.ro,0,1,0,1,-1.0,1.0
Gregorz Braun,www.cotidianul.ro,0,1,0,1,-1.0,1.0
Holownia,www.cotidianul.ro,0,0,1,1,0.0,0.0
Jaroslaw Kaczynski,www.cotidianul.ro,0,1,0,1,-1.0,1.0
Keith Kellogg,www.cotidianul.ro,0,0,1,1,0.0,0.0
Kiev,www.cotidianul.ro,0,2,1,3,-0.6666666666666666,0.6666666666666666
Mentzen,www.cotidianul.ro,0,0,1,1,0.0,0.0
Nawrocki,www.cotidianul.ro,0,1,1,2,-0.5,0.5
Polonia,www.cotidianul.ro,0,0,6,6,0.0,0.0
Rafal Trzaskowski,www.cotidianul.ro,0,0,3,3,0.0,0.0
Slawomir Mentzen,www.cotidianul.ro,0,1,1,2,-0.5,0.5
Trzask,www.cotidianul.ro,0,0,1,1,0.0,0.0
Trzaskowski,www.cotidianul.ro,0,0,2,2,0.0,0.0
Tusk,www.cotidianul.ro,0,1,1,2,-0.5,0.5
Varșovia,www.cotidianul.ro,0,1,2,3,-0.3333333333333333,0.3333333333333333
alegător,www.cotidianul.ro,1,8,3,12,-0.5833333333333334,0.5833333333333334
Karol Nawrocki,www.cotidianul.ro,0,1,1,2,-0.5,0.5
elector,www.cotidianul.ro,0,1,1,2,-0.5,0.5
favorit,www.cotidianul.ro,0,1,0,1,-1.0,1.0
imigrant,www.cotidianul.ro,0,1,0,1,-1.0,1.0
istoric,www.cotidianul.ro,0,1,0,1,-1.0,1.0
ki,www.cotidianul.ro,0,0,1,1,0.0,0.0
Andrzej Duda,www.cotidianul.ro,0,0,2,2,0.0,0.0
proprietar,www.cotidianul.ro,0,1,2,3,-0.3333333333333333,0.3333333333333333
refugiat,www.cotidianul.ro,0,2,0,2,-1.0,1.0
trimis,www.cotidianul.ro,0,1,0,1,-1.0,1.0
judecător,adevarul.ro,1,20,40,61,-0.3114754098360656,0.3114754098360656
Alexandru Dobrău,www.gandul.ro,0,0,1,1,0.0,0.0
Cristian Tudor,adevarul.ro,0,0,1,1,0.0,0.0
Eduard Hellvig,adevarul.ro,0,1,5,6,-0.16666666666666666,0.16666666666666666
Felix Pătrășcanu,adevarul.ro,0,0,1,1,0.0,0.0
Funeriu,adevarul.ro,0,1,3,4,-0.25,0.25
Hellvig,adevarul.ro,0,1,2,3,-0.3333333333333333,0.3333333333333333
Lucian Mîndruță,adevarul.ro,0,0,1,1,0.0,0.0
Mîndruță,adevarul.ro,0,0,1,1,0.0,0.0
Oana Gheorghiu,adevarul.ro,0,0,1,1,0.0,0.0
Theodor Paleologu,adevarul.ro,0,0,2,2,0.0,0.0
figură,adevarul.ro,0,3,0,3,-1.0,1.0
penal,agerpres.ro,0,1,0,1,-1.0,1.0
Alin Mureșan,pressone.ro,0,0,2,2,0.0,0.0
Cristian Micu,pressone.ro,0,0,1,1,0.0,0.0
Ernest Oberländer,pressone.ro,0,0,1,1,0.0,0.0
Oberländer,pressone.ro,0,1,0,1,-1.0,1.0
Ovidiu Raețchi,pressone.ro,0,0,2,2,0.0,0.0
Radu Preda,pressone.ro,0,0,1,1,0.0,0.0
Ungureanu,pressone.ro,0,1,1,2,-0.5,0.5
Gigel Știrbu,pressone.ro,0,3,3,6,-0.5,0.5
deținut,pressone.ro,0,3,1,4,-0.75,0.75
Andronache,pressone.ro,0,2,0,2,-1.0,1.0
juriști,pressone.ro,0,1,1,2,-0.5,0.5
Constantin Brâncuși,pressone.ro,0,0,1,1,0.0,0.0
Știrbu,pressone.ro,0,1,1,2,-0.5,0.5
Alexandru Vornicu,www.antena3.ro,0,1,0,1,-1.0,1.0
anchetator,www.antena3.ro,0,3,1,4,-0.75,0.75
Ciolpani,www.antena3.ro,0,1,0,1,-1.0,1.0
Dan Cristian Panța,www.antena3.ro,0,0,1,1,0.0,0.0
Eugen Sechila,www.antena3.ro,0,0,1,1,0.0,0.0
Frank Timiș,www.antena3.ro,0,3,0,3,-1.0,1.0
Horațiu Potra,www.antena3.ro,0,3,1,4,-0.75,0.75
Lucian Blaga,www.antena3.ro,0,1,0,1,-1.0,1.0
Marian Motocu,www.antena3.ro,0,1,0,1,-1.0,1.0
Marin Burcea,www.antena3.ro,0,1,0,1,-1.0,1.0
Mihai Eminescu,www.antena3.ro,0,0,1,1,0.0,0.0
Potra,www.antena3.ro,0,3,0,3,-1.0,1.0
Zelea Codreanu,www.antena3.ro,0,1,0,1,-1.0,1.0
admirator,www.antena3.ro,0,0,1,1,0.0,0.0
apropiat,www.antena3.ro,0,3,4,7,-0.42857142857142855,0.42857142857142855
intermediar,www.antena3.ro,0,1,1,2,-0.5,0.5
om de afaceri,www.antena3.ro,0,5,3,8,-0.625,0.625
patron,www.antena3.ro,0,1,1,2,-0.5,0.5
Daniela Rotaru,www.g4media.ro,0,0,1,1,0.0,0.0
Mihai Cristian Ciolacu,www.g4media.ro,0,0,1,1,0.0,0.0
Mihai Rotaru,www.g4media.ro,0,0,1,1,0.0,0.0
afacere,www.g4media.ro,0,1,0,1,-1.0,1.0
prieten,www.g4media.ro,4,0,0,4,1.0,1.0
Donald Tusk,recorder.ro,0,1,1,2,-0.5,0.5
Polonia,recorder.ro,0,1,5,6,-0.16666666666666666,0.16666666666666666
Radosław Sikorski,recorder.ro,0,0,1,1,0.0,0.0
Tadkijistan,recorder.ro,0,1,0,1,-1.0,1.0
Taiwan,recorder.ro,0,0,1,1,0.0,0.0
complic,recorder.ro,0,2,0,2,-1.0,1.0
Daniel Constantin,pressone.ro,0,1,4,5,-0.2,0.2
Eugen Teodorovici,pressone.ro,0,1,5,6,-0.16666666666666666,0.16666666666666666
Mădălina Dobrovolschi,pressone.ro,0,0,1,1,0.0,0.0
Nicolae Bănicioiu,pressone.ro,0,0,6,6,0.0,0.0
Radu Vasile,pressone.ro,0,1,1,2,-0.5,0.5
Scarlat Iriza,pressone.ro,0,1,3,4,-0.25,0.25
Sorin Cîmpeanu,pressone.ro,0,9,12,21,-0.42857142857142855,0.42857142857142855
concurent,pressone.ro,0,1,0,1,-1.0,1.0
tehnocrat,pressone.ro,0,3,0,3,-1.0,1.0
delegat,recorder.ro,0,1,1,2,-0.5,0.5
pretendent,recorder.ro,0,1,1,2,-0.5,0.5
Dragoș Sprânceană,www.digi24.ro,0,0,2,2,0.0,0.0
Kiev,www.digi24.ro,3,1,1,5,0.4,0.4
Macron,www.digi24.ro,0,2,1,3,-0.6666666666666666,0.6666666666666666
Sprânceană,www.digi24.ro,0,1,0,1,-1.0,1.0
Sprînceană,www.digi24.ro,0,4,2,6,-0.6666666666666666,0.6666666666666666
Joe Biden,www.euronews.ro,0,1,7,8,-0.125,0.125
Kamala Harris,www.euronews.ro,0,0,4,4,0.0,0.0
Kiev,www.euronews.ro,0,4,8,12,-0.3333333333333333,0.3333333333333333
Liban,www.euronews.ro,0,0,6,6,0.0,0.0
Vatman,www.euronews.ro,0,1,0,1,-1.0,1.0
Washington,www.euronews.ro,1,0,11,12,0.08333333333333333,0.08333333333333333
agent,www.euronews.ro,0,2,0,2,-1.0,1.0
conducător,www.euronews.ro,0,3,1,4,-0.75,0.75
personal,www.euronews.ro,0,1,2,3,-0.3333333333333333,0.3333333333333333
pieton,www.euronews.ro,0,0,1,1,0.0,0.0
vatman,www.euronews.ro,0,1,1,2,-0.5,0.5
înalt,www.euronews.ro,0,0,1,1,0.0,0.0
Paraschiv,www.b1tv.ro,0,1,0,1,-1.0,1.0
elector,www.b1tv.ro,0,4,0,4,-1.0,1.0
erou,www.b1tv.ro,2,2,0,4,0.0,0.0
respondent,www.b1tv.ro,0,1,3,4,-0.25,0.25
tânăr,www.b1tv.ro,2,1,1,4,0.25,0.25
AUR,pressone.ro,0,2,0,2,-1.0,1.0
Ciuca,pressone.ro,0,1,0,1,-1.0,1.0
Ursula von der Leyen,stirileprotv.ro,1,0,4,5,0.2,0.2
ambasadoare,stirileprotv.ro,0,0,1,1,0.0,0.0
Matei,stirileprotv.ro,0,0,1,1,0.0,0.0
Ivan,stirileprotv.ro,0,0,1,1,0.0,0.0
Geoană,stirileprotv.ro,0,1,4,5,-0.2,0.2
Ion Iliescu,stirileprotv.ro,0,0,7,7,0.0,0.0
Oprescu,stirileprotv.ro,0,1,0,1,-1.0,1.0
destinatar,www.romaniatv.net,0,0,1,1,0.0,0.0
fermier,www.romaniatv.net,1,0,3,4,0.25,0.25
gospodărie,www.romaniatv.net,1,0,0,1,1.0,1.0
polițist,www.romaniatv.net,0,3,7,10,-0.3,0.3
vârstnic,www.romaniatv.net,1,0,1,2,0.5,0.5
"Adrian Veștea, secretar general",snoop.ro,0,0,1,1,0.0,0.0
Antonescu,snoop.ro,0,0,1,1,0.0,0.0
Crin Antonescu,snoop.ro,0,0,2,2,0.0,0.0
Cătălin Predoiu,snoop.ro,0,0,4,4,0.0,0.0
Ilie Bolojan,snoop.ro,0,0,5,5,0.0,0.0
Lucian Bode,snoop.ro,0,1,3,4,-0.25,0.25
Mihail Volintiru,snoop.ro,0,1,2,3,-0.3333333333333333,0.3333333333333333
Rareș Bogdan,snoop.ro,0,3,6,9,-0.3333333333333333,0.3333333333333333
Victor Ponta,snoop.ro,0,0,5,5,0.0,0.0
Virgil Guran,snoop.ro,0,0,1,1,0.0,0.0
liberal,snoop.ro,0,4,2,6,-0.6666666666666666,0.6666666666666666
notar,snoop.ro,0,1,1,2,-0.5,0.5
Clotilde Armand,snoop.ro,0,0,2,2,0.0,0.0
Dan Trifu,snoop.ro,0,0,3,3,0.0,0.0
Dani Caramihai,snoop.ro,0,0,1,1,0.0,0.0
George Tuță,snoop.ro,0,0,1,1,0.0,0.0
investitor,snoop.ro,0,1,3,4,-0.25,0.25
Mircea Fechet,snoop.ro,0,0,3,3,0.0,0.0
Niculae Caramihai,snoop.ro,0,0,1,1,0.0,0.0
Trifu,snoop.ro,0,1,1,2,-0.5,0.5
Zoița,snoop.ro,0,0,1,1,0.0,0.0
locuitor,snoop.ro,0,2,15,17,-0.11764705882352941,0.11764705882352941
viceprimar,snoop.ro,0,4,5,9,-0.4444444444444444,0.4444444444444444
Aleksandar Vucic,www.aktual24.ro,0,1,1,2,-0.5,0.5
Milos Vucevic,www.aktual24.ro,0,0,1,1,0.0,0.0
Novi Sad,www.aktual24.ro,0,0,2,2,0.0,0.0
Serbia,www.aktual24.ro,1,1,1,3,0.0,0.0
Serb,www.aktual24.ro,0,0,2,2,0.0,0.0
Vucevic,www.aktual24.ro,0,0,1,1,0.0,0.0
vicepremier,www.aktual24.ro,0,0,4,4,0.0,0.0
Aurelian Dochia,pressone.ro,0,0,4,4,0.0,0.0
Baltasiu,pressone.ro,0,3,1,4,-0.75,0.75
Barna,pressone.ro,0,4,1,5,-0.8,0.8
Codru Vrabie,pressone.ro,0,0,1,1,0.0,0.0
George Cali,pressone.ro,0,0,1,1,0.0,0.0
George Calin,pressone.ro,0,0,3,3,0.0,0.0
George Călin Florin Cîțu,pressone.ro,0,0,1,1,0.0,0.0
pompier,pressone.ro,0,0,2,2,0.0,0.0
Radu Baltasiu,pressone.ro,0,5,3,8,-0.625,0.625
Superman,pressone.ro,0,0,1,1,0.0,0.0
Valentin Ionescu,pressone.ro,0,0,1,1,0.0,0.0
Vama Veche,pressone.ro,0,0,1,1,0.0,0.0
Oana,adevarul.ro,0,0,2,2,0.0,0.0
Alexandru Rafila,www.b1tv.ro,0,1,0,1,-1.0,1.0
senatoare,www.b1tv.ro,1,2,0,3,-0.3333333333333333,0.3333333333333333
economișt,www.b1tv.ro,0,1,0,1,-1.0,1.0
juriști,www.b1tv.ro,0,1,0,1,-1.0,1.0
Rafila,www.b1tv.ro,0,1,0,1,-1.0,1.0
pensionar,www.b1tv.ro,0,1,0,1,-1.0,1.0
AUR,www.antena3.ro,0,0,1,1,0.0,0.0
Andrei Laslau,www.antena3.ro,0,2,0,2,-1.0,1.0
Daniel Polifrone,www.antena3.ro,0,1,0,1,-1.0,1.0
Daniil Starkov,www.antena3.ro,0,0,1,1,0.0,0.0
Dmitri Medvedev,www.antena3.ro,0,0,1,1,0.0,0.0
ERT,www.antena3.ro,0,0,1,1,0.0,0.0
Evaline Sophie,www.antena3.ro,0,0,1,1,0.0,0.0
Ewan Henry Tolladay,www.antena3.ro,0,0,1,1,0.0,0.0
Ewan Tolladay,www.antena3.ro,0,1,0,1,-1.0,1.0
Federația Rusă,www.antena3.ro,0,2,1,3,-0.6666666666666666,0.6666666666666666
Guatemala,www.antena3.ro,0,0,1,1,0.0,0.0
Luke John Askew,www.antena3.ro,0,0,1,1,0.0,0.0
Malta,www.antena3.ro,0,1,0,1,-1.0,1.0
Matei Sergio,www.antena3.ro,0,0,2,2,0.0,0.0
Nicoleta Miuțescu,www.antena3.ro,0,1,0,1,-1.0,1.0
Novosibirsk,www.antena3.ro,0,0,1,1,0.0,0.0
Omid Nouripour,www.antena3.ro,0,0,1,1,0.0,0.0
Regatul Unit al Marii Britanii,www.antena3.ro,0,0,1,1,0.0,0.0
Republica Populară Chineză,www.antena3.ro,0,1,0,1,-1.0,1.0
Răzvan Mihulescu,www.antena3.ro,0,1,0,1,-1.0,1.0
Sandra Gina Eparon,www.antena3.ro,0,1,0,1,-1.0,1.0
Stanislav Fesenko,www.antena3.ro,0,1,0,1,-1.0,1.0
Turcia,www.antena3.ro,0,1,1,2,-0.5,0.5
Regatul Unit,www.antena3.ro,0,0,1,1,0.0,0.0
YouTuber,www.antena3.ro,0,1,0,1,-1.0,1.0
Yulia Serebryan,www.antena3.ro,0,1,0,1,-1.0,1.0
Yulia Serebrianskaya,www.antena3.ro,0,0,1,1,0.0,0.0
blogger,www.antena3.ro,0,1,0,1,-1.0,1.0
conspirator,www.antena3.ro,0,1,0,1,-1.0,1.0
coordonator,www.antena3.ro,0,1,2,3,-0.3333333333333333,0.3333333333333333
coproprietar,www.antena3.ro,0,1,0,1,-1.0,1.0
hacker,www.antena3.ro,0,1,0,1,-1.0,1.0
trol,www.antena3.ro,0,1,0,1,-1.0,1.0
șefă,www.antena3.ro,0,2,0,2,-1.0,1.0
,www.antena3.ro,0,2,3,5,-0.4,0.4
pescar,www.antena3.ro,1,0,0,1,1.0,1.0
Alfred Simonis,stirileprotv.ro,0,0,2,2,0.0,0.0
Laura Vicol,stirileprotv.ro,0,1,0,1,-1.0,1.0
Nisa,stirileprotv.ro,0,0,1,1,0.0,0.0
Vladimir Ciorbă,stirileprotv.ro,0,1,0,1,-1.0,1.0
asociat,stirileprotv.ro,0,1,0,1,-1.0,1.0
contracandidat,stirileprotv.ro,0,1,2,3,-0.3333333333333333,0.3333333333333333
fiu,stirileprotv.ro,0,0,1,1,0.0,0.0
pasager,stirileprotv.ro,0,0,1,1,0.0,0.0
soț,stirileprotv.ro,0,1,2,3,-0.3333333333333333,0.3333333333333333
Abu Dhabi,primanews.ro,0,0,1,1,0.0,0.0
Antalya,primanews.ro,0,0,4,4,0.0,0.0
EAU,primanews.ro,0,0,3,3,0.0,0.0
Emiratele Unite,primanews.ro,0,0,1,1,0.0,0.0
Hakan Fidan,primanews.ro,0,0,1,1,0.0,0.0
miliardar,primanews.ro,0,0,2,2,0.0,0.0
oficial,primanews.ro,0,8,4,12,-0.6666666666666666,0.6666666666666666
Ciprian Șerban,www.g4media.ro,0,0,3,3,0.0,0.0
Coarnă,www.g4media.ro,0,1,0,1,-1.0,1.0
Bogdan Ivănel,www.euronews.ro,0,0,1,1,0.0,0.0
Emil Constantinescu,www.euronews.ro,0,0,1,1,0.0,0.0
Haga,www.euronews.ro,0,0,1,1,0.0,0.0
ambasador,www.euronews.ro,1,0,0,1,1.0,1.0
domnie,www.euronews.ro,0,1,2,3,-0.3333333333333333,0.3333333333333333
personaj,www.euronews.ro,0,2,1,3,-0.6666666666666666,0.6666666666666666
profesionist,www.euronews.ro,2,0,0,2,1.0,1.0
specialist,www.euronews.ro,1,4,10,15,-0.2,0.2
Sorin Ioniță,recorder.ro,0,0,1,1,0.0,0.0
Cristoiu,www.mediafax.ro,0,0,1,1,0.0,0.0
Cătălin Predoiu,www.mediafax.ro,0,0,4,4,0.0,0.0
Ion Cristoiu,www.mediafax.ro,0,0,2,2,0.0,0.0
jurnalist,www.mediafax.ro,0,2,4,6,-0.3333333333333333,0.3333333333333333
publicist,www.mediafax.ro,0,0,1,1,0.0,0.0
urmăritor,www.mediafax.ro,0,1,0,1,-1.0,1.0
Elerna Lasconi,www.digi24.ro,0,0,1,1,0.0,0.0
Lasconi,www.digi24.ro,0,2,9,11,-0.18181818181818182,0.18181818181818182
Mihai Neamțu,www.g4media.ro,0,0,1,1,0.0,0.0
Mihail Neamțu,www.g4media.ro,0,1,1,2,-0.5,0.5
Cristian Terheș,www.g4media.ro,0,1,5,6,-0.16666666666666666,0.16666666666666666
Marian Neacșu,www.news.ro,0,0,1,1,0.0,0.0
Adina Alberts,pressone.ro,0,0,1,1,0.0,0.0
Adrian Zoican,pressone.ro,0,0,1,1,0.0,0.0
Argeș,pressone.ro,0,2,7,9,-0.2222222222222222,0.2222222222222222
Băluță,pressone.ro,0,1,0,1,-1.0,1.0
Chas J. Whalen,pressone.ro,0,0,1,1,0.0,0.0
Cîrstoiu,pressone.ro,0,3,5,8,-0.375,0.375
Cătălin Cîrstoiu,pressone.ro,0,1,7,8,-0.125,0.125
Daniel Pop,pressone.ro,0,0,1,1,0.0,0.0
Dorin Chirtoacă,pressone.ro,0,0,1,1,0.0,0.0
Elena Băsescu,pressone.ro,0,0,1,1,0.0,0.0
Eugen Nicolăescu,pressone.ro,0,0,3,3,0.0,0.0
Familia Cîrstoiu,pressone.ro,0,1,0,1,-1.0,1.0
Ioan Sîrbu,pressone.ro,0,0,1,1,0.0,0.0
Ion Cîrstoiu,pressone.ro,0,1,1,2,-0.5,0.5
Leon Dănăilă,pressone.ro,1,0,2,3,0.3333333333333333,0.3333333333333333
Lucian Judele,pressone.ro,0,0,1,1,0.0,0.0
Marius Craina,pressone.ro,0,0,1,1,0.0,0.0
Mircea Cinteză,pressone.ro,0,0,1,1,0.0,0.0
Monica Cîrstoiu,pressone.ro,0,0,1,1,0.0,0.0
Moși Crăciun,pressone.ro,0,0,1,1,0.0,0.0
Nelu Tătaru,pressone.ro,0,0,2,2,0.0,0.0
Octav Ganea Cătălin Cîrstoiu,pressone.ro,0,0,1,1,0.0,0.0
Piedone,pressone.ro,0,4,0,4,-1.0,1.0
Raed Arafat,pressone.ro,0,1,2,3,-0.3333333333333333,0.3333333333333333
Rafila,pressone.ro,0,2,0,2,-1.0,1.0
Sorin Oprescu,pressone.ro,0,0,1,1,0.0,0.0
Sorina Pintea,pressone.ro,0,1,0,1,-1.0,1.0
Victor Ciutacu,pressone.ro,0,0,1,1,0.0,0.0
Victor Costache,pressone.ro,0,0,1,1,0.0,0.0
Violeta Boerescu,pressone.ro,0,0,1,1,0.0,0.0
Voichița Lăzureanu,pressone.ro,0,0,1,1,0.0,0.0
fin,pressone.ro,0,3,3,6,-0.5,0.5
gay,pressone.ro,0,2,0,2,-1.0,1.0
Adrian Wiener,pressone.ro,0,0,1,1,0.0,0.0
microbiolog,pressone.ro,0,0,1,1,0.0,0.0
Nicolăescu,pressone.ro,0,1,0,1,-1.0,1.0
rurg,pressone.ro,0,0,1,1,0.0,0.0
subsecretar de stat,pressone.ro,0,0,1,1,0.0,0.0
supraviețuitor,pressone.ro,0,3,1,4,-0.75,0.75
Firea,www.luju.ro,0,1,0,1,-1.0,1.0
Gabriela Firea,www.luju.ro,0,2,0,2,-1.0,1.0
senatoare,www.luju.ro,0,2,1,3,-0.6666666666666666,0.6666666666666666
Claudiu Pândaru,www.digi24.ro,0,0,3,3,0.0,0.0
Dîncu,www.digi24.ro,0,1,0,1,-1.0,1.0
Vasile Dâncu,www.digi24.ro,0,0,1,1,0.0,0.0
prieten,www.digi24.ro,2,1,1,4,0.25,0.25
inițiator,www.antena3.ro,0,1,1,2,-0.5,0.5
Băluță,observatornews.ro,0,1,0,1,-1.0,1.0
Cătălin Cîrstoiu,observatornews.ro,0,0,4,4,0.0,0.0
Daniel Băluță,observatornews.ro,0,1,1,2,-0.5,0.5
Gabriela Firea,observatornews.ro,1,2,14,17,-0.058823529411764705,0.058823529411764705
Sebastian Burduja,observatornews.ro,0,1,4,5,-0.2,0.2
manager,observatornews.ro,0,3,3,6,-0.5,0.5
Cîrstoiu,observatornews.ro,0,3,1,4,-0.75,0.75
pacient,observatornews.ro,0,1,0,1,-1.0,1.0
Buzău,www.digi24.ro,0,1,1,2,-0.5,0.5
legiuitor,www.digi24.ro,0,1,0,1,-1.0,1.0
Doina Pană,adevarul.ro,0,0,1,1,0.0,0.0
Pană,adevarul.ro,0,1,0,1,-1.0,1.0
Adrian Severin,recorder.ro,0,1,0,1,-1.0,1.0
Alba,recorder.ro,0,1,2,3,-0.3333333333333333,0.3333333333333333
Avocat al Poporului,recorder.ro,0,1,0,1,-1.0,1.0
BEA,recorder.ro,0,1,0,1,-1.0,1.0
Ciorbea,recorder.ro,0,1,0,1,-1.0,1.0
Ciorbești,recorder.ro,0,0,1,1,0.0,0.0
Coposu,recorder.ro,1,0,0,1,1.0,1.0
Corneliu Coposu,recorder.ro,0,1,1,2,-0.5,0.5
Europa,recorder.ro,0,0,1,1,0.0,0.0
Emil Constantinescu,recorder.ro,0,0,3,3,0.0,0.0
Eugenia,recorder.ro,0,0,1,1,0.0,0.0
gazetar,recorder.ro,0,0,1,1,0.0,0.0
Ilie Năstase,recorder.ro,0,0,1,1,0.0,0.0
Ion Cristoiu,recorder.ro,1,1,0,2,0.0,0.0
Ion Diaconescu,recorder.ro,0,1,0,1,-1.0,1.0
Victor Ciorbea,recorder.ro,0,1,1,2,-0.5,0.5
MI,recorder.ro,0,0,1,1,0.0,0.0
Miron Mitrea,recorder.ro,0,0,1,1,0.0,0.0
Mitrea,recorder.ro,0,0,1,1,0.0,0.0
Nicolae Văcăroiu,recorder.ro,0,0,1,1,0.0,0.0
Ponor,recorder.ro,0,1,0,1,-1.0,1.0
Radu Vasile,recorder.ro,0,0,1,1,0.0,0.0
Robespierre,recorder.ro,0,1,0,1,-1.0,1.0
Roman,recorder.ro,0,2,1,3,-0.6666666666666666,0.6666666666666666
senior,recorder.ro,2,0,0,2,1.0,1.0
Ulm Spineanu,recorder.ro,0,0,1,1,0.0,0.0
Vasile Ciorbea,recorder.ro,0,0,1,1,0.0,0.0
Victor,recorder.ro,0,1,0,1,-1.0,1.0
Victoraș,recorder.ro,0,1,0,1,-1.0,1.0
ZORULUI,recorder.ro,0,0,1,1,0.0,0.0
fecior,recorder.ro,0,0,1,1,0.0,0.0
geamăn,recorder.ro,0,0,1,1,0.0,0.0
niște,recorder.ro,0,1,0,1,-1.0,1.0
sindicalist,recorder.ro,0,3,3,6,-0.5,0.5
taică,recorder.ro,0,1,0,1,-1.0,1.0
traseiștilor,recorder.ro,0,1,0,1,-1.0,1.0
țărăniște,recorder.ro,0,2,0,2,-1.0,1.0
Adrian Nast,a1.ro,0,1,0,1,-1.0,1.0
Anenii Noi,www.g4media.ro,0,0,1,1,0.0,0.0
Floreni,www.g4media.ro,0,0,1,1,0.0,0.0
Iacob Ciprian,www.g4media.ro,0,0,1,1,0.0,0.0
Igor,www.g4media.ro,0,1,0,1,-1.0,1.0
Munteanu,www.g4media.ro,0,0,1,1,0.0,0.0
Ruslan,www.g4media.ro,0,1,0,1,-1.0,1.0
Valeriu Munteanu,www.g4media.ro,0,1,0,1,-1.0,1.0
Mara Nicolescu,www.g4media.ro,0,0,1,1,0.0,0.0
ambii,www.g4media.ro,0,1,0,1,-1.0,1.0
asistent,www.g4media.ro,0,0,2,2,0.0,0.0
președinte interimar,www.g4media.ro,0,0,1,1,0.0,0.0
comandant,www.g4media.ro,0,0,1,1,0.0,0.0
Macel Ciolacu,www.comisarul.ro,0,1,0,1,-1.0,1.0
Toni Greblă,www.comisarul.ro,0,2,0,2,-1.0,1.0
Constantin Nicolescu,www.mediafax.ro,0,0,2,2,0.0,0.0
Nicolae Bănicioiu,www.mediafax.ro,0,0,1,1,0.0,0.0
Nicolae Văcăroiu,www.mediafax.ro,0,0,1,1,0.0,0.0
Nicolescu,www.mediafax.ro,0,0,1,1,0.0,0.0
Gabriel Liiceanu,www.digi24.ro,0,0,2,2,0.0,0.0
George Barbăroșie,www.digi24.ro,0,0,1,1,0.0,0.0
Mihai Tudorică,www.digi24.ro,0,0,1,1,0.0,0.0
Monica Macovei,www.digi24.ro,0,0,4,4,0.0,0.0
filosof,www.digi24.ro,0,0,2,2,0.0,0.0
protestatar,www.digi24.ro,0,1,2,3,-0.3333333333333333,0.3333333333333333
tehnocrat,www.digi24.ro,0,1,0,1,-1.0,1.0
Ștefureac,adevarul.ro,0,0,1,1,0.0,0.0
om politic,a1.ro,0,1,1,2,-0.5,0.5
Vadim Tudor,a1.ro,1,0,2,3,0.3333333333333333,0.3333333333333333
Varujan Vosganian,a1.ro,0,1,0,1,-1.0,1.0
elector,a1.ro,0,1,1,2,-0.5,0.5
Eduard Hellvig,www.mediafax.ro,0,0,1,1,0.0,0.0
Ilie Bolojan,www.mediafax.ro,1,0,7,8,0.125,0.125
participant,www.realitatea.net,0,0,1,1,0.0,0.0
altul,www.luju.ro,0,1,0,1,-1.0,1.0
Dvs,www.luju.ro,0,0,1,1,0.0,0.0
populație,agerpres.ro,0,1,5,6,-0.16666666666666666,0.16666666666666666
Belgrad,www.b1tv.ro,0,6,4,10,-0.6,0.6
Ponta,www.b1tv.ro,0,14,2,16,-0.875,0.875
Răzvan Nicolescu,www.b1tv.ro,0,1,0,1,-1.0,1.0
CTP,adevarul.ro,0,3,3,6,-0.5,0.5
Gazeta,adevarul.ro,0,1,0,1,-1.0,1.0
ăștia,adevarul.ro,0,1,0,1,-1.0,1.0
Corina Crețu,www.digi24.ro,0,0,5,5,0.0,0.0
Gabriela Crețu,www.digi24.ro,0,0,1,1,0.0,0.0
Gunther Oettinger,www.digi24.ro,0,0,1,1,0.0,0.0
Vazil Hudak,www.digi24.ro,0,0,1,1,0.0,0.0
Adina Vălean,www.euronews.ro,0,0,2,2,0.0,0.0
Angela Merkel,www.euronews.ro,0,0,1,1,0.0,0.0
Băsescu,www.euronews.ro,0,1,1,2,-0.5,0.5
Corneliu Coposu,www.euronews.ro,0,0,1,1,0.0,0.0
Doina Cornea,www.euronews.ro,0,0,1,1,0.0,0.0
Eduard Hellvig,www.euronews.ro,0,1,1,2,-0.5,0.5
Liviu Dragnea,www.euronews.ro,0,0,3,3,0.0,0.0
Mihai Răzvan Ungureanu,www.euronews.ro,0,1,0,1,-1.0,1.0
Neagu Djuvara,www.euronews.ro,0,0,1,1,0.0,0.0
artizan,www.euronews.ro,0,0,1,1,0.0,0.0
cancelar,www.euronews.ro,0,4,3,7,-0.5714285714285714,0.5714285714285714
comisar,www.euronews.ro,0,3,1,4,-0.75,0.75
Lucian Boia,www.euronews.ro,0,0,1,1,0.0,0.0
medic,www.euronews.ro,0,3,4,7,-0.42857142857142855,0.42857142857142855
muzeograf,www.euronews.ro,0,0,1,1,0.0,0.0
soră,www.euronews.ro,0,0,1,1,0.0,0.0
Anamaria Constantin,agerpres.ro,0,0,1,1,0.0,0.0
Brașov,agerpres.ro,0,0,1,1,0.0,0.0
Cei,www.cotidianul.ro,0,0,1,1,0.0,0.0
Dan Motreanu,www.cotidianul.ro,0,0,2,2,0.0,0.0
Gabriela Firea,www.cotidianul.ro,0,0,2,2,0.0,0.0
Lucian Bode,www.cotidianul.ro,0,0,3,3,0.0,0.0
Marian Neacșu,www.cotidianul.ro,0,0,2,2,0.0,0.0
Mihai Tudose,www.cotidianul.ro,0,0,1,1,0.0,0.0
Rareș Bogdan,www.cotidianul.ro,0,1,1,2,-0.5,0.5
candidați,www.cotidianul.ro,1,2,5,8,-0.125,0.125
comandant,agerpres.ro,0,0,1,1,0.0,0.0
Egipt,www.gandul.ro,0,0,1,1,0.0,0.0
Iran,www.gandul.ro,0,4,0,4,-1.0,1.0
beneficiar,www.gandul.ro,0,0,1,1,0.0,0.0
refugiat,www.gandul.ro,0,1,0,1,-1.0,1.0
Afganistan,adevarul.ro,0,0,2,2,0.0,0.0
Cîțu,adevarul.ro,0,1,2,3,-0.3333333333333333,0.3333333333333333
Dolj,adevarul.ro,0,1,6,7,-0.14285714285714285,0.14285714285714285
general,adevarul.ro,1,7,7,15,-0.4,0.4
Ion,adevarul.ro,0,0,2,2,0.0,0.0
Irak,adevarul.ro,0,1,3,4,-0.25,0.25
Nasiria,adevarul.ro,0,1,0,1,-1.0,1.0
Nassiriya,adevarul.ro,0,1,1,2,-0.5,0.5
Plenița,adevarul.ro,0,0,1,1,0.0,0.0
comandant,adevarul.ro,0,0,2,2,0.0,0.0
Florin Cîțu,adevarul.ro,0,3,2,5,-0.6,0.6
Liviu Pleșoianu,adevarul.ro,0,0,1,1,0.0,0.0
altor,adevarul.ro,0,0,1,1,0.0,0.0
Domni,recorder.ro,0,1,0,1,-1.0,1.0
Dominique Pelicot,recorder.ro,0,1,0,1,-1.0,1.0
Gisèle,recorder.ro,0,1,0,1,-1.0,1.0
Gisèle Pelicot,recorder.ro,1,0,0,1,1.0,1.0
Viktor Orbán,recorder.ro,0,3,2,5,-0.6,0.6
adolescent,recorder.ro,1,2,2,5,-0.2,0.2
reclamant,recorder.ro,0,1,0,1,-1.0,1.0
Caracal,pressone.ro,0,1,1,2,-0.5,0.5
Daenerys Targaryen,pressone.ro,0,0,1,1,0.0,0.0
Dragoș Tudorache,pressone.ro,0,1,0,1,-1.0,1.0
Regina Dragon,pressone.ro,0,0,1,1,0.0,0.0
Târgu Jiu,pressone.ro,0,0,1,1,0.0,0.0
Vasile Blaga,pressone.ro,0,3,4,7,-0.42857142857142855,0.42857142857142855
Alexandra Măceșanu,pressone.ro,0,1,1,2,-0.5,0.5
Israel,pressone.ro,0,2,3,5,-0.4,0.4
Președintele,pressone.ro,0,0,2,2,0.0,0.0
regele,pressone.ro,0,2,0,2,-1.0,1.0
Vlad Adamescu Răzvan Petri,pressone.ro,0,0,2,2,0.0,0.0
demisionar,pressone.ro,0,1,0,1,-1.0,1.0
guvernator,pressone.ro,0,2,2,4,-0.5,0.5
trădător,pressone.ro,0,4,0,4,-1.0,1.0
Anca Spiridon,pressone.ro,0,1,1,2,-0.5,0.5
Spiridon Ancăi,pressone.ro,0,1,0,1,-1.0,1.0
Ancăi Spiridon,pressone.ro,0,0,1,1,0.0,0.0
Bacău,pressone.ro,0,1,6,7,-0.14285714285714285,0.14285714285714285
Constantin Spiridon,pressone.ro,0,1,0,1,-1.0,1.0
directoare,pressone.ro,0,1,1,2,-0.5,0.5
Dărmănești,pressone.ro,0,0,2,2,0.0,0.0
Spiridon,pressone.ro,0,3,0,3,-1.0,1.0
campion,pressone.ro,0,0,2,2,0.0,0.0
Andrew Tate,www.activenews.ro,0,1,0,1,-1.0,1.0
miliardar,www.activenews.ro,0,0,1,1,0.0,0.0
Tristan Tate,www.activenews.ro,1,0,1,2,0.5,0.5
Abu Dhabi,agerpres.ro,0,0,1,1,0.0,0.0
Bahrain,agerpres.ro,0,0,1,1,0.0,0.0
Donald Trump,agerpres.ro,0,3,3,6,-0.5,0.5
Emiratele Arabe Unite,agerpres.ro,0,0,1,1,0.0,0.0
Irina Cristea,agerpres.ro,0,0,1,1,0.0,0.0
Israel,agerpres.ro,0,0,4,4,0.0,0.0
Riad,agerpres.ro,0,0,1,1,0.0,0.0
SUA,agerpres.ro,0,2,5,7,-0.2857142857142857,0.2857142857142857
Sirie,agerpres.ro,0,1,0,1,-1.0,1.0
Tudor Martalogu,agerpres.ro,0,0,2,2,0.0,0.0
omolog,agerpres.ro,0,1,0,1,-1.0,1.0
Angel Tîlvăr,www.euronews.ro,0,0,3,3,0.0,0.0
Beirut,www.euronews.ro,0,0,1,1,0.0,0.0
Grecia,www.euronews.ro,0,0,2,2,0.0,0.0
Hakov,www.euronews.ro,0,1,0,1,-1.0,1.0
Harkov,www.euronews.ro,0,1,0,1,-1.0,1.0
Spectator,www.euronews.ro,0,0,1,1,0.0,0.0
aliat,www.euronews.ro,0,4,1,5,-0.8,0.8
civil,www.euronews.ro,0,1,1,2,-0.5,0.5
responsabil,www.euronews.ro,0,1,0,1,-1.0,1.0
Clotilde Armand,www.euronews.ro,0,1,1,2,-0.5,0.5
Siria,www.euronews.ro,0,0,1,1,0.0,0.0
manager,www.euronews.ro,0,1,2,3,-0.3333333333333333,0.3333333333333333
Aureliu Decebal Dumitrașcu,www.comisarul.ro,0,1,0,1,-1.0,1.0
Irina Elena Costencu,www.comisarul.ro,0,1,0,1,-1.0,1.0
Luciana Spineanu,www.comisarul.ro,0,1,0,1,-1.0,1.0
Mirela Matichescu,www.comisarul.ro,0,1,0,1,-1.0,1.0
Mirelei Matichescu,www.comisarul.ro,0,1,0,1,-1.0,1.0
Paul Chisnoiu,www.comisarul.ro,0,1,0,1,-1.0,1.0
Vadim Corneliu Ruse,www.comisarul.ro,0,1,0,1,-1.0,1.0
funcționar public,www.comisarul.ro,0,2,0,2,-1.0,1.0
Doina Pană,www.b1tv.ro,0,0,1,1,0.0,0.0
Serbia,www.b1tv.ro,0,1,1,2,-0.5,0.5
Ungaria,www.b1tv.ro,0,0,2,2,0.0,0.0
Andrei Roman,pressone.ro,0,0,1,1,0.0,0.0
Madrid,pressone.ro,0,0,4,4,0.0,0.0
Micutzu,pressone.ro,0,1,0,1,-1.0,1.0
Mircea Geoană,pressone.ro,0,4,10,14,-0.2857142857142857,0.2857142857142857
Nisa,pressone.ro,0,1,0,1,-1.0,1.0
Nordis,pressone.ro,0,1,0,1,-1.0,1.0
ales,pressone.ro,0,6,1,7,-0.8571428571428571,0.8571428571428571
Angel Tîlvăr,www.gandul.ro,0,0,5,5,0.0,0.0
Florin Cîțu,www.gandul.ro,0,1,2,3,-0.3333333333333333,0.3333333333333333
Cristian Bușoi,www.gandul.ro,0,0,1,1,0.0,0.0
Guvernul Ciucă,www.gandul.ro,0,0,1,1,0.0,0.0
Ionuț Stroe,www.gandul.ro,0,0,5,5,0.0,0.0
Ligia Deca,www.gandul.ro,0,0,1,1,0.0,0.0
Mihai Cîmpeanu,www.gandul.ro,0,0,1,1,0.0,0.0
Vicepreședintele,www.gandul.ro,0,1,2,3,-0.3333333333333333,0.3333333333333333
partener,www.gandul.ro,4,2,7,13,0.15384615384615385,0.15384615384615385
înlocuitor,www.gandul.ro,0,1,0,1,-1.0,1.0
Grindeanu,www.digi24.ro,0,1,1,2,-0.5,0.5
Mihai Tudose,www.digi24.ro,0,1,2,3,-0.3333333333333333,0.3333333333333333
Nicole Ciucă,www.digi24.ro,0,1,0,1,-1.0,1.0
Tudose,www.digi24.ro,0,1,1,2,-0.5,0.5
colegiu,www.digi24.ro,0,1,0,1,-1.0,1.0
Mircea Badea,www.antena3.ro,0,0,5,5,0.0,0.0
Sevil Shhaideh,www.antena3.ro,0,0,2,2,0.0,0.0
Baabda,www.gandul.ro,0,0,1,1,0.0,0.0
Beirut,www.gandul.ro,0,0,1,1,0.0,0.0
Liban,www.gandul.ro,0,1,2,3,-0.3333333333333333,0.3333333333333333
Republica Libaneză,www.gandul.ro,0,0,2,2,0.0,0.0
angajat,primanews.ro,1,2,3,6,-0.16666666666666666,0.16666666666666666
contribuabil,primanews.ro,0,1,0,1,-1.0,1.0
Cosmin Popa,www.b1tv.ro,0,0,2,2,0.0,0.0
URSS,www.b1tv.ro,0,0,1,1,0.0,0.0
istoric,www.b1tv.ro,0,0,1,1,0.0,0.0
specialist,www.b1tv.ro,1,0,1,2,0.5,0.5
suveranist,www.b1tv.ro,0,1,1,2,-0.5,0.5
Alin Tișe,www.antena3.ro,1,0,0,1,1.0,1.0
Brașov,www.antena3.ro,0,0,5,5,0.0,0.0
Cluj,www.antena3.ro,3,0,0,3,1.0,1.0
Câmpia Turzii,www.antena3.ro,0,0,1,1,0.0,0.0
Daniel Buda,www.antena3.ro,3,0,1,4,0.75,0.75
Drăgan,www.antena3.ro,0,0,1,1,0.0,0.0
Emil Boc,www.antena3.ro,0,0,1,1,0.0,0.0
Gherla,www.antena3.ro,0,0,1,1,0.0,0.0
Matei,www.antena3.ro,1,0,0,1,1.0,1.0
Moroșan,www.antena3.ro,1,0,0,1,1.0,1.0
Roșigan,www.antena3.ro,0,0,1,1,0.0,0.0
Timiș,www.antena3.ro,0,0,3,3,0.0,0.0
Turda,www.antena3.ro,0,0,1,1,0.0,0.0
clujean,www.antena3.ro,1,0,0,1,1.0,1.0
tineret,www.antena3.ro,1,0,0,1,1.0,1.0
Albin Kurti,adevarul.ro,0,0,1,1,0.0,0.0
Bajram Shala,adevarul.ro,0,1,0,1,-1.0,1.0
Kosovo,adevarul.ro,0,0,2,2,0.0,0.0
arbitru,adevarul.ro,0,1,0,1,-1.0,1.0
jucător,adevarul.ro,0,0,1,1,0.0,0.0
Karol Nawrocki,www.romaniatv.net,0,0,3,3,0.0,0.0
Peiu,www.romaniatv.net,0,0,1,1,0.0,0.0
Satu Mare,www.romaniatv.net,0,0,2,2,0.0,0.0
Varșovia,www.romaniatv.net,0,0,3,3,0.0,0.0
Vasile Pușcaș,www.romaniatv.net,0,0,1,1,0.0,0.0
Ana Maria Pătru,www.digi24.ro,0,0,1,1,0.0,0.0
Raluca Turcan,primanews.ro,0,0,3,3,0.0,0.0
Bogdan Ivan,observatornews.ro,0,0,4,4,0.0,0.0
Bruxelles,observatornews.ro,1,0,7,8,0.125,0.125
Cristi Barbu,observatornews.ro,0,0,1,1,0.0,0.0
Ploiești,observatornews.ro,0,0,1,1,0.0,0.0
Cristian Tudor Popescu,snoop.ro,0,1,1,2,-0.5,0.5
Giurgiu,snoop.ro,0,0,7,7,0.0,0.0
Mihai Tudose,snoop.ro,0,0,6,6,0.0,0.0
Robert Sighiartău,snoop.ro,0,1,0,1,-1.0,1.0
Sighiartău,snoop.ro,0,1,0,1,-1.0,1.0
Sălaj,snoop.ro,0,0,7,7,0.0,0.0
Timiș,snoop.ro,0,1,3,4,-0.25,0.25
autor,snoop.ro,0,3,4,7,-0.42857142857142855,0.42857142857142855
simpatizant,snoop.ro,0,2,0,2,-1.0,1.0
Adrian Mocanu,www.digi24.ro,0,0,2,2,0.0,0.0
Cornel Resmeriță,www.digi24.ro,0,1,0,1,-1.0,1.0
Cristian Resmeriță,www.digi24.ro,0,0,1,1,0.0,0.0
Daciana Sârbu,www.digi24.ro,0,0,1,1,0.0,0.0
Elena,www.digi24.ro,0,0,2,2,0.0,0.0
Florentin Pandele,www.digi24.ro,0,0,1,1,0.0,0.0
Florin Țurcanu,www.digi24.ro,0,0,1,1,0.0,0.0
Gabriela Firea,www.digi24.ro,0,2,4,6,-0.3333333333333333,0.3333333333333333
Horea Uioreanu,www.digi24.ro,0,0,1,1,0.0,0.0
Ilie Sârbu,www.digi24.ro,0,0,1,1,0.0,0.0
Lupeni,www.digi24.ro,0,1,0,1,-1.0,1.0
Manuela,www.digi24.ro,0,0,1,1,0.0,0.0
Manuela Mitrea,www.digi24.ro,0,0,1,1,0.0,0.0
Mircea Cosma,www.digi24.ro,1,0,0,1,1.0,1.0
Miron Mitrea,www.digi24.ro,0,0,3,3,0.0,0.0
Raluca,www.digi24.ro,0,0,1,1,0.0,0.0
Ramona Mănescu,www.digi24.ro,0,0,1,1,0.0,0.0
Rareș Mănescu,www.digi24.ro,1,0,0,1,1.0,1.0
Roxana Anușca,www.digi24.ro,0,0,1,1,0.0,0.0
Victor Mocanu,www.digi24.ro,0,0,1,1,0.0,0.0
voluntar,www.digi24.ro,0,0,1,1,0.0,0.0
familia Mănescu,www.digi24.ro,0,1,0,1,-1.0,1.0
jumătate,www.digi24.ro,0,0,1,1,0.0,0.0
Bogdan Peschir,adevarul.ro,0,1,0,1,-1.0,1.0
Adrian Chesnoiu,observatornews.ro,0,1,0,1,-1.0,1.0
Adrian Năstase,observatornews.ro,0,1,1,2,-0.5,0.5
Daniel Botănoiu,observatornews.ro,0,0,1,1,0.0,0.0
inginer agronom,observatornews.ro,0,0,1,1,0.0,0.0
Petre Daea,observatornews.ro,0,0,1,1,0.0,0.0
apropiat,observatornews.ro,0,1,3,4,-0.25,0.25
director,observatornews.ro,0,4,5,9,-0.4444444444444444,0.4444444444444444
inginer,observatornews.ro,1,0,2,3,0.3333333333333333,0.3333333333333333
ul,observatornews.ro,0,0,1,1,0.0,0.0
șef adjunct,observatornews.ro,0,0,1,1,0.0,0.0
Andra Costache,www.digi24.ro,0,0,2,2,0.0,0.0
Ionuț Stroe,www.digi24.ro,0,1,5,6,-0.16666666666666666,0.16666666666666666
Stroe,www.digi24.ro,0,2,1,3,-0.6666666666666666,0.6666666666666666
Lișcu,www.digi24.ro,0,0,1,1,0.0,0.0
Minuna Palaș,www.digi24.ro,0,0,1,1,0.0,0.0
Miruna Lișcu,www.digi24.ro,0,1,3,4,-0.25,0.25
Miruna Palaș,www.digi24.ro,0,0,1,1,0.0,0.0
Miruna Palș,www.digi24.ro,0,0,1,1,0.0,0.0
Mirunei Lișcu,www.digi24.ro,0,0,1,1,0.0,0.0
Mirunei Lișcu Toma Petcu,www.digi24.ro,0,0,1,1,0.0,0.0
Palaș,www.digi24.ro,0,0,1,1,0.0,0.0
Sebastian Burduja,www.digi24.ro,0,0,6,6,0.0,0.0
Toma Petcu,www.digi24.ro,0,0,1,1,0.0,0.0
Tânăra,www.digi24.ro,0,0,1,1,0.0,0.0
absolvent,www.digi24.ro,0,1,4,5,-0.2,0.2
client,www.digi24.ro,1,1,0,2,0.0,0.0
consilieră,www.digi24.ro,0,1,0,1,-1.0,1.0
cumnat,www.digi24.ro,0,1,0,1,-1.0,1.0
doamnă,www.digi24.ro,2,1,5,8,0.125,0.125
domnișoară,www.digi24.ro,1,1,0,2,0.0,0.0
dansă,www.digi24.ro,0,0,1,1,0.0,0.0
edeni,www.digi24.ro,0,1,0,1,-1.0,1.0
ființă,www.digi24.ro,0,1,0,1,-1.0,1.0
fin,www.digi24.ro,0,1,0,1,-1.0,1.0
naș,www.digi24.ro,0,4,0,4,-1.0,1.0
veri,www.digi24.ro,0,1,0,1,-1.0,1.0
viceprimar,www.digi24.ro,0,1,0,1,-1.0,1.0
Cătălin Cârstoiu,www.gandul.ro,1,0,1,2,0.5,0.5
Claudiu Șerban,adevarul.ro,0,0,1,1,0.0,0.0
cadru,adevarul.ro,0,0,3,3,0.0,0.0
făptuitor,adevarul.ro,0,1,0,1,-1.0,1.0
locțiitor,adevarul.ro,0,1,0,1,-1.0,1.0
operator,adevarul.ro,0,0,2,2,0.0,0.0
pompier,adevarul.ro,1,0,2,3,0.3333333333333333,0.3333333333333333
Mihai Ghigiu,agerpres.ro,0,0,2,2,0.0,0.0
Radu Oprea,agerpres.ro,0,0,5,5,0.0,0.0
Ciprian Ciucu,www.news.ro,1,0,1,2,0.5,0.5
Ciucu,www.news.ro,0,0,3,3,0.0,0.0
candidați,www.news.ro,0,5,5,10,-0.5,0.5
Kiev,observatornews.ro,1,0,2,3,0.3333333333333333,0.3333333333333333
Washington,observatornews.ro,0,2,1,3,-0.6666666666666666,0.6666666666666666
liberal,primanews.ro,1,2,1,4,-0.25,0.25
Baia Mare,pressone.ro,0,1,3,4,-0.25,0.25
Ciorani,pressone.ro,0,1,0,1,-1.0,1.0
Dobrești,pressone.ro,0,0,1,1,0.0,0.0
Făgăraș,pressone.ro,0,0,4,4,0.0,0.0
Gogoșu,pressone.ro,0,1,1,2,-0.5,0.5
Hamburg,pressone.ro,0,0,1,1,0.0,0.0
Jean Rogoveanu,pressone.ro,0,0,1,1,0.0,0.0
mamă,pressone.ro,5,2,11,18,0.16666666666666666,0.16666666666666666
Marin Voicu,pressone.ro,0,1,0,1,-1.0,1.0
Rojiște,pressone.ro,0,0,1,1,0.0,0.0
Sena,pressone.ro,1,0,0,1,1.0,1.0
Vasile Vlașin,pressone.ro,0,0,1,1,0.0,0.0
Victoria,pressone.ro,0,1,0,1,-1.0,1.0
contracan,pressone.ro,0,1,0,1,-1.0,1.0
Lăzăroiu,www.romaniatv.net,0,0,1,1,0.0,0.0
Petre Lăzăroiu,www.romaniatv.net,0,0,1,1,0.0,0.0
Președintele,www.romaniatv.net,0,0,2,2,0.0,0.0
Toader,www.romaniatv.net,0,1,0,1,-1.0,1.0
Tudorel Toader,www.romaniatv.net,0,0,2,2,0.0,0.0
Viorica Dăncilă,www.realitatea.net,0,0,1,1,0.0,0.0
consultant,www.realitatea.net,0,0,1,1,0.0,0.0
Bogdan Ioncu,adevarul.ro,0,0,1,1,0.0,0.0
Petre Lăzăroiu,adevarul.ro,0,0,1,1,0.0,0.0
procuror,adevarul.ro,0,10,4,14,-0.7142857142857143,0.7142857142857143
Adrian Năstase,www.gandul.ro,0,1,2,3,-0.3333333333333333,0.3333333333333333
Bill Clinton,www.gandul.ro,0,0,2,2,0.0,0.0
Geoană,www.gandul.ro,0,1,3,4,-0.25,0.25
George W. Bush,www.gandul.ro,0,1,1,2,-0.5,0.5
Mircea Geană,www.gandul.ro,0,0,1,1,0.0,0.0
secretar general adjunct,www.gandul.ro,0,0,1,1,0.0,0.0
doctor,www.gandul.ro,0,0,4,4,0.0,0.0
Cugir,recorder.ro,0,0,2,2,0.0,0.0
Dacian Ciodaru,recorder.ro,0,0,1,1,0.0,0.0
Elveția,recorder.ro,1,0,3,4,0.25,0.25
Făt Frumos,recorder.ro,1,0,0,1,1.0,1.0
Harari,recorder.ro,0,0,1,1,0.0,0.0
Hunedoara,recorder.ro,0,0,4,4,0.0,0.0
Ilie Toma,recorder.ro,0,0,1,1,0.0,0.0
Jiu,recorder.ro,0,0,1,1,0.0,0.0
Lucian Heiuș,recorder.ro,0,0,1,1,0.0,0.0
Natalia Intotero,recorder.ro,0,0,2,2,0.0,0.0
Petru Sorin Marica,recorder.ro,0,0,1,1,0.0,0.0
Robert D. Kaplan,recorder.ro,0,0,1,1,0.0,0.0
Schopenhauer,recorder.ro,1,0,0,1,1.0,1.0
Slavici,recorder.ro,0,1,0,1,-1.0,1.0
Timotei Ursu,recorder.ro,0,0,1,1,0.0,0.0
Valea Jiului,recorder.ro,0,0,2,2,0.0,0.0
Vasilică Potecă,recorder.ro,0,0,1,1,0.0,0.0
Vetuța Stănescu,recorder.ro,0,0,1,1,0.0,0.0
Viorel Salan,recorder.ro,0,0,1,1,0.0,0.0
adept,recorder.ro,1,0,0,1,1.0,1.0
domn,recorder.ro,0,3,1,4,-0.75,0.75
hunedorean,recorder.ro,1,0,0,1,1.0,1.0
hunedoare,recorder.ro,1,0,0,1,1.0,1.0
hunedoreni,recorder.ro,1,0,0,1,1.0,1.0
nt,recorder.ro,0,0,1,1,0.0,0.0
patriarh,recorder.ro,0,1,0,1,-1.0,1.0
ren,recorder.ro,0,0,1,1,0.0,0.0
scriitor,recorder.ro,1,0,8,9,0.1111111111111111,0.1111111111111111
vârstnic,recorder.ro,0,1,2,3,-0.3333333333333333,0.3333333333333333
învățător,recorder.ro,0,0,5,5,0.0,0.0
pălărie,www.realitatea.net,0,0,1,1,0.0,0.0
Ștefan Pălărie,www.realitatea.net,0,0,1,1,0.0,0.0
Bogdan Aurescu,adevarul.ro,0,1,5,6,-0.16666666666666666,0.16666666666666666
Dmytro Kuleba,adevarul.ro,0,0,1,1,0.0,0.0
Kuleba,adevarul.ro,0,0,1,1,0.0,0.0
competitor,www.antena3.ro,0,1,1,2,-0.5,0.5
câștigător,www.antena3.ro,0,0,1,1,0.0,0.0
nehotărât,www.antena3.ro,0,1,0,1,-1.0,1.0
participant,www.antena3.ro,0,0,2,2,0.0,0.0
protestatar,www.antena3.ro,1,4,0,5,-0.6,0.6
funcționar,www.antena3.ro,0,1,1,2,-0.5,0.5
guvernant,www.antena3.ro,0,1,0,1,-1.0,1.0
profesor,www.antena3.ro,2,1,7,10,0.1,0.1
Andrei Baciu,primanews.ro,0,1,1,2,-0.5,0.5
Mihai Voicu,primanews.ro,0,0,1,1,0.0,0.0
Monica Anisie,primanews.ro,0,0,1,1,0.0,0.0
Octavian Oprea,primanews.ro,0,1,0,1,-1.0,1.0
Orban,primanews.ro,0,0,1,1,0.0,0.0
Răzvan Prișcă,primanews.ro,0,0,1,1,0.0,0.0
Sorin Cîmpeanu,primanews.ro,0,0,1,1,0.0,0.0
Vlad Nistor,primanews.ro,0,0,1,1,0.0,0.0
George Scarlat,primanews.ro,0,0,1,1,0.0,0.0
Dan Șucu,www.g4media.ro,0,0,1,1,0.0,0.0
actor,www.g4media.ro,0,2,1,3,-0.6666666666666666,0.6666666666666666
Ariadna Cârligeanu,pressone.ro,0,0,1,1,0.0,0.0
Augustin Hagiu,pressone.ro,0,0,3,3,0.0,0.0
Ciprian Ignătescu,pressone.ro,0,0,1,1,0.0,0.0
creator,pressone.ro,1,1,2,4,0.0,0.0
Cristian Săvescu,pressone.ro,0,0,1,1,0.0,0.0
Hagiu,pressone.ro,0,1,1,2,-0.5,0.5
Dănuț,pressone.ro,0,0,1,1,0.0,0.0
Flavius Burcă,pressone.ro,0,0,1,1,0.0,0.0
Focșani,pressone.ro,0,0,2,2,0.0,0.0
domnul,pressone.ro,0,2,0,2,-1.0,1.0
fermier,pressone.ro,0,2,1,3,-0.6666666666666666,0.6666666666666666
fondator,pressone.ro,1,6,15,22,-0.22727272727272727,0.22727272727272727
transportator,pressone.ro,0,1,1,2,-0.5,0.5
Procuror Florența,www.activenews.ro,0,0,1,1,0.0,0.0
TikTok,www.activenews.ro,0,1,0,1,-1.0,1.0
Regatul Unit,www.activenews.ro,0,1,0,1,-1.0,1.0
Mihai Eminescu,observatornews.ro,1,0,0,1,1.0,1.0
Burduja,adevarul.ro,0,2,0,2,-1.0,1.0
Modrogan,adevarul.ro,0,0,1,1,0.0,0.0
Rareș,adevarul.ro,0,0,1,1,0.0,0.0
Teodor Stolojan,adevarul.ro,0,0,1,1,0.0,0.0
Viorel Cataramă,adevarul.ro,0,0,1,1,0.0,0.0
câțivă,adevarul.ro,0,0,1,1,0.0,0.0
generalul Ciucă,adevarul.ro,0,1,0,1,-1.0,1.0
Marian Ceaușescu,adevarul.ro,0,1,1,2,-0.5,0.5
tuturor,adevarul.ro,0,0,3,3,0.0,0.0
Iași,www.news.ro,1,1,8,10,0.0,0.0
Marius Dangă,www.news.ro,0,1,0,1,-1.0,1.0
Mihai Chirica,www.news.ro,0,2,0,2,-1.0,1.0
celor,www.news.ro,0,1,0,1,-1.0,1.0
Alexandru Ioan Cuza,www.news.ro,0,0,1,1,0.0,0.0
lider politic,www.news.ro,0,0,1,1,0.0,0.0
mulțime,www.news.ro,0,1,0,1,-1.0,1.0
preot,www.news.ro,0,1,0,1,-1.0,1.0
protestatar,www.news.ro,0,1,0,1,-1.0,1.0
Dinescu,www.antena3.ro,0,2,2,4,-0.5,0.5
Iliescu,www.antena3.ro,0,1,0,1,-1.0,1.0
Mircea Dinescu,www.antena3.ro,0,2,3,5,-0.4,0.4
Rastu Nou,www.antena3.ro,0,1,0,1,-1.0,1.0
scriitor,www.antena3.ro,0,1,1,2,-0.5,0.5
Serb,www.antena3.ro,0,1,2,3,-0.3333333333333333,0.3333333333333333
avocat,www.antena3.ro,1,1,1,3,0.0,0.0
meșter,www.antena3.ro,0,1,0,1,-1.0,1.0
moț,www.antena3.ro,0,1,0,1,-1.0,1.0
strămoș,www.antena3.ro,0,0,1,1,0.0,0.0
turișt,www.antena3.ro,0,2,0,2,-1.0,1.0
Craiova,agerpres.ro,0,0,3,3,0.0,0.0
Lia Olguța Vasilescu,agerpres.ro,0,0,3,3,0.0,0.0
Maria Mitrică,agerpres.ro,0,0,4,4,0.0,0.0
Vasilescu,agerpres.ro,0,0,1,1,0.0,0.0
Dâmbovița,adevarul.ro,0,0,2,2,0.0,0.0
Niculești,adevarul.ro,0,0,1,1,0.0,0.0
Adela Mîrza,www.g4media.ro,0,0,2,2,0.0,0.0
California,www.g4media.ro,0,0,1,1,0.0,0.0
Cozmin Gușă,www.g4media.ro,0,1,1,2,-0.5,0.5
Gheorghe Noane,www.g4media.ro,0,0,2,2,0.0,0.0
Irvine,www.g4media.ro,0,0,1,1,0.0,0.0
Terheș,www.g4media.ro,0,0,3,3,0.0,0.0
Emmanuel Macron,primanews.ro,1,1,3,5,0.0,0.0
Franța,primanews.ro,0,1,11,12,-0.08333333333333333,0.08333333333333333
Kremlin,primanews.ro,0,1,3,4,-0.25,0.25
Rustem Umerov,primanews.ro,0,0,1,1,0.0,0.0
Viktor Ianukovici,primanews.ro,0,1,0,1,-1.0,1.0
Washington,primanews.ro,0,3,2,5,-0.6,0.6
Xi Jinping,primanews.ro,0,0,1,1,0.0,0.0
demonstrant,primanews.ro,0,1,0,1,-1.0,1.0
rebel,primanews.ro,0,2,0,2,-1.0,1.0
Soros,www.digi24.ro,0,1,0,1,-1.0,1.0
Timișoara,www.digi24.ro,0,0,5,5,0.0,0.0
Alexandrescu,www.digi24.ro,0,1,0,1,-1.0,1.0
miliardar,www.digi24.ro,0,1,1,2,-0.5,0.5
Chiriac,a1.ro,2,0,0,2,1.0,1.0
Cristina Chiriac,a1.ro,4,0,2,6,0.6666666666666666,0.6666666666666666
fondator,a1.ro,1,0,3,4,0.25,0.25
Gheorghe Ciuncanu,a1.ro,1,0,1,2,0.5,0.5
Gorj,a1.ro,0,0,2,2,0.0,0.0
Lasconi,a1.ro,1,0,4,5,0.2,0.2
meșteșugar,a1.ro,2,0,0,2,1.0,1.0
artizan,a1.ro,2,0,0,2,1.0,1.0
creatoare,a1.ro,0,0,3,3,0.0,0.0
meșteșug,a1.ro,1,0,1,2,0.5,0.5
tor,a1.ro,0,1,0,1,-1.0,1.0
redactor șef,pressone.ro,0,0,2,2,0.0,0.0
Adrian Curaj,www.comisarul.ro,0,0,1,1,0.0,0.0
Cristian Ghinea,www.comisarul.ro,0,0,1,1,0.0,0.0
Moise Guran,www.comisarul.ro,0,0,1,1,0.0,0.0
Dan Puric,www.comisarul.ro,0,0,4,4,0.0,0.0
personalitate,www.comisarul.ro,1,0,2,3,0.3333333333333333,0.3333333333333333
Gheorghe Mencinicopschi,www.comisarul.ro,0,0,1,1,0.0,0.0
Șerban Sturdza,www.comisarul.ro,0,0,1,1,0.0,0.0
Cristian Vasile Terheș,adevarul.ro,0,1,3,4,-0.25,0.25
plen,adevarul.ro,0,0,1,1,0.0,0.0
Sebastian Constantin Popescu,adevarul.ro,0,1,5,6,-0.16666666666666666,0.16666666666666666
Vlad Gheorghe,adevarul.ro,0,3,4,7,-0.42857142857142855,0.42857142857142855
doamna Lasconi,adevarul.ro,0,2,2,4,-0.5,0.5
lume,adevarul.ro,0,4,2,6,-0.6666666666666666,0.6666666666666666
Dan Voiculescu,www.antena3.ro,1,0,1,2,0.5,0.5
Galați,www.antena3.ro,0,0,1,1,0.0,0.0
gălățean,www.antena3.ro,0,1,0,1,-1.0,1.0
localnic,www.antena3.ro,0,0,1,1,0.0,0.0
preot,www.antena3.ro,0,0,2,2,0.0,0.0
Brennan,www.aktual24.ro,0,0,1,1,0.0,0.0
Bridget Brink,www.aktual24.ro,0,0,1,1,0.0,0.0
Brink,www.aktual24.ro,0,0,1,1,0.0,0.0
Margaret Brennan,www.aktual24.ro,0,0,1,1,0.0,0.0
Vance,www.aktual24.ro,0,1,0,1,-1.0,1.0
Volodîmîr Zelenski,www.aktual24.ro,0,1,0,1,-1.0,1.0
Joe Biden,www.aktual24.ro,0,0,3,3,0.0,0.0
republican,www.aktual24.ro,0,1,0,1,-1.0,1.0
austriac,www.luju.ro,0,0,2,2,0.0,0.0
Axel Springer,www.luju.ro,0,0,1,1,0.0,0.0
Baadsgaard,www.luju.ro,0,0,1,1,0.0,0.0
Bladet Tromsø,www.luju.ro,0,0,1,1,0.0,0.0
Bédat,www.luju.ro,0,0,1,1,0.0,0.0
Campos Damaso,www.luju.ro,0,0,1,1,0.0,0.0
Castells,www.luju.ro,0,0,1,1,0.0,0.0
Ci,www.luju.ro,0,1,0,1,-1.0,1.0
Danemarcei,www.luju.ro,0,0,1,1,0.0,0.0
Dupuis,www.luju.ro,0,1,0,1,-1.0,1.0
Dyuldin,www.luju.ro,0,0,1,1,0.0,0.0
Estonia,www.luju.ro,0,0,1,1,0.0,0.0
Finlanda,www.luju.ro,0,0,1,1,0.0,0.0
Frisk,www.luju.ro,0,0,1,1,0.0,0.0
Jensen,www.luju.ro,0,0,1,1,0.0,0.0
Kislov,www.luju.ro,0,0,1,1,0.0,0.0
Letonia,www.luju.ro,0,0,1,1,0.0,0.0
Lombardo,www.luju.ro,0,1,0,1,-1.0,1.0
Maltei,www.luju.ro,0,1,0,1,-1.0,1.0
Margulev,www.luju.ro,0,1,0,1,-1.0,1.0
Norvegia,www.luju.ro,0,0,1,1,0.0,0.0
Pedersen,www.luju.ro,0,0,1,1,0.0,0.0
Portugalia,www.luju.ro,0,0,1,1,0.0,0.0
Regatul Unit,www.luju.ro,0,2,0,2,-1.0,1.0
Romanenko,www.luju.ro,0,0,1,1,0.0,0.0
Satakunnan Markkinapörss,www.luju.ro,0,0,1,1,0.0,0.0
Satamedia,www.luju.ro,0,0,1,1,0.0,0.0
Slovac,www.luju.ro,0,0,1,1,0.0,0.0
Spania,www.luju.ro,0,0,2,2,0.0,0.0
Stensaas,www.luju.ro,0,0,1,1,0.0,0.0
Tammer,www.luju.ro,0,0,1,1,0.0,0.0
Toranzo Gomez,www.luju.ro,0,0,1,1,0.0,0.0
Vasile Bănescu,www.luju.ro,0,1,0,1,-1.0,1.0
agent,www.luju.ro,0,3,1,4,-0.75,0.75
ales,www.luju.ro,0,1,1,2,-0.5,0.5
cu,www.luju.ro,0,1,0,1,-1.0,1.0
Banescu,www.luju.ro,0,1,0,1,-1.0,1.0
Vasile Banescu,www.luju.ro,0,1,1,2,-0.5,0.5
jurist,www.luju.ro,0,1,0,1,-1.0,1.0
Marius Tuca,www.luju.ro,0,0,2,2,0.0,0.0
olac,www.luju.ro,0,1,0,1,-1.0,1.0
public,www.luju.ro,0,3,5,8,-0.375,0.375
trimis,www.luju.ro,0,1,0,1,-1.0,1.0
y,www.luju.ro,0,0,1,1,0.0,0.0
India,www.romaniatv.net,0,0,3,3,0.0,0.0
Indonezia,www.romaniatv.net,0,0,1,1,0.0,0.0
Japonia,www.romaniatv.net,0,0,2,2,0.0,0.0
Kazahstan,www.romaniatv.net,0,0,2,2,0.0,0.0
Sankt Petersburg,www.romaniatv.net,0,0,2,2,0.0,0.0
Thailanda,www.romaniatv.net,0,0,1,1,0.0,0.0
Uzbekistan,www.romaniatv.net,0,0,2,2,0.0,0.0
Cornelia Dumitru,www.g4media.ro,0,0,1,1,0.0,0.0
Marius Frățilă,www.g4media.ro,0,0,2,2,0.0,0.0
Virgil Guran,www.g4media.ro,0,0,2,2,0.0,0.0
autor,www.g4media.ro,0,2,5,7,-0.2857142857142857,0.2857142857142857
editor,www.g4media.ro,0,0,1,1,0.0,0.0
Omului,www.mediafax.ro,0,0,1,1,0.0,0.0
Președintele,www.mediafax.ro,0,0,2,2,0.0,0.0
autor,www.mediafax.ro,0,2,1,3,-0.6666666666666666,0.6666666666666666
legiuitor,www.mediafax.ro,0,1,0,1,-1.0,1.0
procuror general,www.mediafax.ro,0,1,1,2,-0.5,0.5
părinte,www.mediafax.ro,0,0,1,1,0.0,0.0
titular,www.mediafax.ro,0,1,1,2,-0.5,0.5
învinuit,www.mediafax.ro,0,1,0,1,-1.0,1.0
Mehedinți,www.news.ro,0,0,1,1,0.0,0.0
Virgil Popescu,www.news.ro,0,0,2,2,0.0,0.0
Cristian Ghinea,www.aktual24.ro,0,2,3,5,-0.4,0.4
Cristina Pruna,www.aktual24.ro,0,0,3,3,0.0,0.0
Bistrița,agerpres.ro,0,0,3,3,0.0,0.0
Eforie,agerpres.ro,0,0,1,1,0.0,0.0
Marcel Boloș,agerpres.ro,0,0,6,6,0.0,0.0
locuitor,agerpres.ro,0,0,1,1,0.0,0.0
Laszlo Tokes,adevarul.ro,0,0,2,2,0.0,0.0
Slovacia,adevarul.ro,0,1,1,2,-0.5,0.5
Sogor Csaba,adevarul.ro,0,0,1,1,0.0,0.0
voievodină,adevarul.ro,0,0,1,1,0.0,0.0
minoritate,adevarul.ro,0,1,0,1,-1.0,1.0
Badea,www.cotidianul.ro,1,0,0,1,1.0,1.0
Je,www.cotidianul.ro,0,0,1,1,0.0,0.0
Sorina Matei,www.cotidianul.ro,0,2,0,2,-1.0,1.0
Mucușor,www.cotidianul.ro,0,1,0,1,-1.0,1.0
Papagali,www.cotidianul.ro,0,1,0,1,-1.0,1.0
Turcan,www.cotidianul.ro,0,1,0,1,-1.0,1.0
ghiari,www.cotidianul.ro,0,1,0,1,-1.0,1.0
Baia Mare,www.comisarul.ro,0,0,2,2,0.0,0.0
Henri Coandă,www.comisarul.ro,0,0,1,1,0.0,0.0
Ioan Rus,www.comisarul.ro,0,0,2,2,0.0,0.0
Pușcaș,www.comisarul.ro,0,1,1,2,-0.5,0.5
Satu Mare,www.comisarul.ro,0,2,3,5,-0.4,0.4
Snoop,www.comisarul.ro,0,0,2,2,0.0,0.0
Vasile Pușcaș,www.comisarul.ro,0,0,2,2,0.0,0.0
afacerist,www.comisarul.ro,0,6,1,7,-0.8571428571428571,0.8571428571428571
ginere,www.comisarul.ro,0,1,0,1,-1.0,1.0
Emil Boc,www.comisarul.ro,0,1,3,4,-0.25,0.25
Anamaria Gavrilă,stirileprotv.ro,0,2,0,2,-1.0,1.0
Gavrilă,stirileprotv.ro,0,1,0,1,-1.0,1.0
Kelemen Hunor,stirileprotv.ro,0,1,7,8,-0.125,0.125
Varujan Pambuccian,stirileprotv.ro,0,0,2,2,0.0,0.0
ohann,stirileprotv.ro,0,1,0,1,-1.0,1.0
Șoșoacă,stirileprotv.ro,0,3,1,4,-0.75,0.75
Chișinău,www.g4media.ro,0,0,3,3,0.0,0.0
pensionar,www.g4media.ro,0,3,2,5,-0.6,0.6
student,www.g4media.ro,1,1,4,6,0.0,0.0
Târziu,www.digi24.ro,0,5,0,5,-1.0,1.0
JD Vance,www.digi24.ro,0,1,1,2,-0.5,0.5
Munchen,www.digi24.ro,0,0,1,1,0.0,0.0
Coana Leana,adevarul.ro,0,1,0,1,-1.0,1.0
Coana Leanable,adevarul.ro,0,1,0,1,-1.0,1.0
Câmpulung Muscel,adevarul.ro,0,0,3,3,0.0,0.0
Marius,adevarul.ro,0,0,1,1,0.0,0.0
Suzana Gâdea,adevarul.ro,0,0,1,1,0.0,0.0
demagog,adevarul.ro,0,1,0,1,-1.0,1.0
doamna Șoșoacă,adevarul.ro,0,1,0,1,-1.0,1.0
Adrian Veștea,www.euronews.ro,0,0,1,1,0.0,0.0
"Adrian Veștea, secretar general",www.euronews.ro,0,0,1,1,0.0,0.0
Ciprian Ciucu,www.euronews.ro,0,1,1,2,-0.5,0.5
Vlad Gheorghe,www.euronews.ro,1,0,3,4,0.25,0.25
Șoșoacă,www.euronews.ro,0,3,2,5,-0.6,0.6
Radu Moldovan,www.g4media.ro,0,0,1,1,0.0,0.0
Brăila,www.g4media.ro,0,0,2,2,0.0,0.0
Dan Perciun,www.g4media.ro,0,1,2,3,-0.3333333333333333,0.3333333333333333
elev,www.g4media.ro,0,0,3,3,0.0,0.0
Ciprian Rus,www.news.ro,0,0,2,2,0.0,0.0
Cătălin Bochileanu,www.news.ro,0,0,1,1,0.0,0.0
Iulian Lorincz,www.news.ro,0,0,2,2,0.0,0.0
Adelaide,adevarul.ro,0,0,3,3,0.0,0.0
Australia,adevarul.ro,0,0,4,4,0.0,0.0
Botoșani,adevarul.ro,0,0,2,2,0.0,0.0
Bâcleș,adevarul.ro,0,1,0,1,-1.0,1.0
Bărăștii de Vede,adevarul.ro,0,0,1,1,0.0,0.0
Canberra,adevarul.ro,0,0,3,3,0.0,0.0
Colonești,adevarul.ro,0,1,0,1,-1.0,1.0
Gogoșu,adevarul.ro,0,1,0,1,-1.0,1.0
Ilfov,adevarul.ro,0,0,2,2,0.0,0.0
Mehedinți,adevarul.ro,0,1,4,5,-0.2,0.2
Melbourne,adevarul.ro,0,0,3,3,0.0,0.0
Poroina,adevarul.ro,0,1,0,1,-1.0,1.0
Prahova,adevarul.ro,0,2,5,7,-0.2857142857142857,0.2857142857142857
Satu Mare,adevarul.ro,0,0,3,3,0.0,0.0
Spania,adevarul.ro,0,0,5,5,0.0,0.0
surfer,adevarul.ro,0,0,1,1,0.0,0.0
Sydney,adevarul.ro,0,0,3,3,0.0,0.0
Vaslui,adevarul.ro,0,0,6,6,0.0,0.0
Alessandra Stoicescu,www.cotidianul.ro,0,0,1,1,0.0,0.0
președinte interimar,www.cotidianul.ro,0,0,3,3,0.0,0.0
corporatist,www.cotidianul.ro,0,1,0,1,-1.0,1.0
ocupant,www.cotidianul.ro,0,1,0,1,-1.0,1.0
realizator,www.cotidianul.ro,0,1,0,1,-1.0,1.0
personaj,www.digi24.ro,1,5,3,9,-0.4444444444444444,0.4444444444444444
Amsterdam,www.mediafax.ro,0,0,1,1,0.0,0.0
Antwerpen,www.mediafax.ro,0,0,1,1,0.0,0.0
Berlin,www.mediafax.ro,0,0,2,2,0.0,0.0
Dublin,www.mediafax.ro,0,0,1,1,0.0,0.0
Lille,www.mediafax.ro,0,0,1,1,0.0,0.0
Londra,www.mediafax.ro,0,0,1,1,0.0,0.0
Marian Muhuleț,www.mediafax.ro,0,0,1,1,0.0,0.0
Muhuleț,www.mediafax.ro,0,0,1,1,0.0,0.0
Offenbach,www.mediafax.ro,0,1,0,1,-1.0,1.0
Regensburg,www.mediafax.ro,0,0,1,1,0.0,0.0
Roma,www.mediafax.ro,0,1,0,1,-1.0,1.0
Verona,www.mediafax.ro,0,0,1,1,0.0,0.0
alegător,www.mediafax.ro,0,4,2,6,-0.6666666666666666,0.6666666666666666
hoț,www.mediafax.ro,0,1,0,1,-1.0,1.0
âm,www.mediafax.ro,0,1,0,1,-1.0,1.0
Cristian Diaconescu,www.news.ro,0,0,14,14,0.0,0.0
Diaconescu,www.news.ro,0,1,4,5,-0.2,0.2
Daniel Suciu,agerpres.ro,0,0,3,3,0.0,0.0
Emil Hurezeanu,agerpres.ro,0,1,2,3,-0.3333333333333333,0.3333333333333333
Agnita,pressone.ro,0,0,1,1,0.0,0.0
Barna Tánczos,pressone.ro,0,2,0,2,-1.0,1.0
Blândești,pressone.ro,0,0,1,1,0.0,0.0
Borboly,pressone.ro,0,0,1,1,0.0,0.0
Borboly Csaba,pressone.ro,0,1,0,1,-1.0,1.0
Borzont,pressone.ro,0,1,0,1,-1.0,1.0
Bușteni,pressone.ro,0,0,1,1,0.0,0.0
Caransebeș,pressone.ro,0,0,2,2,0.0,0.0
Cinod,pressone.ro,0,1,0,1,-1.0,1.0
Ciuc,pressone.ro,0,0,1,1,0.0,0.0
Ciucul de Sus,pressone.ro,0,0,1,1,0.0,0.0
Costel Șoptică,pressone.ro,0,2,0,2,-1.0,1.0
Furic Iarco,pressone.ro,0,0,1,1,0.0,0.0
Ioan Sorin Roman,pressone.ro,0,0,1,1,0.0,0.0
Ioan Terea,pressone.ro,0,1,1,2,-0.5,0.5
Ion Tăbugan,pressone.ro,0,0,1,1,0.0,0.0
Dorohoi,pressone.ro,0,0,1,1,0.0,0.0
Emanoil Savin,pressone.ro,0,0,1,1,0.0,0.0
Eugen Gioancă,pressone.ro,0,0,1,1,0.0,0.0
Filiași,pressone.ro,0,0,1,1,0.0,0.0
Flămânzi,pressone.ro,0,0,1,1,0.0,0.0
Făget,pressone.ro,0,0,1,1,0.0,0.0
Gioancă,pressone.ro,0,0,1,1,0.0,0.0
Horea,pressone.ro,0,0,1,1,0.0,0.0
Liliana Magda,pressone.ro,0,0,1,1,0.0,0.0
Marcel Vela,pressone.ro,0,0,3,3,0.0,0.0
Miercurea Ciuc,pressone.ro,1,0,2,3,0.3333333333333333,0.3333333333333333
Mădăraș,pressone.ro,0,0,1,1,0.0,0.0
Odorheiul Secuiesc,pressone.ro,0,0,1,1,0.0,0.0
Sandominic,pressone.ro,0,1,0,1,-1.0,1.0
Savin,pressone.ro,0,0,1,1,0.0,0.0
Savin Emanoil,pressone.ro,0,0,1,1,0.0,0.0
Silviu Chiriac,pressone.ro,0,0,1,1,0.0,0.0
Sâncrăieni,pressone.ro,0,0,1,1,0.0,0.0
Turnu Ruieni,pressone.ro,0,0,1,1,0.0,0.0
Tușnad,pressone.ro,0,0,2,2,0.0,0.0
Tánczos,pressone.ro,0,0,1,1,0.0,0.0
Tánczos Szidónia,pressone.ro,0,0,1,1,0.0,0.0
Tăbugan,pressone.ro,0,1,0,1,-1.0,1.0
Vela,pressone.ro,0,0,2,2,0.0,0.0
cenzor,pressone.ro,0,1,0,1,-1.0,1.0
crescător,pressone.ro,0,1,0,1,-1.0,1.0
Corneliu Olar,pressone.ro,0,1,2,3,-0.3333333333333333,0.3333333333333333
Gheorghe Tinel,pressone.ro,0,0,1,1,0.0,0.0
Emanuel Havrici,pressone.ro,0,0,1,1,0.0,0.0
Ion Cupă,pressone.ro,0,0,1,1,0.0,0.0
neveste,pressone.ro,0,2,0,2,-1.0,1.0
silvicultor,pressone.ro,0,0,1,1,0.0,0.0
victima,pressone.ro,1,5,2,8,-0.5,0.5
vânt,pressone.ro,0,0,1,1,0.0,0.0
vânător,pressone.ro,0,2,0,2,-1.0,1.0
șopț,pressone.ro,0,1,0,1,-1.0,1.0
Bogdan Popescu,stirileprotv.ro,0,2,0,2,-1.0,1.0
Cristina Prună,pressone.ro,0,0,2,2,0.0,0.0
Ionela Băluță,pressone.ro,0,0,2,2,0.0,0.0
Ionelei Băluță,pressone.ro,0,0,1,1,0.0,0.0
Prună,pressone.ro,0,0,1,1,0.0,0.0
cercetătoare,pressone.ro,0,1,2,3,-0.3333333333333333,0.3333333333333333
contestatoare,pressone.ro,0,1,0,1,-1.0,1.0
omolog,pressone.ro,0,2,2,4,-0.5,0.5
Bruxelles,agerpres.ro,0,0,4,4,0.0,0.0
Boloș,agerpres.ro,0,0,3,3,0.0,0.0
expert,agerpres.ro,0,0,7,7,0.0,0.0
miniștri,agerpres.ro,0,3,4,7,-0.42857142857142855,0.42857142857142855
Gheorghe,www.mediafax.ro,0,1,2,3,-0.3333333333333333,0.3333333333333333
Tăricianu,www.mediafax.ro,0,1,0,1,-1.0,1.0
Vlad Gheorghe,www.mediafax.ro,0,0,1,1,0.0,0.0
Andrei Muraru,www.luju.ro,0,1,0,1,-1.0,1.0
Buzau,www.luju.ro,0,1,1,2,-0.5,0.5
Constanța,www.luju.ro,0,1,1,2,-0.5,0.5
Dacian Ciolos,www.luju.ro,0,0,1,1,0.0,0.0
Emmanuel Macron,www.luju.ro,0,4,4,8,-0.5,0.5
Emil Hurezeanu,www.luju.ro,0,1,0,1,-1.0,1.0
Lucian Romascanu,www.luju.ro,0,1,0,1,-1.0,1.0
Persona,www.luju.ro,0,1,0,1,-1.0,1.0
Washington,www.luju.ro,0,2,1,3,-0.6666666666666666,0.6666666666666666
cap,www.luju.ro,0,1,0,1,-1.0,1.0
denigrator,www.luju.ro,0,1,0,1,-1.0,1.0
Dragos Spranceana,www.luju.ro,0,1,0,1,-1.0,1.0
oficial,www.luju.ro,1,4,1,6,-0.5,0.5
om politic,www.luju.ro,0,1,0,1,-1.0,1.0
Andronescu,pressone.ro,0,2,0,2,-1.0,1.0
Blaga,pressone.ro,0,0,3,3,0.0,0.0
Cornel Panait,pressone.ro,0,0,1,1,0.0,0.0
Cîmpeanu,pressone.ro,0,4,5,9,-0.4444444444444444,0.4444444444444444
Dan Popa,pressone.ro,0,0,1,1,0.0,0.0
Daniel Funeriu,pressone.ro,0,0,1,1,0.0,0.0
Florian Popa,pressone.ro,0,0,2,2,0.0,0.0
Iosif Ștefan Drăgulescu,pressone.ro,0,0,1,1,0.0,0.0
Marilen Pirtea,pressone.ro,0,1,3,4,-0.25,0.25
Marinel Pirtea,pressone.ro,0,0,1,1,0.0,0.0
Mihnea Costoiu,pressone.ro,0,0,3,3,0.0,0.0
Mircea Miclea,pressone.ro,0,0,2,2,0.0,0.0
Nicolae Robu,pressone.ro,0,1,3,4,-0.25,0.25
Pirtea,pressone.ro,0,1,1,2,-0.5,0.5
Pricopie,pressone.ro,0,0,1,1,0.0,0.0
Rector,pressone.ro,0,1,2,3,-0.3333333333333333,0.3333333333333333
Remus Pricopie,pressone.ro,0,0,2,2,0.0,0.0
ministru Mircea Miclea,pressone.ro,0,1,0,1,-1.0,1.0
protejat,pressone.ro,0,2,0,2,-1.0,1.0
rectorat,pressone.ro,0,0,1,1,0.0,0.0
Peiu,www.b1tv.ro,0,0,1,1,0.0,0.0
Petrișor Peiu,www.b1tv.ro,0,1,0,1,-1.0,1.0
imion,www.b1tv.ro,0,1,0,1,-1.0,1.0
patriot,www.b1tv.ro,1,2,0,3,-0.3333333333333333,0.3333333333333333
ăsta,www.b1tv.ro,0,1,0,1,-1.0,1.0
Mara Roman,www.euronews.ro,0,0,1,1,0.0,0.0
"Mihai Tudose, Gabriela Firea, Claudiu Manda, Victor Negrescu, Vasile Dîncu, Maria Grapini, Gheorghe Cârciu, Dragoș Benea",www.euronews.ro,0,0,1,1,0.0,0.0
Nicole Ciucă,www.euronews.ro,0,0,1,1,0.0,0.0
Ramona Chiriac,www.euronews.ro,0,0,1,1,0.0,0.0
Ramonei Chiriac,www.euronews.ro,0,0,1,1,0.0,0.0
Rareș Bogdan,www.euronews.ro,0,0,4,4,0.0,0.0
Titus Corlățean,www.euronews.ro,0,0,2,2,0.0,0.0
ea,www.euronews.ro,0,1,1,2,-0.5,0.5
înlocuitor,www.euronews.ro,0,2,0,2,-1.0,1.0
Dinu Iancu Sălăjanu,agerpres.ro,0,0,1,1,0.0,0.0
Sebastian Olaru,agerpres.ro,0,0,3,3,0.0,0.0
Zalău,agerpres.ro,0,0,1,1,0.0,0.0
Zală,agerpres.ro,1,0,1,2,0.5,0.5
Nicoșor Dan,observatornews.ro,0,1,0,1,-1.0,1.0
Israel,www.g4media.ro,1,2,2,5,-0.2,0.2
Reuven Azar,www.g4media.ro,0,0,1,1,0.0,0.0
Sorin Lavric,www.g4media.ro,0,1,0,1,-1.0,1.0
ideolog,www.g4media.ro,0,1,0,1,-1.0,1.0
Donald Trump Jr,www.antena3.ro,0,0,1,1,0.0,0.0
Dinu Patriciu,recorder.ro,0,1,0,1,-1.0,1.0
Eugen Nicolicea,recorder.ro,0,2,0,2,-1.0,1.0
Florin Iordache,recorder.ro,0,4,1,5,-0.8,0.8
Nicolicea,recorder.ro,0,1,0,1,-1.0,1.0
rege,recorder.ro,0,2,0,2,-1.0,1.0
regele,recorder.ro,1,2,0,3,-0.3333333333333333,0.3333333333333333
Regele Mihai,recorder.ro,0,2,2,4,-0.5,0.5
Regele,recorder.ro,0,1,1,2,-0.5,0.5
Ticu Dumitrescu,recorder.ro,0,1,0,1,-1.0,1.0
Vadim,recorder.ro,0,1,0,1,-1.0,1.0
Vadim Tudor,recorder.ro,0,1,0,1,-1.0,1.0
gunoier,recorder.ro,0,1,0,1,-1.0,1.0
putat,recorder.ro,0,1,0,1,-1.0,1.0
Albă,snoop.ro,0,0,1,1,0.0,0.0
Angela Merkel,snoop.ro,0,0,1,1,0.0,0.0
Azuga,snoop.ro,0,0,1,1,0.0,0.0
Barack Obama,snoop.ro,0,0,1,1,0.0,0.0
Bran,snoop.ro,0,0,2,2,0.0,0.0
Bușteni,snoop.ro,0,0,1,1,0.0,0.0
Băicoi,snoop.ro,0,0,1,1,0.0,0.0
Bănești,snoop.ro,0,1,3,4,-0.25,0.25
Comarnic,snoop.ro,0,0,1,1,0.0,0.0
Câmpina,snoop.ro,0,0,4,4,0.0,0.0
Cătălin Drulă,snoop.ro,0,0,1,1,0.0,0.0
Feleacu,snoop.ro,0,0,1,1,0.0,0.0
Ionel Ciunt,snoop.ro,0,0,1,1,0.0,0.0
Lucian Romașcanu,snoop.ro,0,1,2,3,-0.3333333333333333,0.3333333333333333
Moieciu,snoop.ro,0,0,1,1,0.0,0.0
Oana Murariu,snoop.ro,0,0,1,1,0.0,0.0
Prahova,snoop.ro,0,0,7,7,0.0,0.0
Predeal,snoop.ro,0,0,1,1,0.0,0.0
Romașcanu,snoop.ro,0,1,0,1,-1.0,1.0
Râșnov,snoop.ro,0,0,2,2,0.0,0.0
Tohanul Nou,snoop.ro,0,0,1,1,0.0,0.0
Tulcea,snoop.ro,0,0,2,2,0.0,0.0
ostaș,snoop.ro,0,2,0,2,-1.0,1.0
Călinescu,www.realitatea.net,0,1,0,1,-1.0,1.0
ăia,www.realitatea.net,0,1,0,1,-1.0,1.0
Cristian Diaconescu,www.gandul.ro,0,0,3,3,0.0,0.0
Diaconescu,www.gandul.ro,0,0,1,1,0.0,0.0
Mihai Răzvan Ungureanu,www.gandul.ro,0,0,1,1,0.0,0.0
Năstase,www.gandul.ro,0,1,0,1,-1.0,1.0
contracandidat,www.gandul.ro,0,9,4,13,-0.6923076923076923,0.6923076923076923
Traian Băsescu,www.gandul.ro,1,8,12,21,-0.3333333333333333,0.3333333333333333
Antonie,primanews.ro,0,0,1,1,0.0,0.0
Antonie Iorgovan,primanews.ro,0,0,1,1,0.0,0.0
Elena Simina Tănăsescu,primanews.ro,0,0,1,1,0.0,0.0
Ioan Muraru,primanews.ro,0,0,1,1,0.0,0.0
Mihai Constaninescu,primanews.ro,0,0,1,1,0.0,0.0
Mihai Constantinescu,primanews.ro,0,0,1,1,0.0,0.0
Președintele,primanews.ro,0,1,3,4,-0.25,0.25
an,primanews.ro,0,0,1,1,0.0,0.0
tehnocrat,primanews.ro,0,1,1,2,-0.5,0.5
Augustin Zegrean,observatornews.ro,0,1,2,3,-0.3333333333333333,0.3333333333333333
Gigi Becali,observatornews.ro,0,0,5,5,0.0,0.0
Stoiciu,www.aktual24.ro,0,1,0,1,-1.0,1.0
Victoria Stoiciu,www.aktual24.ro,0,1,3,4,-0.25,0.25
demnitar,www.aktual24.ro,0,1,1,2,-0.5,0.5
Fifor,agerpres.ro,0,1,0,1,-1.0,1.0
Mihai Fifor,agerpres.ro,3,1,6,10,0.2,0.2
celor,agerpres.ro,0,1,0,1,-1.0,1.0
om politic,agerpres.ro,0,2,1,3,-0.6666666666666666,0.6666666666666666
neavenit,www.comisarul.ro,0,1,0,1,-1.0,1.0
Daniel Bosa,a1.ro,0,0,1,1,0.0,0.0
Nicușor Sgubeanu,a1.ro,0,0,1,1,0.0,0.0
Robert Dicu,a1.ro,0,0,1,1,0.0,0.0
muncitor,a1.ro,0,1,1,2,-0.5,0.5
terorist,a1.ro,0,1,0,1,-1.0,1.0
Dăncilă,www.cotidianul.ro,0,0,1,1,0.0,0.0
Vasile Cristian Terheș,www.cotidianul.ro,0,0,1,1,0.0,0.0
Viorica Dăncilă,www.cotidianul.ro,0,1,0,1,-1.0,1.0
Raicu,www.mediafax.ro,0,0,1,1,0.0,0.0
Romeo Raicu,www.mediafax.ro,1,0,0,1,1.0,1.0
Teo Trandafir,www.mediafax.ro,1,0,0,1,1.0,1.0
Syda,a1.ro,0,0,1,1,0.0,0.0
asociat,a1.ro,0,1,0,1,-1.0,1.0
Victor Videanu,a1.ro,0,3,0,3,-1.0,1.0
prieteni,a1.ro,2,0,2,4,0.5,0.5
antreprenor,adevarul.ro,2,1,3,6,0.16666666666666666,0.16666666666666666
Carolina de Sud,adevarul.ro,0,0,1,1,0.0,0.0
Florida,adevarul.ro,0,0,7,7,0.0,0.0
John Banu Muscel,adevarul.ro,0,0,1,1,0.0,0.0
John Ion Banu,adevarul.ro,0,0,2,2,0.0,0.0
John Ion Banu Muscel,adevarul.ro,0,0,2,2,0.0,0.0
McCormick,adevarul.ro,0,0,1,1,0.0,0.0
Mugur Ciuvică,adevarul.ro,0,0,1,1,0.0,0.0
român,adevarul.ro,1,2,0,3,-0.3333333333333333,0.3333333333333333
milionar,adevarul.ro,0,1,2,3,-0.3333333333333333,0.3333333333333333
ATA,www.luju.ro,0,1,0,1,-1.0,1.0
George,www.luju.ro,0,3,1,4,-0.75,0.75
Chișinău,www.gandul.ro,0,1,5,6,-0.16666666666666666,0.16666666666666666
Filat,www.gandul.ro,0,0,1,1,0.0,0.0
Maia Sandu,www.gandul.ro,2,1,1,4,0.25,0.25
Vlad Filat,www.gandul.ro,0,1,0,1,-1.0,1.0
Macedonia,primanews.ro,0,0,2,2,0.0,0.0
părinte,primanews.ro,0,2,0,2,-1.0,1.0
Stevo Pendarovski,primanews.ro,1,0,0,1,1.0,1.0
copil,primanews.ro,6,4,2,12,0.16666666666666666,0.16666666666666666
familie,primanews.ro,6,2,3,11,0.36363636363636365,0.36363636363636365
fetiță,primanews.ro,0,1,1,2,-0.5,0.5
Ioan Stanomir,adevarul.ro,0,1,5,6,-0.16666666666666666,0.16666666666666666
Stanomir,adevarul.ro,0,0,1,1,0.0,0.0
Ioana Grosaru,www.comisarul.ro,0,0,1,1,0.0,0.0
Președintele,www.comisarul.ro,0,0,4,4,0.0,0.0
Alexandru Popa,www.comisarul.ro,0,1,0,1,-1.0,1.0
Antim,www.romaniatv.net,0,0,2,2,0.0,0.0
Cei,www.romaniatv.net,0,0,1,1,0.0,0.0
cuplu,www.romaniatv.net,0,0,2,2,0.0,0.0
Mirabela,www.romaniatv.net,0,0,2,2,0.0,0.0
Mirabela Grădinaru,www.romaniatv.net,0,0,2,2,0.0,0.0
Vaslui,www.romaniatv.net,0,0,2,2,0.0,0.0
cercetător,www.romaniatv.net,0,0,2,2,0.0,0.0
Aheea,www.romaniatv.net,0,0,2,2,0.0,0.0
mamă,www.romaniatv.net,1,0,1,2,0.5,0.5
studentă,www.romaniatv.net,1,0,1,2,0.5,0.5
student,www.romaniatv.net,2,0,2,4,0.5,0.5
finalist,www.digi24.ro,0,0,1,1,0.0,0.0
Cristian Seidler,www.b1tv.ro,0,0,1,1,0.0,0.0
Dan Motreanu,www.euronews.ro,0,1,3,4,-0.25,0.25
Dan Vîlceanu,www.euronews.ro,0,0,1,1,0.0,0.0
Florin Cîțu,www.euronews.ro,0,0,1,1,0.0,0.0
Guran,www.euronews.ro,0,0,1,1,0.0,0.0
Sorin Moldovan,www.euronews.ro,0,0,1,1,0.0,0.0
Vergil Chițac,www.euronews.ro,0,0,1,1,0.0,0.0
Virgil Guran,www.euronews.ro,0,0,2,2,0.0,0.0
Virgil Popescu,www.euronews.ro,0,0,2,2,0.0,0.0
Ben Oni Ardelean,www.euronews.ro,0,0,1,1,0.0,0.0
Bill Clinton,www.news.ro,0,0,1,1,0.0,0.0
Constantinescu,www.news.ro,1,0,1,2,0.5,0.5
Emil Constantinescu,www.news.ro,1,0,1,2,0.5,0.5
Ghiță,www.news.ro,0,2,0,2,-1.0,1.0
Iugoslavia,www.news.ro,0,1,0,1,-1.0,1.0
Sebastian Ghiță,www.news.ro,0,2,0,2,-1.0,1.0
Serb,www.news.ro,0,0,1,1,0.0,0.0
aliat,www.news.ro,0,0,2,2,0.0,0.0
amândoi,www.news.ro,1,0,0,1,1.0,1.0
cercetător,www.news.ro,1,0,0,1,1.0,1.0
domn,www.news.ro,0,0,4,4,0.0,0.0
Nicolae Iliescu,www.news.ro,0,1,0,1,-1.0,1.0
dușman,www.news.ro,0,4,0,4,-1.0,1.0
garant,www.news.ro,0,1,0,1,-1.0,1.0
polițist,www.news.ro,1,4,0,5,-0.6,0.6
preopinent,www.news.ro,0,1,0,1,-1.0,1.0
protector,www.news.ro,0,1,0,1,-1.0,1.0
public,www.news.ro,1,3,4,8,-0.25,0.25
subsecretar,www.news.ro,0,0,1,1,0.0,0.0
suporter,www.news.ro,1,0,1,2,0.5,0.5
victimă,www.news.ro,5,1,1,7,0.5714285714285714,0.5714285714285714
Ana Hermina Iancu,www.luju.ro,0,0,1,1,0.0,0.0
Axinte,www.luju.ro,0,0,1,1,0.0,0.0
Cristinel Grosu,www.luju.ro,0,0,2,2,0.0,0.0
Lacramioara Axinte,www.luju.ro,0,1,1,2,-0.5,0.5
Maricel Nechita,www.luju.ro,0,0,1,1,0.0,0.0
Mihaela Mineran,www.luju.ro,0,0,1,1,0.0,0.0
Mihnea Adrian Tănase,www.luju.ro,0,0,1,1,0.0,0.0
Radu Cristescu,agerpres.ro,0,0,1,1,0.0,0.0
Elon Musk,www.comisarul.ro,0,1,4,5,-0.2,0.2
Marian Oprișan,recorder.ro,0,1,1,2,-0.5,0.5
Petre Daea,recorder.ro,0,2,1,3,-0.6666666666666666,0.6666666666666666
Vrancea,recorder.ro,0,0,5,5,0.0,0.0
crainic,recorder.ro,0,1,0,1,-1.0,1.0
Abhazia,www.activenews.ro,0,0,1,1,0.0,0.0
Aleksei Kozlov,www.activenews.ro,0,0,1,1,0.0,0.0
Alexei Kozlov,www.activenews.ro,0,0,1,1,0.0,0.0
Armenia,www.activenews.ro,0,0,1,1,0.0,0.0
Belarus,www.activenews.ro,0,1,1,2,-0.5,0.5
Estonia,www.activenews.ro,0,0,1,1,0.0,0.0
Georgia,www.activenews.ro,0,0,1,1,0.0,0.0
Kozlov,www.activenews.ro,0,1,0,1,-1.0,1.0
Laine,www.activenews.ro,0,0,1,1,0.0,0.0
Martin Line,www.activenews.ro,0,0,1,1,0.0,0.0
Mircea Dan Geoană,www.activenews.ro,0,0,1,1,0.0,0.0
Mănescu,www.activenews.ro,0,1,0,1,-1.0,1.0
Osetia de Sud,www.activenews.ro,0,0,1,1,0.0,0.0
Ramon Mănescu,www.activenews.ro,0,0,1,1,0.0,0.0
Rares,www.activenews.ro,0,0,1,1,0.0,0.0
Rares Mănescu,www.activenews.ro,0,0,1,1,0.0,0.0
Rareș Mănescu,www.activenews.ro,0,1,0,1,-1.0,1.0
Transnistria,www.activenews.ro,0,0,1,1,0.0,0.0
Ucraina,www.activenews.ro,0,4,16,20,-0.2,0.2
antreprenor,www.activenews.ro,0,0,1,1,0.0,0.0
bucătar,www.activenews.ro,1,0,0,1,1.0,1.0
corespondent,www.activenews.ro,0,2,1,3,-0.6666666666666666,0.6666666666666666
marionetă,www.activenews.ro,0,3,0,3,-1.0,1.0
număr,www.activenews.ro,0,1,0,1,-1.0,1.0
observator,www.activenews.ro,0,0,4,4,0.0,0.0
protagonist,www.activenews.ro,0,0,1,1,0.0,0.0
specialist,www.activenews.ro,2,3,3,8,-0.125,0.125
Cristian Seidler,adevarul.ro,0,0,2,2,0.0,0.0
Drulă,adevarul.ro,0,0,3,3,0.0,0.0
Seidler,adevarul.ro,0,0,1,1,0.0,0.0
Belarus,www.luju.ro,0,1,0,1,-1.0,1.0
Parchetul General,www.luju.ro,0,1,0,1,-1.0,1.0
Anca Alexandrescu,www.luju.ro,0,0,2,2,0.0,0.0
politist,www.luju.ro,0,12,1,13,-0.9230769230769231,0.9230769230769231
Ludovic Orban,www.gandul.ro,0,1,11,12,-0.08333333333333333,0.08333333333333333
Nelu Tătaru,www.gandul.ro,0,1,0,1,-1.0,1.0
Orban,www.gandul.ro,0,2,2,4,-0.5,0.5
Ponta,www.gandul.ro,0,7,4,11,-0.6363636363636364,0.6363636363636364
Tătaru,www.gandul.ro,0,1,0,1,-1.0,1.0
ambulanțier,www.gandul.ro,1,0,1,2,0.5,0.5
apărător,www.gandul.ro,1,0,0,1,1.0,1.0
personal medical,www.gandul.ro,0,0,1,1,0.0,0.0
Grigore Popescu,pressone.ro,0,0,2,2,0.0,0.0
Adolf Hitler,pressone.ro,0,1,1,2,-0.5,0.5
Ion Iliescu,pressone.ro,0,3,8,11,-0.2727272727272727,0.2727272727272727
Lavric,pressone.ro,0,1,0,1,-1.0,1.0
Liviu Chirica,pressone.ro,0,0,1,1,0.0,0.0
Mălin Bot,pressone.ro,0,1,0,1,-1.0,1.0
Nicholas Taleb,pressone.ro,0,0,1,1,0.0,0.0
Noica,pressone.ro,1,1,0,2,0.0,0.0
Sorin Lavric,pressone.ro,0,1,0,1,-1.0,1.0
antreprenor,pressone.ro,2,3,7,12,-0.08333333333333333,0.08333333333333333
corporatișt,pressone.ro,0,1,0,1,-1.0,1.0
divinitate,pressone.ro,0,1,0,1,-1.0,1.0
filosof,pressone.ro,0,1,3,4,-0.25,0.25
follower,pressone.ro,0,1,1,2,-0.5,0.5
impostor,pressone.ro,0,2,0,2,-1.0,1.0
om de afaceri,pressone.ro,0,6,9,15,-0.4,0.4
puști,pressone.ro,0,2,0,2,-1.0,1.0
scriitor,pressone.ro,3,1,5,9,0.2222222222222222,0.2222222222222222
Friedrich Merz,www.mediafax.ro,0,0,2,2,0.0,0.0
Jusos,www.mediafax.ro,0,1,0,1,-1.0,1.0
Klingbeil,www.mediafax.ro,0,0,1,1,0.0,0.0
Lars Klingbeil,www.mediafax.ro,0,0,1,1,0.0,0.0
cancelar,www.mediafax.ro,0,0,3,3,0.0,0.0
Julia Klöckner,www.mediafax.ro,0,0,1,1,0.0,0.0
Andrei Niculae,www.euronews.ro,0,0,1,1,0.0,0.0
Simina Tulbure,www.euronews.ro,0,0,1,1,0.0,0.0
Stefan Lofven,www.aktual24.ro,1,0,0,1,1.0,1.0
aparator,www.aktual24.ro,1,2,2,5,-0.2,0.2
Hubert Thuma,www.comisarul.ro,0,0,2,2,0.0,0.0
ai,www.activenews.ro,0,2,0,2,-1.0,1.0
Coldea,www.activenews.ro,0,3,0,3,-1.0,1.0
Manfred Weber,www.activenews.ro,0,1,0,1,-1.0,1.0
Plicușor Ban,www.activenews.ro,0,1,0,1,-1.0,1.0
Turnător,www.activenews.ro,0,1,0,1,-1.0,1.0
afacerist,www.activenews.ro,0,1,0,1,-1.0,1.0
Clotilde,www.activenews.ro,0,1,0,1,-1.0,1.0
cineva,www.activenews.ro,0,1,0,1,-1.0,1.0
comisar,www.activenews.ro,0,4,0,4,-1.0,1.0
dezvoltator,www.activenews.ro,0,1,0,1,-1.0,1.0
Weber,www.activenews.ro,0,1,0,1,-1.0,1.0
finanțator,www.activenews.ro,0,1,0,1,-1.0,1.0
neofit,www.activenews.ro,0,1,0,1,-1.0,1.0
penal,www.activenews.ro,0,1,0,1,-1.0,1.0
sponsor,www.activenews.ro,0,1,0,1,-1.0,1.0
coleg,www.gandul.ro,7,5,20,32,0.0625,0.0625
competitor,www.gandul.ro,0,2,0,2,-1.0,1.0
controlor,www.gandul.ro,0,1,0,1,-1.0,1.0
Corneliu Bjola,agerpres.ro,0,0,1,1,0.0,0.0
Iulian Fota,agerpres.ro,0,0,1,1,0.0,0.0
Valentin Naumescu,agerpres.ro,0,0,1,1,0.0,0.0
consilier,agerpres.ro,1,5,10,16,-0.25,0.25
Petru Mîndru,www.realitatea.net,0,0,1,1,0.0,0.0
Bechet,stirileprotv.ro,0,0,1,1,0.0,0.0
Calafat,stirileprotv.ro,0,0,1,1,0.0,0.0
cetate,stirileprotv.ro,0,0,1,1,0.0,0.0
Deșa,stirileprotv.ro,0,0,1,1,0.0,0.0
Dinescu,stirileprotv.ro,0,1,0,1,-1.0,1.0
Doina Pană,stirileprotv.ro,0,0,1,1,0.0,0.0
Doinei Pană,stirileprotv.ro,0,1,0,1,-1.0,1.0
Gorj,stirileprotv.ro,0,0,2,2,0.0,0.0
Iancu de Hunedoara,stirileprotv.ro,1,0,0,1,1.0,1.0
Mahomed,stirileprotv.ro,1,0,0,1,1.0,1.0
P,stirileprotv.ro,0,1,0,1,-1.0,1.0
Piscu,stirileprotv.ro,0,0,1,1,0.0,0.0
Piscu Vechi,stirileprotv.ro,0,0,1,1,0.0,0.0
părinte,stirileprotv.ro,1,1,1,3,0.0,0.0
Robert,stirileprotv.ro,0,0,1,1,0.0,0.0
Robert Turcescu,stirileprotv.ro,0,0,1,1,0.0,0.0
Serb,stirileprotv.ro,0,2,2,4,-0.5,0.5
Teleorman,stirileprotv.ro,0,0,3,3,0.0,0.0
Turcescu,stirileprotv.ro,0,0,1,1,0.0,0.0
internaut,stirileprotv.ro,0,1,0,1,-1.0,1.0
jandarm,stirileprotv.ro,0,2,0,2,-1.0,1.0
specialist,stirileprotv.ro,1,0,0,1,1.0,1.0
Activisti,www.aktual24.ro,0,0,1,1,0.0,0.0
internaut,www.aktual24.ro,0,1,0,1,-1.0,1.0
martor,www.aktual24.ro,0,0,1,1,0.0,0.0
trecător,www.aktual24.ro,0,1,0,1,-1.0,1.0
licean,www.digi24.ro,0,0,2,2,0.0,0.0
școlar,www.digi24.ro,0,0,1,1,0.0,0.0
Cristian Valentin Stoica,snoop.ro,0,0,3,3,0.0,0.0
Stoica,snoop.ro,0,4,4,8,-0.5,0.5
Gabriela Iacobici,snoop.ro,0,0,4,4,0.0,0.0
Gheorghe Stoica,snoop.ro,0,3,2,5,-0.6,0.6
Grădina,snoop.ro,0,1,1,2,-0.5,0.5
Urleta,snoop.ro,0,0,3,3,0.0,0.0
bugetar,snoop.ro,0,2,0,2,-1.0,1.0
Laura Codruța Kovesi,stirileprotv.ro,0,2,2,4,-0.5,0.5
peremist,www.aktual24.ro,1,0,2,3,0.3333333333333333,0.3333333333333333
Lia Olguta Vasilescu,www.aktual24.ro,1,0,2,3,0.3333333333333333,0.3333333333333333
Lucian Braniște,www.g4media.ro,0,0,1,1,0.0,0.0
aliat,adevarul.ro,1,0,4,5,0.2,0.2
Galați,www.realitatea.net,0,0,1,1,0.0,0.0
participanț,www.realitatea.net,0,0,1,1,0.0,0.0
victimă,www.realitatea.net,0,0,2,2,0.0,0.0
Adrian Nastase,www.luju.ro,0,0,1,1,0.0,0.0
Cristian Winzer,www.luju.ro,1,0,2,3,0.3333333333333333,0.3333333333333333
baron,www.luju.ro,0,1,0,1,-1.0,1.0
combinator,www.luju.ro,0,1,0,1,-1.0,1.0
demnitar,www.luju.ro,0,2,0,2,-1.0,1.0
electorat,www.luju.ro,0,1,0,1,-1.0,1.0
intelectual,www.luju.ro,1,0,0,1,1.0,1.0
nicusor,www.luju.ro,0,1,0,1,-1.0,1.0
tânăr,www.luju.ro,3,1,1,5,0.4,0.4
toți,www.luju.ro,0,1,1,2,-0.5,0.5
Albă ca Zăpada,www.mediafax.ro,0,1,0,1,-1.0,1.0
Bănicioiu,www.mediafax.ro,0,0,2,2,0.0,0.0
Caragiale,www.mediafax.ro,0,0,1,1,0.0,0.0
Hrebe,www.mediafax.ro,0,0,1,1,0.0,0.0
Liviu,www.mediafax.ro,0,0,1,1,0.0,0.0
Petre Pitiș,www.mediafax.ro,0,0,1,1,0.0,0.0
Sadoveanu,www.mediafax.ro,0,1,0,1,-1.0,1.0
Sibiu,www.mediafax.ro,0,0,3,3,0.0,0.0
Teleorman,www.mediafax.ro,0,0,1,1,0.0,0.0
bătrână,www.mediafax.ro,0,0,1,1,0.0,0.0
domn,www.mediafax.ro,0,1,1,2,-0.5,0.5
dumnealui,www.mediafax.ro,0,2,0,2,-1.0,1.0
dvs,www.mediafax.ro,0,1,1,2,-0.5,0.5
ia,www.mediafax.ro,0,1,0,1,-1.0,1.0
individ,www.mediafax.ro,0,1,0,1,-1.0,1.0
infractor,www.mediafax.ro,0,4,0,4,-1.0,1.0
interpuși,www.mediafax.ro,0,1,0,1,-1.0,1.0
localnic,www.mediafax.ro,0,0,1,1,0.0,0.0
martor,www.mediafax.ro,0,0,2,2,0.0,0.0
personaj,www.mediafax.ro,0,3,0,3,-1.0,1.0
proprietarii,www.mediafax.ro,0,1,0,1,-1.0,1.0
puciște,www.mediafax.ro,0,1,0,1,-1.0,1.0
tip,www.mediafax.ro,0,1,0,1,-1.0,1.0
Ștefan Dragnea,www.mediafax.ro,0,0,1,1,0.0,0.0
țăran,www.mediafax.ro,0,1,0,1,-1.0,1.0
Bologna,pressone.ro,0,0,1,1,0.0,0.0
Cătălin Ștefănescu,pressone.ro,0,0,2,2,0.0,0.0
Domnul Dunca,pressone.ro,0,0,1,1,0.0,0.0
Dunca,pressone.ro,0,2,1,3,-0.6666666666666666,0.6666666666666666
Fata,pressone.ro,0,0,2,2,0.0,0.0
Federica Mogherini,pressone.ro,1,0,1,2,0.5,0.5
Franco,pressone.ro,0,1,0,1,-1.0,1.0
Ghana,pressone.ro,1,0,0,1,1.0,1.0
Gheorghe Ialomițianu,pressone.ro,0,0,1,1,0.0,0.0
Ioan Mareș,pressone.ro,0,0,1,1,0.0,0.0
Iran,pressone.ro,1,0,1,2,0.5,0.5
Mara Mareș,pressone.ro,0,0,3,3,0.0,0.0
Mareș,pressone.ro,0,0,3,3,0.0,0.0
Margaret Thatcher,pressone.ro,1,0,0,1,1.0,1.0
Marius Dunca,pressone.ro,0,1,2,3,-0.3333333333333333,0.3333333333333333
Nicola Sturgeon,pressone.ro,0,0,1,1,0.0,0.0
Radu F. Alexandru,pressone.ro,0,0,1,1,0.0,0.0
dâns,pressone.ro,0,1,0,1,-1.0,1.0
mentor,pressone.ro,1,0,3,4,0.25,0.25
orator,pressone.ro,0,1,0,1,-1.0,1.0
roșcată,pressone.ro,0,1,0,1,-1.0,1.0
toți,pressone.ro,0,1,0,1,-1.0,1.0
șatenă,pressone.ro,0,1,0,1,-1.0,1.0
Andrusceac,adevarul.ro,0,1,0,1,-1.0,1.0
Antonio Andrusceac,adevarul.ro,0,2,0,2,-1.0,1.0
fată,adevarul.ro,1,2,1,4,-0.25,0.25
Mocofan,adevarul.ro,0,1,0,1,-1.0,1.0
Sibiu,adevarul.ro,0,0,8,8,0.0,0.0
prăpădit,adevarul.ro,0,1,0,1,-1.0,1.0
sărac,adevarul.ro,0,1,0,1,-1.0,1.0
trimis,www.digi24.ro,0,0,4,4,0.0,0.0
Antinoro,adevarul.ro,0,1,0,1,-1.0,1.0
Antonello Antinoro,adevarul.ro,0,0,1,1,0.0,0.0
director general,adevarul.ro,0,0,4,4,0.0,0.0
Colorado,adevarul.ro,0,0,1,1,0.0,0.0
George Bush,adevarul.ro,0,1,0,1,-1.0,1.0
George W. Bush,adevarul.ro,0,1,0,1,-1.0,1.0
Mary F. Wieseman,adevarul.ro,0,0,1,1,0.0,0.0
Niels Schnecker,adevarul.ro,1,1,0,2,0.0,0.0
Reagan,adevarul.ro,0,0,1,1,0.0,0.0
Ronald Reagan,adevarul.ro,0,0,1,1,0.0,0.0
Rudolph Giuliani,adevarul.ro,0,1,0,1,-1.0,1.0
Schencker,adevarul.ro,0,0,1,1,0.0,0.0
Schnecker,adevarul.ro,0,1,0,1,-1.0,1.0
absolvent,adevarul.ro,1,3,2,6,-0.3333333333333333,0.3333333333333333
Tony Robinson,adevarul.ro,0,1,0,1,-1.0,1.0
pilot,adevarul.ro,1,0,0,1,1.0,1.0
sponsor,adevarul.ro,0,1,3,4,-0.25,0.25
student,adevarul.ro,0,4,4,8,-0.5,0.5
gazetar,www.realitatea.net,0,1,0,1,-1.0,1.0
Ion Cristoiu,www.realitatea.net,0,0,1,1,0.0,0.0
general,www.news.ro,1,2,0,3,-0.3333333333333333,0.3333333333333333
Andrada Cilibiu,adevarul.ro,0,2,0,2,-1.0,1.0
căpitan,adevarul.ro,0,0,1,1,0.0,0.0
reprezentantă,adevarul.ro,0,2,1,3,-0.6666666666666666,0.6666666666666666
Sergiu Covaci,adevarul.ro,0,1,0,1,-1.0,1.0
staș,adevarul.ro,0,1,0,1,-1.0,1.0
URSS,adevarul.ro,0,2,1,3,-0.6666666666666666,0.6666666666666666
adept,adevarul.ro,0,4,0,4,-1.0,1.0
salvator,adevarul.ro,0,2,1,3,-0.6666666666666666,0.6666666666666666
Oana Crețu,adevarul.ro,0,0,4,4,0.0,0.0
Drăgan Gelu,adevarul.ro,0,0,3,3,0.0,0.0
Filip Constantin-Titian,adevarul.ro,0,0,2,2,0.0,0.0
Cristian Pîrvulescu,www.g4media.ro,0,0,3,3,0.0,0.0
Pîrvulescu,www.g4media.ro,0,0,2,2,0.0,0.0
Bacău,www.g4media.ro,0,0,4,4,0.0,0.0
Cristina Breahnă Pravăț,www.g4media.ro,0,0,2,2,0.0,0.0
Daniel Juravle,www.g4media.ro,0,0,1,1,0.0,0.0
Gelu Mărgină,www.g4media.ro,0,0,2,2,0.0,0.0
Iași,www.g4media.ro,2,0,4,6,0.3333333333333333,0.3333333333333333
Liviu Miroșeanu,www.g4media.ro,0,1,0,1,-1.0,1.0
Marian Mina,www.g4media.ro,0,0,1,1,0.0,0.0
Roxana Necula,www.g4media.ro,0,0,1,1,0.0,0.0
Roșca,www.g4media.ro,0,0,1,1,0.0,0.0
Suceava,www.g4media.ro,0,0,7,7,0.0,0.0
Vasile Isvoran,www.g4media.ro,0,0,2,2,0.0,0.0
Mircea Roșca,www.g4media.ro,0,0,1,1,0.0,0.0
Daniel Soare,www.g4media.ro,0,0,1,1,0.0,0.0
Vlad Călin Dumitrescu Ferentz,www.g4media.ro,0,0,1,1,0.0,0.0
Gheorghe Șoldan,www.g4media.ro,0,0,1,1,0.0,0.0
Virgil Nanu,www.g4media.ro,0,0,1,1,0.0,0.0
vice,www.g4media.ro,0,0,1,1,0.0,0.0
Alexandru Bălănescu,recorder.ro,0,0,1,1,0.0,0.0
Aleș,recorder.ro,0,1,0,1,-1.0,1.0
Andreea Cosma,recorder.ro,0,0,1,1,0.0,0.0
Andrei Călin Matei,recorder.ro,0,0,1,1,0.0,0.0
Andrei Pop,recorder.ro,0,0,1,1,0.0,0.0
Argeș,recorder.ro,1,0,4,5,0.2,0.2
Aurel Căciulă,recorder.ro,2,0,1,3,0.6666666666666666,0.6666666666666666
Cornel Itu,recorder.ro,0,0,1,1,0.0,0.0
Cătălin,recorder.ro,0,1,0,1,-1.0,1.0
Cătălin Rădulescu,recorder.ro,0,1,0,1,-1.0,1.0
Daniela Oteșanu,recorder.ro,0,1,0,1,-1.0,1.0
Eugen Neață,recorder.ro,0,1,0,1,-1.0,1.0
Iuliu Nosa,recorder.ro,0,0,1,1,0.0,0.0
Laura Mihaela Moagher,recorder.ro,0,0,1,1,0.0,0.0
Liviu Pleșoianu,recorder.ro,0,0,1,1,0.0,0.0
Lucian Simion,recorder.ro,0,0,1,1,0.0,0.0
Matei Suciu,recorder.ro,0,0,1,1,0.0,0.0
Mihăiță Vîrză,recorder.ro,0,0,1,1,0.0,0.0
Nicolae Georgescu,recorder.ro,0,0,1,1,0.0,0.0
Nicușor Halici,recorder.ro,0,1,1,2,-0.5,0.5
Radu Babuș,recorder.ro,0,0,1,1,0.0,0.0
Radu Vasilică,recorder.ro,0,0,1,1,0.0,0.0
Rodica Paraschiv,recorder.ro,0,0,2,2,0.0,0.0
Rădulescu,recorder.ro,0,3,0,3,-1.0,1.0
Silviu Macovei,recorder.ro,0,0,1,1,0.0,0.0
Spînu Ion,recorder.ro,0,0,1,1,0.0,0.0
Sălaj,recorder.ro,0,0,4,4,0.0,0.0
Toma Ilie,recorder.ro,0,0,1,1,0.0,0.0
Vasile Cocoș,recorder.ro,0,1,0,1,-1.0,1.0
Vlad Bontea,recorder.ro,0,1,0,1,-1.0,1.0
curcile,recorder.ro,0,1,0,1,-1.0,1.0
semnatar,recorder.ro,1,1,1,3,0.0,0.0
Ștefan Ovidiu Popa,recorder.ro,0,0,1,1,0.0,0.0
Mureș,agerpres.ro,0,0,1,1,0.0,0.0
român,agerpres.ro,2,0,1,3,0.6666666666666666,0.6666666666666666
Radu Hanga,www.euronews.ro,0,0,1,1,0.0,0.0
Călin Badiu,www.digi24.ro,0,1,0,1,-1.0,1.0
Mihai Goțiu,www.digi24.ro,0,2,1,3,-0.6666666666666666,0.6666666666666666
Octavian Berceanu,www.digi24.ro,0,0,1,1,0.0,0.0
Carp,www.comisarul.ro,0,0,1,1,0.0,0.0
Radu Carp,www.comisarul.ro,0,2,1,3,-0.6666666666666666,0.6666666666666666
politolog,www.comisarul.ro,0,1,3,4,-0.25,0.25
Ceaușescu,adevarul.ro,0,1,0,1,-1.0,1.0
Cosmin Popa,adevarul.ro,0,0,3,3,0.0,0.0
Europa Unită,adevarul.ro,0,0,1,1,0.0,0.0
Iorga,adevarul.ro,0,0,1,1,0.0,0.0
Nicolae Ceaușescu,adevarul.ro,1,2,1,4,-0.25,0.25
Popa,adevarul.ro,0,1,1,2,-0.5,0.5
Bill Clinton,adevarul.ro,0,0,1,1,0.0,0.0
anturaj,adevarul.ro,0,1,0,1,-1.0,1.0
popoare,adevarul.ro,0,0,1,1,0.0,0.0
Andrei Caramitru,www.gandul.ro,0,0,1,1,0.0,0.0
Băse,www.gandul.ro,0,1,0,1,-1.0,1.0
Caramitru,www.gandul.ro,0,0,1,1,0.0,0.0
Ion Caramitru,www.gandul.ro,0,0,1,1,0.0,0.0
Karl Nehammer,www.gandul.ro,0,1,2,3,-0.3333333333333333,0.3333333333333333
MC,www.gandul.ro,1,0,0,1,1.0,1.0
favorit,www.gandul.ro,0,0,1,1,0.0,0.0
mame,www.gandul.ro,0,0,1,1,0.0,0.0
om politic,www.gandul.ro,0,2,0,2,-1.0,1.0
player,www.gandul.ro,1,0,0,1,1.0,1.0
Robert Turcescu,www.digi24.ro,0,0,3,3,0.0,0.0
vicepremier,www.digi24.ro,0,2,2,4,-0.5,0.5
victima,www.digi24.ro,0,2,0,2,-1.0,1.0
DPO,www.activenews.ro,0,0,1,1,0.0,0.0
Ligia Deca,www.activenews.ro,0,1,1,2,-0.5,0.5
elev,www.activenews.ro,0,9,3,12,-0.75,0.75
Ionel Rusei,www.activenews.ro,0,0,1,1,0.0,0.0
părinte,www.activenews.ro,6,7,10,23,-0.043478260869565216,0.043478260869565216
român,www.activenews.ro,0,0,3,3,0.0,0.0
Reprezentant legal,www.activenews.ro,0,0,2,2,0.0,0.0
Tutorele,www.activenews.ro,0,0,1,1,0.0,0.0
actorii,www.activenews.ro,0,0,1,1,0.0,0.0
asistent social,www.activenews.ro,0,0,1,1,0.0,0.0
autor,www.activenews.ro,0,4,4,8,-0.5,0.5
beneficiar,www.activenews.ro,0,2,4,6,-0.3333333333333333,0.3333333333333333
comerciant,www.activenews.ro,0,0,2,2,0.0,0.0
consumator,www.activenews.ro,0,1,3,4,-0.25,0.25
custode,www.activenews.ro,0,1,0,1,-1.0,1.0
intermediar,www.activenews.ro,0,1,0,1,-1.0,1.0
nedidactic,www.activenews.ro,0,1,0,1,-1.0,1.0
nimănui,www.activenews.ro,0,1,0,1,-1.0,1.0
operator,www.activenews.ro,0,1,0,1,-1.0,1.0
personal,www.activenews.ro,0,2,3,5,-0.4,0.4
personal didactic,www.activenews.ro,0,0,2,2,0.0,0.0
personalului administrativ,www.activenews.ro,0,0,1,1,0.0,0.0
posesor,www.activenews.ro,0,0,1,1,0.0,0.0
profesor,www.activenews.ro,0,2,2,4,-0.5,0.5
psiholog,www.activenews.ro,0,1,0,1,-1.0,1.0
reprezentant legal,www.activenews.ro,0,2,0,2,-1.0,1.0
reprezentanți,www.activenews.ro,0,1,0,1,-1.0,1.0
respondent,www.activenews.ro,0,1,2,3,-0.3333333333333333,0.3333333333333333
salariaț,www.activenews.ro,0,1,2,3,-0.3333333333333333,0.3333333333333333
solocitant,www.activenews.ro,0,1,0,1,-1.0,1.0
supraveghetor,www.activenews.ro,0,0,1,1,0.0,0.0
tutore,www.activenews.ro,0,0,1,1,0.0,0.0
tutorel,www.activenews.ro,0,1,0,1,-1.0,1.0
tutor,www.activenews.ro,0,1,2,3,-0.3333333333333333,0.3333333333333333
Târgu Mureș,www.gandul.ro,0,0,1,1,0.0,0.0
arși,www.gandul.ro,0,1,0,1,-1.0,1.0
Adrian Moraru,www.digi24.ro,0,0,1,1,0.0,0.0
Belgia,www.digi24.ro,0,0,1,1,0.0,0.0
ales,www.digi24.ro,0,6,0,6,-1.0,1.0
Bodean,www.luju.ro,0,1,0,1,-1.0,1.0
Iliuta,www.luju.ro,0,0,1,1,0.0,0.0
Vasile Iliuta,www.luju.ro,0,1,0,1,-1.0,1.0
colaborator,www.luju.ro,0,3,6,9,-0.3333333333333333,0.3333333333333333
contestatar,www.luju.ro,0,1,0,1,-1.0,1.0
cunostință,www.luju.ro,0,1,0,1,-1.0,1.0
parat,www.luju.ro,0,2,1,3,-0.6666666666666666,0.6666666666666666
paratul,www.luju.ro,0,1,0,1,-1.0,1.0
prieteni,www.luju.ro,1,1,1,3,0.0,0.0
Andrei Bodean,www.luju.ro,0,1,0,1,-1.0,1.0
rudă,www.luju.ro,0,1,1,2,-0.5,0.5
subsemnat,www.luju.ro,0,1,5,6,-0.16666666666666666,0.16666666666666666
Adășeni,www.romaniatv.net,0,0,1,1,0.0,0.0
Alțina,www.romaniatv.net,0,0,1,1,0.0,0.0
Avrămeni,www.romaniatv.net,0,0,1,1,0.0,0.0
Balinț,www.romaniatv.net,0,0,1,1,0.0,0.0
Balotești,www.romaniatv.net,0,0,1,1,0.0,0.0
Bara,www.romaniatv.net,0,0,1,1,0.0,0.0
Belinț,www.romaniatv.net,0,0,1,1,0.0,0.0
Bethausen,www.romaniatv.net,0,0,1,1,0.0,0.0
Botoroaga,www.romaniatv.net,0,0,1,1,0.0,0.0
Botoșani,www.romaniatv.net,0,0,2,2,0.0,0.0
Brestovăț,www.romaniatv.net,0,0,1,1,0.0,0.0
Brezoaele,www.romaniatv.net,0,0,1,1,0.0,0.0
Broscăuți,www.romaniatv.net,0,0,1,1,0.0,0.0
Brăești,www.romaniatv.net,0,0,1,1,0.0,0.0
Buftea,www.romaniatv.net,0,0,1,1,0.0,0.0
Bujoreni,www.romaniatv.net,0,0,1,1,0.0,0.0
Bujoru,www.romaniatv.net,0,0,1,1,0.0,0.0
Bulbucata,www.romaniatv.net,0,0,1,1,0.0,0.0
Buturugeni,www.romaniatv.net,0,0,1,1,0.0,0.0
Bârghiș,www.romaniatv.net,0,0,1,1,0.0,0.0
Bălcăuți,www.romaniatv.net,0,0,1,1,0.0,0.0
Băneasa,www.romaniatv.net,0,0,1,1,0.0,0.0
Băuțar,www.romaniatv.net,0,1,0,1,-1.0,1.0
Calafindești,www.romaniatv.net,0,0,1,1,0.0,0.0
Cervenia,www.romaniatv.net,0,0,1,1,0.0,0.0
Ciocănești,www.romaniatv.net,0,0,1,1,0.0,0.0
Ciorogârla,www.romaniatv.net,0,0,1,1,0.0,0.0
Cisnădie,www.romaniatv.net,0,0,1,1,0.0,0.0
Clinceni,www.romaniatv.net,0,0,1,1,0.0,0.0
Colibași,www.romaniatv.net,0,0,1,1,0.0,0.0
Comana,www.romaniatv.net,0,0,2,2,0.0,0.0
Concești,www.romaniatv.net,0,0,1,1,0.0,0.0
Constantin Daicoviciu,www.romaniatv.net,0,0,1,1,0.0,0.0
Conțești,www.romaniatv.net,0,0,1,1,0.0,0.0
Copăceni,www.romaniatv.net,0,0,1,1,0.0,0.0
Corbeanca,www.romaniatv.net,0,0,1,1,0.0,0.0
Cordăreni,www.romaniatv.net,0,0,1,1,0.0,0.0
Corlăteni,www.romaniatv.net,0,0,1,1,0.0,0.0
Cornetu,www.romaniatv.net,0,0,1,1,0.0,0.0
Cosoba,www.romaniatv.net,0,0,1,1,0.0,0.0
Coșteiu,www.romaniatv.net,0,0,1,1,0.0,0.0
Coțușca,www.romaniatv.net,0,0,1,1,0.0,0.0
Crevedia,www.romaniatv.net,0,0,1,1,0.0,0.0
Crevenicu,www.romaniatv.net,0,0,1,1,0.0,0.0
Cristian,www.romaniatv.net,0,0,1,1,0.0,0.0
Cristinești,www.romaniatv.net,0,0,1,1,0.0,0.0
Cândești,www.romaniatv.net,0,0,1,1,0.0,0.0
Călugăreni,www.romaniatv.net,0,0,1,1,0.0,0.0
Daia,www.romaniatv.net,0,0,1,1,0.0,0.0
Darabani,www.romaniatv.net,0,0,1,1,0.0,0.0
Decembrie,www.romaniatv.net,0,0,1,1,0.0,0.0
Dersca,www.romaniatv.net,0,0,1,1,0.0,0.0
Dimăcheni,www.romaniatv.net,0,0,1,1,0.0,0.0
Domnești,www.romaniatv.net,0,0,1,1,0.0,0.0
Dorohoi,www.romaniatv.net,0,0,1,1,0.0,0.0
Drăgușeni,www.romaniatv.net,0,0,1,1,0.0,0.0
Dâmbovița,www.romaniatv.net,0,0,4,4,0.0,0.0
Dărmănești,www.romaniatv.net,0,0,1,1,0.0,0.0
Florești,www.romaniatv.net,0,0,1,1,0.0,0.0
frumoasă,www.romaniatv.net,0,0,1,1,0.0,0.0
Frătești,www.romaniatv.net,0,0,1,1,0.0,0.0
George Enescu,www.romaniatv.net,0,0,1,1,0.0,0.0
Ghimpați,www.romaniatv.net,0,0,1,1,0.0,0.0
Ghizela,www.romaniatv.net,0,0,1,1,0.0,0.0
Giurgiu,www.romaniatv.net,0,0,3,3,0.0,0.0
Glimboca,www.romaniatv.net,0,0,1,1,0.0,0.0
Gogoșari,www.romaniatv.net,0,0,1,1,0.0,0.0
Gostinari,www.romaniatv.net,0,0,1,1,0.0,0.0
Gostinu,www.romaniatv.net,0,0,1,1,0.0,0.0
Greaca,www.romaniatv.net,0,0,1,1,0.0,0.0
Grămești,www.romaniatv.net,0,0,1,1,0.0,0.0
Găujani,www.romaniatv.net,0,0,1,1,0.0,0.0
Havârna,www.romaniatv.net,0,0,1,1,0.0,0.0
Herăști,www.romaniatv.net,0,0,1,1,0.0,0.0
hotare,www.romaniatv.net,0,0,1,1,0.0,0.0
Hudești,www.romaniatv.net,0,0,1,1,0.0,0.0
Ibănești,www.romaniatv.net,0,0,1,1,0.0,0.0
Iepurești,www.romaniatv.net,0,0,1,1,0.0,0.0
Isvoarele,www.romaniatv.net,0,0,1,1,0.0,0.0
Izvoarele,www.romaniatv.net,0,0,1,1,0.0,0.0
Joița,www.romaniatv.net,0,0,1,1,0.0,0.0
Leorda,www.romaniatv.net,0,0,1,1,0.0,0.0
Letca Nouă,www.romaniatv.net,0,0,1,1,0.0,0.0
Loamneș,www.romaniatv.net,0,0,1,1,0.0,0.0
Lozna,www.romaniatv.net,0,0,1,1,0.0,0.0
Malu,www.romaniatv.net,0,0,1,1,0.0,0.0
Marga,www.romaniatv.net,0,0,1,1,0.0,0.0
Marpod,www.romaniatv.net,0,0,1,1,0.0,0.0
Mereni,www.romaniatv.net,0,0,1,1,0.0,0.0
Mihai Bravu,www.romaniatv.net,0,0,1,1,0.0,0.0
Mihăileni,www.romaniatv.net,0,0,1,1,0.0,0.0
Mihăilești,www.romaniatv.net,0,0,1,1,0.0,0.0
Mileanca,www.romaniatv.net,0,0,1,1,0.0,0.0
Mitoc,www.romaniatv.net,0,0,1,1,0.0,0.0
Mogoșoaia,www.romaniatv.net,0,0,1,1,0.0,0.0
Moșteni,www.romaniatv.net,0,0,1,1,0.0,0.0
Mușenița,www.romaniatv.net,0,0,1,1,0.0,0.0
Mârzănești,www.romaniatv.net,0,0,1,1,0.0,0.0
Nicșeni,www.romaniatv.net,0,0,1,1,0.0,0.0
Nocrich,www.romaniatv.net,0,0,1,1,0.0,0.0
Obreja,www.romaniatv.net,0,0,1,1,0.0,0.0
Ocna Sibiului,www.romaniatv.net,0,0,1,1,0.0,0.0
Ogrezeni,www.romaniatv.net,0,0,1,1,0.0,0.0
Oinacu,www.romaniatv.net,0,0,1,1,0.0,0.0
Otopeni,www.romaniatv.net,0,0,1,1,0.0,0.0
Oțelu Roșu,www.romaniatv.net,0,0,1,1,0.0,0.0
Pietroșani,www.romaniatv.net,0,0,1,1,0.0,0.0
Pomârla,www.romaniatv.net,0,0,1,1,0.0,0.0
Prundu,www.romaniatv.net,0,0,1,1,0.0,0.0
Putineiu,www.romaniatv.net,0,0,1,1,0.0,0.0
Păltiniș,www.romaniatv.net,0,0,1,1,0.0,0.0
Recaș,www.romaniatv.net,0,0,1,1,0.0,0.0
Roma,www.romaniatv.net,0,0,3,3,0.0,0.0
Roșia,www.romaniatv.net,0,0,1,1,0.0,0.0
Rusca Montană,www.romaniatv.net,0,0,1,1,0.0,0.0
Răsmirești,www.romaniatv.net,0,0,1,1,0.0,0.0
Răsuceni,www.romaniatv.net,0,0,1,1,0.0,0.0
Schitu,www.romaniatv.net,0,0,1,1,0.0,0.0
Secaș,www.romaniatv.net,0,0,1,1,0.0,0.0
Singureni,www.romaniatv.net,0,0,1,1,0.0,0.0
Siret,www.romaniatv.net,0,0,1,1,0.0,0.0
Slimnic,www.romaniatv.net,0,0,1,1,0.0,0.0
Slobozia,www.romaniatv.net,0,0,1,1,0.0,0.0
Slobozia Moară,www.romaniatv.net,0,0,1,1,0.0,0.0
Stoenești,www.romaniatv.net,0,0,1,1,0.0,0.0
Stănești,www.romaniatv.net,0,0,1,1,0.0,0.0
Suceava,www.romaniatv.net,0,0,4,4,0.0,0.0
Suharău,www.romaniatv.net,0,0,1,1,0.0,0.0
Săbăreni,www.romaniatv.net,0,0,1,1,0.0,0.0
Săliște,www.romaniatv.net,0,0,1,1,0.0,0.0
Săveni,www.romaniatv.net,0,0,1,1,0.0,0.0
Teleorman,www.romaniatv.net,0,0,4,4,0.0,0.0
Topolovățu Mare,www.romaniatv.net,0,0,1,1,0.0,0.0
Toporu,www.romaniatv.net,0,0,1,1,0.0,0.0
Turnu Ruieni,www.romaniatv.net,0,0,1,1,0.0,0.0
Tărtășești,www.romaniatv.net,0,0,1,1,0.0,0.0
Ulmi,www.romaniatv.net,0,0,1,1,0.0,0.0
Ungureni,www.romaniatv.net,0,0,1,1,0.0,0.0
Valea Dragului,www.romaniatv.net,0,0,1,1,0.0,0.0
Vedea,www.romaniatv.net,0,0,1,1,0.0,0.0
Videle,www.romaniatv.net,0,0,1,1,0.0,0.0
Vidra,www.romaniatv.net,0,0,1,1,0.0,0.0
Viișoara,www.romaniatv.net,0,0,1,1,0.0,0.0
Vitănești,www.romaniatv.net,0,0,1,1,0.0,0.0
Vorniceni,www.romaniatv.net,0,0,1,1,0.0,0.0
Vurpăr,www.romaniatv.net,0,0,1,1,0.0,0.0
Vârfu Câmpului,www.romaniatv.net,0,0,1,1,0.0,0.0
Văculești,www.romaniatv.net,0,0,1,1,0.0,0.0
Vărăști,www.romaniatv.net,0,0,1,1,0.0,0.0
Zamostea,www.romaniatv.net,0,0,1,1,0.0,0.0
Zvoriștea,www.romaniatv.net,0,0,1,1,0.0,0.0
Zăvoi,www.romaniatv.net,0,0,1,1,0.0,0.0
Șeica Mare,www.romaniatv.net,0,0,1,1,0.0,0.0
Șelimbăr,www.romaniatv.net,0,0,1,1,0.0,0.0
Șendriceni,www.romaniatv.net,0,0,1,1,0.0,0.0
Știubieni,www.romaniatv.net,0,0,1,1,0.0,0.0
Ștorobăneasa,www.romaniatv.net,0,0,1,1,0.0,0.0
Șura Mare,www.romaniatv.net,0,0,1,1,0.0,0.0
Șura Mică,www.romaniatv.net,0,0,1,1,0.0,0.0
Beijing,primanews.ro,0,0,1,1,0.0,0.0
China,primanews.ro,0,0,1,1,0.0,0.0
Kush Desai,primanews.ro,0,0,1,1,0.0,0.0
Scott Bessent,primanews.ro,0,0,1,1,0.0,0.0
secretar,primanews.ro,0,0,5,5,0.0,0.0
Adrian,www.luju.ro,0,0,1,1,0.0,0.0
Paul Valentin Armașu,www.luju.ro,0,2,0,2,-1.0,1.0
Caras Severin,www.luju.ro,0,0,3,3,0.0,0.0
Costin Moraru,www.luju.ro,0,0,1,1,0.0,0.0
Dana,www.luju.ro,0,0,1,1,0.0,0.0
Daniela Florea,www.luju.ro,0,0,2,2,0.0,0.0
denunțător,www.luju.ro,0,3,1,4,-0.75,0.75
Dolcu,www.luju.ro,0,2,0,2,-1.0,1.0
Florea Daniela,www.luju.ro,0,0,3,3,0.0,0.0
inculpată,www.luju.ro,0,0,1,1,0.0,0.0
Jivan,www.luju.ro,0,0,1,1,0.0,0.0
Luminița Jivan,www.luju.ro,1,0,2,3,0.3333333333333333,0.3333333333333333
Jivan Luminița,www.luju.ro,0,1,2,3,-0.3333333333333333,0.3333333333333333
Lucian Dolcu,www.luju.ro,0,3,1,4,-0.75,0.75
Luminita,www.luju.ro,0,0,1,1,0.0,0.0
Luminitei Jivan,www.luju.ro,0,0,2,2,0.0,0.0
Martin,www.luju.ro,0,0,1,1,0.0,0.0
martor,www.luju.ro,0,2,8,10,-0.2,0.2
Torma Adrian Constantin,www.luju.ro,0,0,8,8,0.0,0.0
Moldova Nouă,www.luju.ro,0,1,3,4,-0.25,0.25
Nemes,www.luju.ro,0,0,1,1,0.0,0.0
Noua,www.luju.ro,0,0,1,1,0.0,0.0
oraș,www.luju.ro,0,0,1,1,0.0,0.0
Resita,www.luju.ro,0,0,1,1,0.0,0.0
Torma Constantin Adrian,www.luju.ro,0,1,6,7,-0.14285714285714285,0.14285714285714285
administrator,www.luju.ro,2,1,2,5,0.2,0.2
Paul Armasu,www.luju.ro,0,1,0,1,-1.0,1.0
ambii,www.luju.ro,0,1,0,1,-1.0,1.0
Nicușor Maldea,www.luju.ro,0,0,3,3,0.0,0.0
avocatul Maldea,www.luju.ro,0,0,1,1,0.0,0.0
complici,www.luju.ro,0,0,1,1,0.0,0.0
denuntător,www.luju.ro,0,0,1,1,0.0,0.0
Adrian Constantin Torma,www.luju.ro,0,0,1,1,0.0,0.0
Ion Ghildeanu,www.luju.ro,0,0,1,1,0.0,0.0
grefă,www.luju.ro,0,1,0,1,-1.0,1.0
Jivan Luminița Maria,www.luju.ro,0,2,3,5,-0.4,0.4
Jivan Luminita,www.luju.ro,0,1,1,2,-0.5,0.5
Armasu Paul Valentin,www.luju.ro,0,0,2,2,0.0,0.0
Popescu,www.luju.ro,0,1,0,1,-1.0,1.0
Ioan Popescu,www.luju.ro,0,0,3,3,0.0,0.0
martor denuntător,www.luju.ro,0,0,2,2,0.0,0.0
numit,www.luju.ro,0,0,4,4,0.0,0.0
reprezentantilor,www.luju.ro,0,2,2,4,-0.5,0.5
Frankfurt,adevarul.ro,0,0,2,2,0.0,0.0
Gelu Duminică,adevarul.ro,0,0,10,10,0.0,0.0
Belgia,a1.ro,0,0,3,3,0.0,0.0
cabinet,a1.ro,0,1,0,1,-1.0,1.0
Corina Dumitrescu,a1.ro,0,0,1,1,0.0,0.0
Dan Suciu,a1.ro,0,0,1,1,0.0,0.0
doctor,a1.ro,0,0,4,4,0.0,0.0
Napoca,a1.ro,0,0,1,1,0.0,0.0
Porto Roz,a1.ro,0,0,1,1,0.0,0.0
Rodicai Stanoiu,a1.ro,0,0,1,1,0.0,0.0
Slovenia,a1.ro,0,0,1,1,0.0,0.0
Laura Codruța Kövesi,stirileprotv.ro,0,0,2,2,0.0,0.0
agent,stirileprotv.ro,0,1,0,1,-1.0,1.0
slugă,stirileprotv.ro,0,1,0,1,-1.0,1.0
Codrin Ștefănescu,www.romaniatv.net,0,0,1,1,0.0,0.0
Costel,www.romaniatv.net,0,0,1,1,0.0,0.0
Dan Puric,www.romaniatv.net,0,0,2,2,0.0,0.0
Dan Tănasă,www.romaniatv.net,0,0,2,2,0.0,0.0
Gheorghe Piperea,www.romaniatv.net,0,1,2,3,-0.3333333333333333,0.3333333333333333
Liviu Dragnea,www.romaniatv.net,0,4,2,6,-0.6666666666666666,0.6666666666666666
blogger,www.romaniatv.net,0,0,1,1,0.0,0.0
membru militant,www.romaniatv.net,0,0,1,1,0.0,0.0
secretar general adjunct,www.romaniatv.net,0,1,0,1,-1.0,1.0
traseist,www.romaniatv.net,0,2,0,2,-1.0,1.0
Andrei Colțea,pressone.ro,0,0,1,1,0.0,0.0
Cezara Panait,pressone.ro,0,0,1,1,0.0,0.0
Ciprian Ciucu,pressone.ro,0,0,1,1,0.0,0.0
Cătălin Drulă,pressone.ro,0,0,4,4,0.0,0.0
Martinei Orlea,pressone.ro,0,0,1,1,0.0,0.0
Mihai Viteazul,pressone.ro,0,0,5,5,0.0,0.0
consultant,pressone.ro,0,2,11,13,-0.15384615384615385,0.15384615384615385
publicitar,pressone.ro,0,1,0,1,-1.0,1.0
Agent șef,www.comisarul.ro,1,0,0,1,1.0,1.0
cunoscut,www.comisarul.ro,0,1,0,1,-1.0,1.0
Galați,www.comisarul.ro,0,0,2,2,0.0,0.0
Ionel Ciucă,www.comisarul.ro,0,1,0,1,-1.0,1.0
Turcu Valentin Ioan,www.comisarul.ro,1,0,0,1,1.0,1.0
Târgu Bujor,www.comisarul.ro,0,0,1,1,0.0,0.0
clopotar,www.comisarul.ro,0,1,0,1,-1.0,1.0
clopotar violator,www.comisarul.ro,0,1,0,1,-1.0,1.0
fată,www.comisarul.ro,0,1,3,4,-0.25,0.25
nepot,www.comisarul.ro,0,3,0,3,-1.0,1.0
nepoată,www.comisarul.ro,0,1,0,1,-1.0,1.0
suveranist,www.comisarul.ro,0,2,1,3,-0.6666666666666666,0.6666666666666666
unchi,www.comisarul.ro,0,2,0,2,-1.0,1.0
Andrei Muraru,www.news.ro,2,1,1,4,0.25,0.25
Biden,www.news.ro,0,1,0,1,-1.0,1.0
Liviu Dragnea,www.news.ro,0,4,1,5,-0.8,0.8
Marea Britanie,www.news.ro,0,0,4,4,0.0,0.0
diplomat,www.news.ro,0,2,3,5,-0.4,0.4
Ciucă,www.news.ro,0,10,8,18,-0.5555555555555556,0.5555555555555556
Hurezeanu,www.news.ro,1,0,0,1,1.0,1.0
domnul Muraru,www.news.ro,0,0,1,1,0.0,0.0
Dan Hurezeanu,www.news.ro,0,1,0,1,-1.0,1.0
Domnul Hurezeanu,www.news.ro,0,0,1,1,0.0,0.0
ospătar,www.news.ro,0,1,0,1,-1.0,1.0
Mircea Coșea,www.b1tv.ro,0,0,2,2,0.0,0.0
alegător,www.b1tv.ro,1,2,4,7,-0.14285714285714285,0.14285714285714285
intervievat,www.b1tv.ro,0,0,1,1,0.0,0.0
profesor,www.b1tv.ro,0,4,1,5,-0.8,0.8
profesorul Coșea,www.b1tv.ro,0,0,1,1,0.0,0.0
Claudiu Muresan,www.aktual24.ro,0,0,1,1,0.0,0.0
Darius Valcov,www.aktual24.ro,0,1,0,1,-1.0,1.0
Gabriel Oprea,www.aktual24.ro,0,1,1,2,-0.5,0.5
Lavinia Sandru,www.aktual24.ro,0,0,2,2,0.0,0.0
Mureș,www.aktual24.ro,0,0,1,1,0.0,0.0
Slatina,www.aktual24.ro,0,1,1,2,-0.5,0.5
absolvent,www.aktual24.ro,1,0,2,3,0.3333333333333333,0.3333333333333333
coordonator,www.aktual24.ro,0,0,3,3,0.0,0.0
Lavinia Șandru,www.aktual24.ro,0,1,0,1,-1.0,1.0
Adela Ioana Târziu,www.comisarul.ro,0,0,1,1,0.0,0.0
Adela Ioana Târziu Grăjdeanu,www.comisarul.ro,0,0,1,1,0.0,0.0
Adela Grăjdeanu,www.comisarul.ro,0,0,1,1,0.0,0.0
Garoafa,www.comisarul.ro,0,0,1,1,0.0,0.0
Petrică Negrea,www.comisarul.ro,0,0,1,1,0.0,0.0
Vrancea,www.comisarul.ro,0,0,1,1,0.0,0.0
George Badiu,www.comisarul.ro,0,0,1,1,0.0,0.0
fin,www.comisarul.ro,0,1,0,1,-1.0,1.0
Măndica Badiu,www.comisarul.ro,0,1,1,2,-0.5,0.5
naș,www.comisarul.ro,0,1,0,1,-1.0,1.0
rudă,www.comisarul.ro,0,2,1,3,-0.6666666666666666,0.6666666666666666
comunicator,www.cotidianul.ro,0,1,0,1,-1.0,1.0
liberal,www.cotidianul.ro,1,4,0,5,-0.6,0.6
donator,www.mediafax.ro,0,0,1,1,0.0,0.0
Corneliu Zelea Codreanu,observatornews.ro,0,1,0,1,-1.0,1.0
Daniel Fenechiu,observatornews.ro,0,0,8,8,0.0,0.0
Mihaela Ciochină,observatornews.ro,0,1,0,1,-1.0,1.0
Robert Cazanciuc,observatornews.ro,0,0,1,1,0.0,0.0
Iuliana Scântei,observatornews.ro,0,1,0,1,-1.0,1.0
Adrian Zuckerman,adevarul.ro,0,0,2,2,0.0,0.0
Zuckerman,adevarul.ro,0,0,2,2,0.0,0.0
Anna Luhrmann,observatornews.ro,0,0,1,1,0.0,0.0
Cristian,observatornews.ro,0,0,1,1,0.0,0.0
Federația Rusă,observatornews.ro,0,6,0,6,-1.0,1.0
Germania,observatornews.ro,0,0,7,7,0.0,0.0
Steinmeier,observatornews.ro,0,0,1,1,0.0,0.0
Primar General,www.gandul.ro,0,0,1,1,0.0,0.0
Damian Butnariu,observatornews.ro,0,1,0,1,-1.0,1.0
Iași,observatornews.ro,0,0,3,3,0.0,0.0
Mogoșești,observatornews.ro,0,0,1,1,0.0,0.0
Romeo Vatră,observatornews.ro,0,0,1,1,0.0,0.0
Siret,observatornews.ro,0,0,1,1,0.0,0.0
elev,observatornews.ro,0,0,1,1,0.0,0.0
proxenet,observatornews.ro,0,2,0,2,-1.0,1.0
beneficiar,www.cotidianul.ro,0,2,0,2,-1.0,1.0
Bihor,www.cotidianul.ro,1,1,0,2,0.0,0.0
capitală,www.cotidianul.ro,1,1,3,5,0.0,0.0
Coldea,www.cotidianul.ro,0,3,0,3,-1.0,1.0
Mănăstire,www.cotidianul.ro,0,2,1,3,-0.6666666666666666,0.6666666666666666
Florin Birta,www.cotidianul.ro,0,1,1,2,-0.5,0.5
Ilie,www.cotidianul.ro,1,0,1,2,0.5,0.5
mulți,www.cotidianul.ro,0,1,0,1,-1.0,1.0
Nea,www.cotidianul.ro,0,1,0,1,-1.0,1.0
noi,www.cotidianul.ro,1,0,0,1,1.0,1.0
Predoiu,www.cotidianul.ro,0,1,2,3,-0.3333333333333333,0.3333333333333333
Silviu Mănăstire,www.cotidianul.ro,0,2,0,2,-1.0,1.0
Vadu,www.cotidianul.ro,0,1,0,1,-1.0,1.0
bihorean,www.cotidianul.ro,0,0,1,1,0.0,0.0
dansator,www.cotidianul.ro,0,0,2,2,0.0,0.0
Micula,www.cotidianul.ro,0,1,0,1,-1.0,1.0
lepră,www.cotidianul.ro,0,1,0,1,-1.0,1.0
oportunist,www.cotidianul.ro,0,1,0,1,-1.0,1.0
ortac,www.cotidianul.ro,0,1,0,1,-1.0,1.0
prim-vicepreședinte,www.cotidianul.ro,0,1,0,1,-1.0,1.0
părtaș,www.cotidianul.ro,0,1,0,1,-1.0,1.0
sclav,www.cotidianul.ro,0,1,0,1,-1.0,1.0
Anton Pisaroglu,www.mediafax.ro,0,0,1,1,0.0,0.0
Florică Ică Calotă,adevarul.ro,0,0,1,1,0.0,0.0
Teleorman,adevarul.ro,0,0,2,2,0.0,0.0
plămantar,adevarul.ro,0,1,0,1,-1.0,1.0
suveran,observatornews.ro,0,2,0,2,-1.0,1.0
Șoșoacă,observatornews.ro,0,1,1,2,-0.5,0.5
Argeș,www.comisarul.ro,0,0,3,3,0.0,0.0
Gheorghe Badea,www.comisarul.ro,0,0,1,1,0.0,0.0
Mihai Coteț,www.comisarul.ro,0,0,2,2,0.0,0.0
Remus Pricopie,www.romaniatv.net,0,0,1,1,0.0,0.0
Andrei Pleșu,www.euronews.ro,0,0,2,2,0.0,0.0
filosof,www.euronews.ro,0,0,1,1,0.0,0.0
Pleșu,www.euronews.ro,0,0,1,1,0.0,0.0
credincios,www.euronews.ro,0,1,1,2,-0.5,0.5
doctorand,www.euronews.ro,0,1,1,2,-0.5,0.5
student,www.euronews.ro,0,0,1,1,0.0,0.0
Arnault,a1.ro,0,0,1,1,0.0,0.0
Bernard Arnault,a1.ro,0,1,1,2,-0.5,0.5
Elon Musk,a1.ro,0,0,1,1,0.0,0.0
Jeff Bezos,a1.ro,0,0,2,2,0.0,0.0
Mark Zuckerberg,a1.ro,0,3,0,3,-1.0,1.0
Musk,a1.ro,0,0,1,1,0.0,0.0
Prințul Paul,a1.ro,0,2,2,4,-0.5,0.5
Taiwan,a1.ro,0,0,1,1,0.0,0.0
vânzător,a1.ro,0,1,1,2,-0.5,0.5
cumpărător,a1.ro,0,2,0,2,-1.0,1.0
magnat,a1.ro,0,1,0,1,-1.0,1.0
miliardar,a1.ro,0,2,1,3,-0.6666666666666666,0.6666666666666666
producător,a1.ro,0,0,1,1,0.0,0.0
proprietar,a1.ro,0,1,0,1,-1.0,1.0
Cosmin Corendea,adevarul.ro,0,0,1,1,0.0,0.0
Ramona Ioana Bruynseels,adevarul.ro,0,0,3,3,0.0,0.0
Tennessee,adevarul.ro,0,0,1,1,0.0,0.0
Kelemen,adevarul.ro,0,0,1,1,0.0,0.0
Alexandru Stănescu,adevarul.ro,0,0,1,1,0.0,0.0
Benea,adevarul.ro,0,2,0,2,-1.0,1.0
Dragoș Benea,adevarul.ro,0,0,3,3,0.0,0.0
Florin Roman,adevarul.ro,2,2,2,6,0.0,0.0
Paul Stănescu,adevarul.ro,0,0,3,3,0.0,0.0
frate,adevarul.ro,2,4,7,13,-0.15384615384615385,0.15384615384615385
Ionuț Stroe,www.g4media.ro,0,0,1,1,0.0,0.0
Stroe,www.g4media.ro,0,0,1,1,0.0,0.0
doamnă,www.g4media.ro,0,0,2,2,0.0,0.0
Berlin,www.cotidianul.ro,0,1,1,2,-0.5,0.5
Ion Iliescu,www.cotidianul.ro,0,1,1,2,-0.5,0.5
guvernant,www.cotidianul.ro,0,1,0,1,-1.0,1.0
locuitor,www.cotidianul.ro,1,0,2,3,0.3333333333333333,0.3333333333333333
proiectant,www.cotidianul.ro,0,1,0,1,-1.0,1.0
proletariat,www.cotidianul.ro,0,1,0,1,-1.0,1.0
părinte,www.cotidianul.ro,1,0,1,2,0.5,0.5
Vaslui,www.comisarul.ro,0,2,1,3,-0.6666666666666666,0.6666666666666666
Leontin Cupar,agerpres.ro,0,0,1,1,0.0,0.0
Pintér Zsolt,agerpres.ro,0,0,1,1,0.0,0.0
artist,agerpres.ro,0,0,1,1,0.0,0.0
Ana Ciolan,snoop.ro,0,0,1,1,0.0,0.0
Andreea,snoop.ro,0,0,2,2,0.0,0.0
Andrei Bușe,snoop.ro,0,0,2,2,0.0,0.0
Bușe,snoop.ro,0,0,1,1,0.0,0.0
Claudia Voicu,snoop.ro,0,0,1,1,0.0,0.0
Dorina,snoop.ro,0,0,1,1,0.0,0.0
Elena Pop,snoop.ro,0,0,1,1,0.0,0.0
Eusebiu,snoop.ro,0,0,1,1,0.0,0.0
Florin Gherasim,snoop.ro,0,0,1,1,0.0,0.0
Ionescu,snoop.ro,0,1,3,4,-0.25,0.25
Ivan,snoop.ro,0,0,1,1,0.0,0.0
Victor Ilie,snoop.ro,0,0,4,4,0.0,0.0
Luiza Vasiliu,snoop.ro,0,0,1,1,0.0,0.0
Mariana,snoop.ro,0,0,2,2,0.0,0.0
Niculae,snoop.ro,0,0,1,1,0.0,0.0
Petre,snoop.ro,0,0,2,2,0.0,0.0
Petrescu,snoop.ro,0,0,1,1,0.0,0.0
Recorder,snoop.ro,0,0,1,1,0.0,0.0
Vasile,snoop.ro,0,0,2,2,0.0,0.0
boți,snoop.ro,0,1,0,1,-1.0,1.0
programator,snoop.ro,0,1,6,7,-0.14285714285714285,0.14285714285714285
robot,snoop.ro,0,0,1,1,0.0,0.0
Brazilia,www.digi24.ro,0,0,1,1,0.0,0.0
Daniel Vodă,recorder.ro,0,0,1,1,0.0,0.0
Macron,recorder.ro,0,2,1,3,-0.6666666666666666,0.6666666666666666
Maia Sandu,recorder.ro,1,1,1,3,0.0,0.0
Sinaia,recorder.ro,0,3,3,6,-0.5,0.5
Vlad Oprea,recorder.ro,0,2,1,3,-0.6666666666666666,0.6666666666666666
activist,recorder.ro,1,7,1,9,-0.6666666666666666,0.6666666666666666
Anghel,www.g4media.ro,0,0,1,1,0.0,0.0
Dan Puric,www.g4media.ro,0,1,2,3,-0.3333333333333333,0.3333333333333333
Daniel Fenechiu,www.g4media.ro,0,0,1,1,0.0,0.0
Florin Anghel,www.g4media.ro,0,0,3,3,0.0,0.0
Ioan Stanomir,www.g4media.ro,0,0,5,5,0.0,0.0
Japonia,www.g4media.ro,0,1,0,1,-1.0,1.0
Kremlin,www.g4media.ro,0,1,0,1,-1.0,1.0
Radu Ioanid,www.g4media.ro,0,3,0,3,-1.0,1.0
Silvestru,www.g4media.ro,0,0,1,1,0.0,0.0
Tucker Carlson,www.g4media.ro,0,1,0,1,-1.0,1.0
autoare,www.g4media.ro,0,1,0,1,-1.0,1.0
cadru medical,www.g4media.ro,0,1,0,1,-1.0,1.0
criminal,www.g4media.ro,0,4,0,4,-1.0,1.0
critic literar,www.g4media.ro,0,0,1,1,0.0,0.0
dictator,www.g4media.ro,0,2,0,2,-1.0,1.0
extremist,www.g4media.ro,0,5,0,5,-1.0,1.0
filozof,www.g4media.ro,0,0,1,1,0.0,0.0
lor,www.g4media.ro,0,1,0,1,-1.0,1.0
politolog,www.g4media.ro,0,0,2,2,0.0,0.0
simpatizant,www.g4media.ro,0,7,4,11,-0.6363636363636364,0.6363636363636364
Dan Petre,adevarul.ro,0,0,6,6,0.0,0.0
Grindeanu,adevarul.ro,0,1,2,3,-0.3333333333333333,0.3333333333333333
Raluca Turcan,adevarul.ro,0,0,2,2,0.0,0.0
Regele Ferdinand,adevarul.ro,0,0,1,1,0.0,0.0
Regina Maria,adevarul.ro,0,0,1,1,0.0,0.0
Sociologul Bogdan Bucur,adevarul.ro,0,0,1,1,0.0,0.0
Barcelona,www.gandul.ro,0,0,1,1,0.0,0.0
fiică,www.gandul.ro,0,1,4,5,-0.2,0.2
Lucian Romașcanu,www.gandul.ro,0,2,3,5,-0.4,0.4
Romașcanu,www.gandul.ro,0,1,3,4,-0.25,0.25
Spania,www.gandul.ro,0,1,3,4,-0.25,0.25
las,www.gandul.ro,0,1,0,1,-1.0,1.0
nepot,www.gandul.ro,0,1,1,2,-0.5,0.5
Bogdan Oprea,www.digi24.ro,0,0,1,1,0.0,0.0
Joseph Biden,www.digi24.ro,0,0,1,1,0.0,0.0
Robert Sighiartău,adevarul.ro,0,0,1,1,0.0,0.0
Sighiartău,adevarul.ro,0,0,1,1,0.0,0.0
apărător,adevarul.ro,0,1,1,2,-0.5,0.5
luptător,adevarul.ro,3,0,1,4,0.75,0.75
Raed Arafat,a1.ro,0,0,1,1,0.0,0.0
subsecretar,a1.ro,0,0,1,1,0.0,0.0
Amalia Bellantoni,observatornews.ro,0,0,1,1,0.0,0.0
greblă,observatornews.ro,0,0,1,1,0.0,0.0
Toni Greblă,observatornews.ro,0,0,1,1,0.0,0.0
prezidențiabil,www.romaniatv.net,0,0,1,1,0.0,0.0
Dacian Cioloș,www.b1tv.ro,0,1,1,2,-0.5,0.5
Ion Iliescu,www.b1tv.ro,0,0,1,1,0.0,0.0
Avram Marius Gal,www.g4media.ro,0,1,0,1,-1.0,1.0
Câmpia Turzii,www.g4media.ro,0,0,1,1,0.0,0.0
Turda,www.g4media.ro,0,0,1,1,0.0,0.0
consilier parlamentar,www.g4media.ro,0,1,0,1,-1.0,1.0
Augustin Zegrean,adevarul.ro,0,0,1,1,0.0,0.0
Cristi Danileț,adevarul.ro,0,1,3,4,-0.25,0.25
Claudiu Năsui,agerpres.ro,0,2,0,2,-1.0,1.0
Ghigiu,agerpres.ro,0,1,0,1,-1.0,1.0
Năsui,agerpres.ro,0,2,0,2,-1.0,1.0
Sorana,www.g4media.ro,0,0,1,1,0.0,0.0
Sorana Cîrstea,www.g4media.ro,0,0,1,1,0.0,0.0
Soranei,www.g4media.ro,0,0,1,1,0.0,0.0
Adrian Ivan,recorder.ro,0,0,1,1,0.0,0.0
Maria Nistor,recorder.ro,0,1,0,1,-1.0,1.0
Topârceanu,recorder.ro,0,0,1,1,0.0,0.0
mulți,www.comisarul.ro,0,1,0,1,-1.0,1.0
instigator,www.comisarul.ro,0,1,0,1,-1.0,1.0
participanț,www.comisarul.ro,0,0,2,2,0.0,0.0
reporter,www.comisarul.ro,0,3,6,9,-0.3333333333333333,0.3333333333333333
trădător,www.comisarul.ro,0,3,0,3,-1.0,1.0
Magdin,adevarul.ro,0,0,2,2,0.0,0.0
aliat,www.b1tv.ro,0,0,1,1,0.0,0.0
aliaț,www.b1tv.ro,1,0,0,1,1.0,1.0
vecin,www.b1tv.ro,0,2,0,2,-1.0,1.0
Avrămuță,pressone.ro,0,0,1,1,0.0,0.0
Bădău,pressone.ro,0,0,1,1,0.0,0.0
Cezar Avrămuță,pressone.ro,0,0,1,1,0.0,0.0
Chelaru,pressone.ro,0,1,1,2,-0.5,0.5
Cojocaru,pressone.ro,0,1,0,1,-1.0,1.0
Colceag,pressone.ro,0,0,1,1,0.0,0.0
Constantin Cojocaru,pressone.ro,0,2,1,3,-0.6666666666666666,0.6666666666666666
Corneliu Tudor,pressone.ro,0,1,4,5,-0.2,0.2
Crăciun,pressone.ro,0,0,2,2,0.0,0.0
Epilog,pressone.ro,0,0,1,1,0.0,0.0
Frank Sinatra,pressone.ro,0,0,1,1,0.0,0.0
Horea Mihai Bădău,pressone.ro,0,0,3,3,0.0,0.0
Laurențiu Rebega,pressone.ro,0,0,2,2,0.0,0.0
Legea Cojocaru,pressone.ro,0,1,0,1,-1.0,1.0
Ludovic De Danne,pressone.ro,0,0,1,1,0.0,0.0
Ma,pressone.ro,0,0,1,1,0.0,0.0
Marian Munteanu,pressone.ro,0,0,1,1,0.0,0.0
Mircea Găinușă,pressone.ro,0,0,1,1,0.0,0.0
moderator,pressone.ro,0,4,4,8,-0.5,0.5
Molinari,pressone.ro,0,0,1,1,0.0,0.0
Okamura,pressone.ro,0,0,1,1,0.0,0.0
Radomir Bălăneanu,pressone.ro,0,0,1,1,0.0,0.0
Radu Enache,pressone.ro,1,0,0,1,1.0,1.0
Rebega,pressone.ro,0,0,1,1,0.0,0.0
Sinaia,pressone.ro,0,0,1,1,0.0,0.0
Sinatra,pressone.ro,0,0,1,1,0.0,0.0
Take Ionescu,pressone.ro,0,0,1,1,0.0,0.0
Zamfirescu,pressone.ro,0,1,0,1,-1.0,1.0
Victor Crăciun,pressone.ro,0,0,1,1,0.0,0.0
Florin Zamfirescu,pressone.ro,0,0,1,1,0.0,0.0
antevorbitor,pressone.ro,0,2,0,2,-1.0,1.0
antrenor,pressone.ro,1,1,2,4,0.0,0.0
Daniel Croitoru,pressone.ro,1,0,0,1,1.0,1.0
euroaleș,pressone.ro,0,0,1,1,0.0,0.0
gazdă,pressone.ro,0,1,0,1,-1.0,1.0
Mircea Chelaru,pressone.ro,0,0,1,1,0.0,0.0
invitat,pressone.ro,1,4,5,10,-0.3,0.3
Florian Colceag,pressone.ro,1,0,0,1,1.0,1.0
milițian,pressone.ro,0,1,0,1,-1.0,1.0
oaspete,pressone.ro,0,1,0,1,-1.0,1.0
stegar,pressone.ro,0,1,0,1,-1.0,1.0
vedetă,pressone.ro,0,0,2,2,0.0,0.0
O,www.activenews.ro,0,0,1,1,0.0,0.0
Oameni,www.activenews.ro,0,0,1,1,0.0,0.0
Toți,www.activenews.ro,0,0,1,1,0.0,0.0
cititor,www.activenews.ro,3,3,3,9,0.0,0.0
apostol,www.activenews.ro,1,0,1,2,0.5,0.5
Athos,www.activenews.ro,0,0,1,1,0.0,0.0
creștin ortodox,www.activenews.ro,0,1,0,1,-1.0,1.0
Doamne,www.activenews.ro,1,0,0,1,1.0,1.0
duh,www.activenews.ro,2,0,0,2,1.0,1.0
Duhul Sfânt,www.activenews.ro,2,0,0,2,1.0,1.0
Fecioara Maria,www.activenews.ro,1,0,0,1,1.0,1.0
fiu,www.activenews.ro,0,4,5,9,-0.4444444444444444,0.4444444444444444
Iisus,www.activenews.ro,1,0,0,1,1.0,1.0
Iisus Mare Arhiereu,www.activenews.ro,1,0,0,1,1.0,1.0
Maica,www.activenews.ro,1,0,0,1,1.0,1.0
Pimen Vlad,www.activenews.ro,1,0,2,3,0.3333333333333333,0.3333333333333333
Stareț,www.activenews.ro,0,1,0,1,-1.0,1.0
stăpân,www.activenews.ro,1,3,0,4,-0.5,0.5
Stăpâne Doamne,www.activenews.ro,1,0,0,1,1.0,1.0
tată,www.activenews.ro,1,5,0,6,-0.6666666666666666,0.6666666666666666
Teologos,www.activenews.ro,0,0,2,2,0.0,0.0
arhiereu,www.activenews.ro,1,0,1,2,0.5,0.5
cuvioș,www.activenews.ro,1,0,0,1,1.0,1.0
frate,www.activenews.ro,2,3,1,6,-0.16666666666666666,0.16666666666666666
ierarh,www.activenews.ro,0,2,0,2,-1.0,1.0
monah,www.activenews.ro,1,1,1,3,0.0,0.0
monahal,www.activenews.ro,0,0,1,1,0.0,0.0
mucenic,www.activenews.ro,0,0,1,1,0.0,0.0
Gheorghe Calciu,www.activenews.ro,1,0,0,1,1.0,1.0
Theologos,www.activenews.ro,1,0,0,1,1.0,1.0
rob,www.activenews.ro,0,1,0,1,-1.0,1.0
secerător,www.activenews.ro,1,0,0,1,1.0,1.0
vrăjmaș,www.activenews.ro,0,2,0,2,-1.0,1.0
împărat,www.activenews.ro,1,1,0,2,0.0,0.0
Ciprian Necula,www.realitatea.net,0,0,1,1,0.0,0.0
secretar general,www.realitatea.net,0,0,2,2,0.0,0.0
Bulgaria,observatornews.ro,0,0,7,7,0.0,0.0
omolog,observatornews.ro,0,0,2,2,0.0,0.0
înalt,observatornews.ro,0,0,1,1,0.0,0.0
Ramona Chiriac,recorder.ro,0,0,1,1,0.0,0.0
Tudose,recorder.ro,0,1,3,4,-0.25,0.25
Dan Șucu,agerpres.ro,0,0,1,1,0.0,0.0
Nicoleta Bănciulea,agerpres.ro,0,0,4,4,0.0,0.0
Andrei Marga,adevarul.ro,0,1,2,3,-0.3333333333333333,0.3333333333333333
Călin Chirita,adevarul.ro,0,1,1,2,-0.5,0.5
favorit,adevarul.ro,0,2,6,8,-0.25,0.25
Gabriela,adevarul.ro,0,0,1,1,0.0,0.0
Gabriela Radu,adevarul.ro,0,0,1,1,0.0,0.0
Laurentiu Dumitrascu,adevarul.ro,0,0,1,1,0.0,0.0
Silvia Petrovici,adevarul.ro,0,0,1,1,0.0,0.0
Vasile Lupu,adevarul.ro,0,1,2,3,-0.3333333333333333,0.3333333333333333
trezorier,adevarul.ro,0,0,1,1,0.0,0.0
Marius Dunca,www.antena3.ro,0,0,1,1,0.0,0.0
Niculae Bădălău,www.antena3.ro,0,1,0,1,-1.0,1.0
Anamaria Gavrilă,www.activenews.ro,0,1,1,2,-0.5,0.5
POT,www.activenews.ro,0,1,0,1,-1.0,1.0
jandarm,www.activenews.ro,0,1,1,2,-0.5,0.5
mascaț,www.activenews.ro,0,2,0,2,-1.0,1.0
Silviu Predoiu,www.activenews.ro,0,4,0,4,-1.0,1.0
securist,www.activenews.ro,0,4,0,4,-1.0,1.0
soldat,www.cotidianul.ro,0,0,2,2,0.0,0.0
Ilfov,www.gandul.ro,0,0,3,3,0.0,0.0
Marian Neacșu,www.gandul.ro,0,0,3,3,0.0,0.0
Robert Negoiță,www.gandul.ro,0,0,2,2,0.0,0.0
Viorica Dăncilă,www.gandul.ro,1,0,8,9,0.1111111111111111,0.1111111111111111
Aurelian Pavelescu,adevarul.ro,0,0,1,1,0.0,0.0
Cozmin Gusa,adevarul.ro,0,1,1,2,-0.5,0.5
Lavinia Sandru,adevarul.ro,0,0,1,1,0.0,0.0
Dumnezeu,www.b1tv.ro,1,0,0,1,1.0,1.0
bunică,www.b1tv.ro,1,0,0,1,1.0,1.0
femeie,www.b1tv.ro,1,0,1,2,0.5,0.5
român,www.b1tv.ro,1,0,0,1,1.0,1.0
Cristian Pârvulescu,observatornews.ro,0,0,4,4,0.0,0.0
Cătălin Predoiu,observatornews.ro,0,1,12,13,-0.07692307692307693,0.07692307692307693
Daniel Funeriu,observatornews.ro,0,0,1,1,0.0,0.0
Luminița Odobescu,observatornews.ro,0,0,1,1,0.0,0.0
Remus Cernea,observatornews.ro,0,0,1,1,0.0,0.0
titular,observatornews.ro,0,2,1,3,-0.6666666666666666,0.6666666666666666
Ștefan Pălărie,observatornews.ro,0,0,1,1,0.0,0.0
Batrina Doamnă,www.realitatea.net,0,1,0,1,-1.0,1.0
China,www.realitatea.net,0,1,1,2,-0.5,0.5
Macron,www.realitatea.net,0,2,1,3,-0.6666666666666666,0.6666666666666666
Mask,www.realitatea.net,0,1,0,1,-1.0,1.0
Meloni,www.realitatea.net,0,1,0,1,-1.0,1.0
a,www.realitatea.net,0,0,1,1,0.0,0.0
analist,www.realitatea.net,0,1,4,5,-0.2,0.2
cancelar,www.realitatea.net,1,0,0,1,1.0,1.0
Emmanuel Macron,www.realitatea.net,0,1,2,3,-0.3333333333333333,0.3333333333333333
secretar de stat,www.realitatea.net,0,1,0,1,-1.0,1.0
strateg,www.realitatea.net,1,1,0,2,0.0,0.0
Anca Boagiu,www.gandul.ro,0,1,1,2,-0.5,0.5
Băsescu,www.gandul.ro,0,6,2,8,-0.75,0.75
Elena Udrea,www.gandul.ro,0,1,2,3,-0.3333333333333333,0.3333333333333333
Sulfina Barbu,www.gandul.ro,0,1,1,2,-0.5,0.5
André Ventura,www.g4media.ro,0,0,2,2,0.0,0.0
Portugalia,www.g4media.ro,0,0,4,4,0.0,0.0
Emmanuel Macron,adevarul.ro,0,0,4,4,0.0,0.0
Jeddah,adevarul.ro,0,0,1,1,0.0,0.0
Kaja Kallas,adevarul.ro,0,0,1,1,0.0,0.0
Katarina Mathernova,adevarul.ro,0,0,1,1,0.0,0.0
Mathernova,adevarul.ro,0,0,1,1,0.0,0.0
Sankt Petersburg,adevarul.ro,0,0,2,2,0.0,0.0
Steve Witkoff,adevarul.ro,0,0,2,2,0.0,0.0
Sumî,adevarul.ro,0,1,1,2,-0.5,0.5
civil,adevarul.ro,0,0,2,2,0.0,0.0
emisar special,adevarul.ro,0,0,1,1,0.0,0.0
mort,adevarul.ro,0,3,0,3,-1.0,1.0
Înaltul Reprezentant,adevarul.ro,0,1,0,1,-1.0,1.0
Laura Bota,a1.ro,0,1,0,1,-1.0,1.0
Oprescu,a1.ro,0,0,2,2,0.0,0.0
Popescu,a1.ro,0,1,0,1,-1.0,1.0
Prigoana,a1.ro,0,2,0,2,-1.0,1.0
botă,a1.ro,0,1,0,1,-1.0,1.0
domnie,a1.ro,0,5,2,7,-0.7142857142857143,0.7142857142857143
gospodar,a1.ro,0,1,0,1,-1.0,1.0
vizionar,a1.ro,1,0,0,1,1.0,1.0
critic,www.g4media.ro,0,3,0,3,-1.0,1.0
turnător,www.g4media.ro,0,1,0,1,-1.0,1.0
Anca Panaite,www.romaniatv.net,0,0,1,1,0.0,0.0
Antonio Andrușceac,www.romaniatv.net,0,0,1,1,0.0,0.0
Cosmin Bărbălău,www.romaniatv.net,0,0,1,1,0.0,0.0
politică,www.romaniatv.net,0,1,1,2,-0.5,0.5
celorlalt,www.romaniatv.net,0,1,0,1,-1.0,1.0
ea,www.romaniatv.net,0,0,2,2,0.0,0.0
Atena,primanews.ro,0,0,1,1,0.0,0.0
Creta,primanews.ro,0,0,2,2,0.0,0.0
Dodecanez,primanews.ro,0,0,1,1,0.0,0.0
Egipt,primanews.ro,0,0,1,1,0.0,0.0
Grecia,primanews.ro,0,0,3,3,0.0,0.0
Kasos,primanews.ro,0,0,1,1,0.0,0.0
victima,primanews.ro,0,1,1,2,-0.5,0.5
Chișinău,adevarul.ro,1,2,4,7,-0.14285714285714285,0.14285714285714285
Lavinia,adevarul.ro,0,0,1,1,0.0,0.0
Bogdan Ionescu,adevarul.ro,0,0,2,2,0.0,0.0
Mugur Mihăescu,www.cotidianul.ro,0,1,0,1,-1.0,1.0
Republica Moldova,www.cotidianul.ro,0,2,2,4,-0.5,0.5
adversar,www.cotidianul.ro,0,4,0,4,-1.0,1.0
intelectual,www.cotidianul.ro,0,2,1,3,-0.6666666666666666,0.6666666666666666
nemulțumit,www.cotidianul.ro,0,1,0,1,-1.0,1.0
tânăr,www.cotidianul.ro,1,2,1,4,-0.25,0.25
șomer,www.cotidianul.ro,0,1,0,1,-1.0,1.0
Bacău,www.gandul.ro,0,0,5,5,0.0,0.0
Robert Negoiță,observatornews.ro,0,1,1,2,-0.5,0.5
Valeriu Turcan,observatornews.ro,0,0,8,8,0.0,0.0
primar general,observatornews.ro,0,2,0,2,-1.0,1.0
Camarad Iedu,pressone.ro,0,1,0,1,-1.0,1.0
Cosmin Ionescu,pressone.ro,0,1,0,1,-1.0,1.0
Gabriel Pasat,pressone.ro,0,0,1,1,0.0,0.0
Ionescu,pressone.ro,0,1,1,2,-0.5,0.5
Nichita,pressone.ro,0,1,0,1,-1.0,1.0
Nichita Popescu,pressone.ro,0,1,0,1,-1.0,1.0
Pasat,pressone.ro,0,1,0,1,-1.0,1.0
Piatra Neamț,pressone.ro,0,0,2,2,0.0,0.0
Popescu,pressone.ro,0,1,1,2,-0.5,0.5
Serghei Donică,pressone.ro,0,1,0,1,-1.0,1.0
Skvll,pressone.ro,0,1,0,1,-1.0,1.0
Tyler,pressone.ro,0,0,1,1,0.0,0.0
Ungheni,pressone.ro,0,0,1,1,0.0,0.0
aderent,pressone.ro,0,0,2,2,0.0,0.0
camaraz,pressone.ro,0,3,0,3,-1.0,1.0
inamic,pressone.ro,0,3,0,3,-1.0,1.0
legionar,pressone.ro,0,3,0,3,-1.0,1.0
locotenent,pressone.ro,0,2,0,2,-1.0,1.0
lucrător,pressone.ro,0,1,2,3,-0.3333333333333333,0.3333333333333333
neonazist,pressone.ro,0,2,0,2,-1.0,1.0
pedofil,pressone.ro,0,2,0,2,-1.0,1.0
puștan,pressone.ro,0,1,0,1,-1.0,1.0
recrut,pressone.ro,0,3,1,4,-0.75,0.75
sub,pressone.ro,0,0,1,1,0.0,0.0
veteran,pressone.ro,0,0,1,1,0.0,0.0
Gheorghe Simion,www.realitatea.net,0,0,2,2,0.0,0.0
Armand,www.digi24.ro,0,1,0,1,-1.0,1.0
Clotilde Armand,www.digi24.ro,0,0,3,3,0.0,0.0
Cristian Popescu Piedone,www.digi24.ro,0,0,1,1,0.0,0.0
Daniel Băluță,www.digi24.ro,0,0,1,1,0.0,0.0
Dumitrescu,www.digi24.ro,0,1,0,1,-1.0,1.0
Eugen Pîrvulescu,www.digi24.ro,0,1,0,1,-1.0,1.0
Firea,www.digi24.ro,0,1,1,2,-0.5,0.5
Flutur,www.digi24.ro,0,0,1,1,0.0,0.0
George Tuță,www.digi24.ro,0,0,1,1,0.0,0.0
Gheorghe Flutur,www.digi24.ro,0,0,2,2,0.0,0.0
Huși,www.digi24.ro,0,0,1,1,0.0,0.0
Iulian,www.digi24.ro,0,1,1,2,-0.5,0.5
Nelu Tătaru,www.digi24.ro,0,1,1,2,-0.5,0.5
Piedone,www.digi24.ro,0,1,0,1,-1.0,1.0
reprezentantă,www.digi24.ro,0,1,2,3,-0.3333333333333333,0.3333333333333333
sector,www.digi24.ro,0,1,1,2,-0.5,0.5
Teleorman,www.digi24.ro,0,1,0,1,-1.0,1.0
adjunct,www.digi24.ro,0,0,1,1,0.0,0.0
câștigător,www.digi24.ro,0,2,0,2,-1.0,1.0
pacient,www.digi24.ro,0,1,2,3,-0.3333333333333333,0.3333333333333333
pierzător,www.digi24.ro,0,1,0,1,-1.0,1.0
Amza Pelea,www.antena3.ro,0,0,1,1,0.0,0.0
Arad,www.antena3.ro,0,0,1,1,0.0,0.0
Dorin Cocoș,www.antena3.ro,0,0,1,1,0.0,0.0
Elena Udrea,www.antena3.ro,0,1,0,1,-1.0,1.0
Gheorghe Falcă,www.antena3.ro,0,0,1,1,0.0,0.0
Rareș Bogdan,www.antena3.ro,0,0,2,2,0.0,0.0
Pavel Abraham,www.antena3.ro,0,0,1,1,0.0,0.0
Mihai Viteazul,www.antena3.ro,0,0,2,2,0.0,0.0
Țara Bârsei,www.antena3.ro,0,0,1,1,0.0,0.0
analișt,adevarul.ro,0,3,3,6,-0.5,0.5
Brașov,www.romaniatv.net,0,0,4,4,0.0,0.0
Brăila,www.romaniatv.net,0,0,2,2,0.0,0.0
Constanța,www.romaniatv.net,0,0,6,6,0.0,0.0
Dolj,www.romaniatv.net,0,0,2,2,0.0,0.0
Emil Boc,www.romaniatv.net,0,0,3,3,0.0,0.0
Iași,www.romaniatv.net,0,0,3,3,0.0,0.0
Olguța Vasilescu,www.romaniatv.net,0,1,0,1,-1.0,1.0
Tudose,www.romaniatv.net,0,1,2,3,-0.3333333333333333,0.3333333333333333
Leocadia Gabrilescu,recorder.ro,0,0,1,1,0.0,0.0
Meleșcanu,recorder.ro,0,1,0,1,-1.0,1.0
Nancy,recorder.ro,0,1,0,1,-1.0,1.0
Ponta,recorder.ro,0,4,6,10,-0.4,0.4
Teodor Meleșcanu,recorder.ro,0,1,0,1,-1.0,1.0
traseist,recorder.ro,0,4,0,4,-1.0,1.0
Președintele României,www.realitatea.net,0,0,2,2,0.0,0.0
Ispas Paul,www.realitatea.net,0,0,1,1,0.0,0.0
Vanea Matei,www.realitatea.net,0,0,1,1,0.0,0.0
Constantin Vieriu,www.realitatea.net,0,0,1,1,0.0,0.0
edil,www.mediafax.ro,0,2,4,6,-0.3333333333333333,0.3333333333333333
America,www.romaniatv.net,1,0,2,3,0.3333333333333333,0.3333333333333333
Diana Baciuna,www.news.ro,0,0,1,1,0.0,0.0
Octavian Oprea,www.news.ro,0,0,1,1,0.0,0.0
Secretar General,www.news.ro,0,0,2,2,0.0,0.0
Silviu Feroiu,www.news.ro,0,0,1,1,0.0,0.0
Silviu Văduva,www.news.ro,0,0,1,1,0.0,0.0
Stelian Bujduveanu,www.news.ro,0,0,1,1,0.0,0.0
trezorier,www.news.ro,0,0,2,2,0.0,0.0
Valentin Ștefan,www.news.ro,0,0,2,2,0.0,0.0
Radu Moldovan,www.news.ro,0,0,1,1,0.0,0.0
Cristian Pârvulescu,adevarul.ro,0,0,1,1,0.0,0.0
Federația Rusă,adevarul.ro,0,5,1,6,-0.8333333333333334,0.8333333333333334
Grecia,stirileprotv.ro,0,1,1,2,-0.5,0.5
Muraru,stirileprotv.ro,0,0,1,1,0.0,0.0
Bogdan Aurescu,observatornews.ro,0,0,3,3,0.0,0.0
Bogdan Gheorghiu,observatornews.ro,0,0,1,1,0.0,0.0
Ciucă Dan Vîlceanu,observatornews.ro,0,0,1,1,0.0,0.0
Attila Cseke,observatornews.ro,0,0,4,4,0.0,0.0
Florin Roman,observatornews.ro,0,0,2,2,0.0,0.0
Hegedus Csilla,observatornews.ro,0,0,1,1,0.0,0.0
Hunor Kelemen,observatornews.ro,0,0,1,1,0.0,0.0
Lucian Bode,observatornews.ro,0,0,3,3,0.0,0.0
Mircea Fechet,observatornews.ro,0,0,3,3,0.0,0.0
Nelu Tătaru,observatornews.ro,0,1,2,3,-0.3333333333333333,0.3333333333333333
Novak Eduard,observatornews.ro,0,0,1,1,0.0,0.0
Raluca Turcan,observatornews.ro,0,0,8,8,0.0,0.0
Robert Sighiartău,observatornews.ro,0,0,2,2,0.0,0.0
Sorin Cîmpeanu,observatornews.ro,0,1,2,3,-0.3333333333333333,0.3333333333333333
Tanczos Barna,observatornews.ro,0,0,3,3,0.0,0.0
Virgil Popescu,observatornews.ro,0,0,2,2,0.0,0.0
Bogdan Ciuca,stirileprotv.ro,0,0,1,1,0.0,0.0
Ciuca,stirileprotv.ro,0,0,2,2,0.0,0.0
Martion Arpad,stirileprotv.ro,0,0,1,1,0.0,0.0
Mihaita Calimente,stirileprotv.ro,0,1,0,1,-1.0,1.0
regizor,stirileprotv.ro,0,0,1,1,0.0,0.0
Sorin Oprescu,stirileprotv.ro,0,0,2,2,0.0,0.0
artist,stirileprotv.ro,0,0,1,1,0.0,0.0
compozitor,stirileprotv.ro,0,0,1,1,0.0,0.0
fotograf,stirileprotv.ro,0,0,1,1,0.0,0.0
pictor,stirileprotv.ro,0,0,1,1,0.0,0.0
proprietar,stirileprotv.ro,0,1,0,1,-1.0,1.0
sportiv,stirileprotv.ro,0,0,1,1,0.0,0.0
tot,stirileprotv.ro,0,0,2,2,0.0,0.0
ziarist,stirileprotv.ro,0,0,1,1,0.0,0.0
Daniel Fenechiu,www.aktual24.ro,0,0,4,4,0.0,0.0
Gabriel Andronache,www.aktual24.ro,0,0,1,1,0.0,0.0
reprezentantilor,www.aktual24.ro,0,1,1,2,-0.5,0.5
Tomac,stirileprotv.ro,0,0,1,1,0.0,0.0
comisar,stirileprotv.ro,0,0,5,5,0.0,0.0
Cristian Hrițuc,pressone.ro,0,0,3,3,0.0,0.0
om politic,pressone.ro,0,9,0,9,-1.0,1.0
zeu,pressone.ro,0,0,1,1,0.0,0.0
Emil Constantinescu,adevarul.ro,1,4,5,10,-0.3,0.3
California,pressone.ro,0,0,2,2,0.0,0.0
Camorra,pressone.ro,0,1,0,1,-1.0,1.0
Eduard Martin,pressone.ro,0,3,2,5,-0.6,0.6
Dumitru Martin,pressone.ro,0,1,0,1,-1.0,1.0
Eduard Stelian Martin,pressone.ro,0,1,1,2,-0.5,0.5
Gheorghe Martin,pressone.ro,0,0,2,2,0.0,0.0
James Gandolfini,pressone.ro,0,0,1,1,0.0,0.0
Mamaia,pressone.ro,0,0,2,2,0.0,0.0
Martin,pressone.ro,0,3,0,3,-1.0,1.0
Mazăre,pressone.ro,0,0,1,1,0.0,0.0
Napoli,pressone.ro,0,0,1,1,0.0,0.0
prinț,pressone.ro,0,1,0,1,-1.0,1.0
Radu Mazăre,pressone.ro,0,2,3,5,-0.4,0.4
Roberto Saviano,pressone.ro,0,0,1,1,0.0,0.0
Saviano,pressone.ro,0,1,0,1,-1.0,1.0
sopran,pressone.ro,0,0,1,1,0.0,0.0
Tony Soprano,pressone.ro,0,0,1,1,0.0,0.0
Mircea Dobre,pressone.ro,0,0,1,1,0.0,0.0
recordman,pressone.ro,0,1,0,1,-1.0,1.0
unchi,pressone.ro,0,1,0,1,-1.0,1.0
olimpic,www.g4media.ro,2,0,1,3,0.6666666666666666,0.6666666666666666
Claudiu Maior,pressone.ro,0,1,1,2,-0.5,0.5
Csiki Csengele,pressone.ro,0,1,0,1,-1.0,1.0
Csiki Zsolt,pressone.ro,0,0,1,1,0.0,0.0
maior,pressone.ro,0,1,0,1,-1.0,1.0
Mark Christian Hermann,pressone.ro,0,0,1,1,0.0,0.0
Mark Hermann,pressone.ro,0,0,1,1,0.0,0.0
Peti,pressone.ro,0,1,0,1,-1.0,1.0
Peti Andrei,pressone.ro,0,2,1,3,-0.6666666666666666,0.6666666666666666
Sergiu Papuc,pressone.ro,0,1,0,1,-1.0,1.0
Someșan,pressone.ro,0,0,1,1,0.0,0.0
Dorin Florea,pressone.ro,0,1,1,2,-0.5,0.5
Ștefan Someșan,pressone.ro,0,0,1,1,0.0,0.0
Radu Moldova,www.aktual24.ro,0,0,1,1,0.0,0.0
Bistrița,www.aktual24.ro,0,0,1,1,0.0,0.0
Lucian Romascanu,www.aktual24.ro,0,0,10,10,0.0,0.0
Maramureș,www.aktual24.ro,0,0,2,2,0.0,0.0
Zetea,www.aktual24.ro,0,0,1,1,0.0,0.0
Constantin,www.antena3.ro,0,0,1,1,0.0,0.0
Daniel Constantin,www.antena3.ro,0,1,2,3,-0.3333333333333333,0.3333333333333333
Alfred Simonis,observatornews.ro,1,2,0,3,-0.3333333333333333,0.3333333333333333
Dacian Cioloș,observatornews.ro,0,1,2,3,-0.3333333333333333,0.3333333333333333
Kelemen Hunor,observatornews.ro,0,1,13,14,-0.07142857142857142,0.07142857142857142
Ludovic Orban,observatornews.ro,0,2,14,16,-0.125,0.125
Oana Morariu,observatornews.ro,0,0,1,1,0.0,0.0
ales,observatornews.ro,0,4,1,5,-0.8,0.8
Bogdan Teodorescu,www.antena3.ro,0,2,0,2,-1.0,1.0
domnie,www.antena3.ro,1,3,2,6,-0.3333333333333333,0.3333333333333333
Ciucă,www.antena3.ro,0,2,1,3,-0.6666666666666666,0.6666666666666666
domnul Geoană,www.antena3.ro,0,1,0,1,-1.0,1.0
inamic,www.antena3.ro,0,1,0,1,-1.0,1.0
Mihai Constantin,agerpres.ro,0,0,2,2,0.0,0.0
Papa Francisc,agerpres.ro,1,0,2,3,0.3333333333333333,0.3333333333333333
Roma,agerpres.ro,0,0,1,1,0.0,0.0
purtător de cuvânt,agerpres.ro,0,0,5,5,0.0,0.0
colaborator,www.b1tv.ro,0,2,1,3,-0.6666666666666666,0.6666666666666666
lucrător,www.b1tv.ro,0,0,2,2,0.0,0.0
Președintele,www.g4media.ro,0,0,3,3,0.0,0.0
Anisie,www.aktual24.ro,0,0,1,1,0.0,0.0
Bujduveanu,www.aktual24.ro,0,0,1,1,0.0,0.0
Cimpeanu,www.aktual24.ro,0,0,1,1,0.0,0.0
Cozma,www.aktual24.ro,0,0,1,1,0.0,0.0
Fechet,www.aktual24.ro,0,0,1,1,0.0,0.0
George Tuta,www.aktual24.ro,0,0,1,1,0.0,0.0
Motreanu,www.aktual24.ro,0,0,1,1,0.0,0.0
Sighiartau,www.aktual24.ro,0,0,2,2,0.0,0.0
Tise,www.aktual24.ro,0,0,1,1,0.0,0.0
Virgil Popescu,www.aktual24.ro,0,0,1,1,0.0,0.0
Antonescu,primanews.ro,0,0,4,4,0.0,0.0
funcționar parlamentar,www.cotidianul.ro,0,0,1,1,0.0,0.0
funcționar public,www.cotidianul.ro,0,1,0,1,-1.0,1.0
Beijingul,recorder.ro,0,1,4,5,-0.2,0.2
Botoșani,recorder.ro,1,3,4,8,-0.25,0.25
Chinei,recorder.ro,0,0,2,2,0.0,0.0
München,recorder.ro,0,0,1,1,0.0,0.0
Scoția,recorder.ro,0,0,1,1,0.0,0.0
Slovacia,recorder.ro,0,0,2,2,0.0,0.0
Xi Jinping,recorder.ro,0,0,3,3,0.0,0.0
Zelenski,recorder.ro,0,0,1,1,0.0,0.0
Dominic Fritz,stirileprotv.ro,0,0,6,6,0.0,0.0
Ionuț Mosteanu,stirileprotv.ro,0,0,1,1,0.0,0.0
Csoma Botond,stirileprotv.ro,0,0,2,2,0.0,0.0
ar,www.activenews.ro,0,1,0,1,-1.0,1.0
avortist,www.activenews.ro,0,1,0,1,-1.0,1.0
celorlalt,www.activenews.ro,0,1,0,1,-1.0,1.0
Cioloș,www.activenews.ro,0,1,0,1,-1.0,1.0
ființă,www.activenews.ro,1,0,0,1,1.0,1.0
semnatar,www.activenews.ro,0,1,0,1,-1.0,1.0
Mircea Badea,www.digi24.ro,0,1,0,1,-1.0,1.0
Dâncu,www.digi24.ro,0,1,0,1,-1.0,1.0
Kelemen,www.digi24.ro,0,0,1,1,0.0,0.0
domnul Pambuccian,www.digi24.ro,0,0,1,1,0.0,0.0
om politic,www.digi24.ro,0,3,0,3,-1.0,1.0
Eugen Nicolaescu,stirileprotv.ro,0,0,3,3,0.0,0.0
Iordania,stirileprotv.ro,0,0,2,2,0.0,0.0
Siria,stirileprotv.ro,0,0,1,1,0.0,0.0
Turciei,stirileprotv.ro,0,0,1,1,0.0,0.0
Valeriu Zgonea,stirileprotv.ro,0,0,2,2,0.0,0.0
Victor Paul Dobre,stirileprotv.ro,0,1,1,2,-0.5,0.5
imigrant,stirileprotv.ro,0,1,0,1,-1.0,1.0
migrant,stirileprotv.ro,0,0,1,1,0.0,0.0
politist,stirileprotv.ro,0,2,0,2,-1.0,1.0
refugiat,stirileprotv.ro,0,0,4,4,0.0,0.0
Alba Iulia,www.cotidianul.ro,0,0,1,1,0.0,0.0
Baesu,a1.ro,0,0,1,1,0.0,0.0
Dorina Danielescu,a1.ro,0,0,1,1,0.0,0.0
Geoana,a1.ro,0,0,1,1,0.0,0.0
George Baesu,a1.ro,0,0,1,1,0.0,0.0
Vrancea,a1.ro,0,0,1,1,0.0,0.0
"Victor Ponta, Dorina Dănilescu",a1.ro,0,0,1,1,0.0,0.0
Ana Maria Gavrilă,adevarul.ro,0,0,2,2,0.0,0.0
Ion Popa,adevarul.ro,0,2,0,2,-1.0,1.0
Marcu,adevarul.ro,0,1,0,1,-1.0,1.0
Maria Marcu,adevarul.ro,0,1,3,4,-0.25,0.25
Mîndru,adevarul.ro,0,0,1,1,0.0,0.0
Petru Mîndru,adevarul.ro,0,2,0,2,-1.0,1.0
lucrător,adevarul.ro,0,0,3,3,0.0,0.0
și,adevarul.ro,0,1,1,2,-0.5,0.5
Anamaria Gavrila,www.euronews.ro,0,1,0,1,-1.0,1.0
Cosmin Cerva,www.euronews.ro,0,0,1,1,0.0,0.0
George Becali,www.euronews.ro,0,0,1,1,0.0,0.0
Jucan,www.euronews.ro,0,0,1,1,0.0,0.0
Machiavelli,www.euronews.ro,0,0,1,1,0.0,0.0
Valentin Jucan,www.euronews.ro,0,0,1,1,0.0,0.0
influencer,www.euronews.ro,0,2,0,2,-1.0,1.0
interlop,www.euronews.ro,0,1,0,1,-1.0,1.0
reporter,www.euronews.ro,0,1,2,3,-0.3333333333333333,0.3333333333333333
șefă,www.euronews.ro,0,0,2,2,0.0,0.0
Petru Filip,a1.ro,0,0,1,1,0.0,0.0
Laura Vicol,www.news.ro,0,1,4,5,-0.2,0.2
Vicol,www.news.ro,0,1,5,6,-0.16666666666666666,0.16666666666666666
Vladimir Ciorbă,www.news.ro,0,0,5,5,0.0,0.0
Adrian Zuckerman,www.g4media.ro,0,0,1,1,0.0,0.0
Alfred Moses,www.g4media.ro,0,0,1,1,0.0,0.0
Zuckerman,www.g4media.ro,0,0,2,2,0.0,0.0
Andrei Muraru,www.g4media.ro,0,2,0,2,-1.0,1.0
Clinton,www.g4media.ro,0,0,1,1,0.0,0.0
Constanța,www.g4media.ro,0,0,8,8,0.0,0.0
Hans G. Klemm,www.g4media.ro,0,0,1,1,0.0,0.0
James Rosapepe,www.g4media.ro,0,0,1,1,0.0,0.0
Maramureș,www.g4media.ro,0,0,4,4,0.0,0.0
Mark Gitenstein,www.g4media.ro,0,0,1,1,0.0,0.0
Michael Guest,www.g4media.ro,0,0,1,1,0.0,0.0
Nicholas Taubman,www.g4media.ro,0,0,1,1,0.0,0.0
Stalin,www.g4media.ro,0,1,0,1,-1.0,1.0
Statele,www.g4media.ro,0,0,1,1,0.0,0.0
subsemnat,www.g4media.ro,0,0,1,1,0.0,0.0
reprezentant oficial,www.g4media.ro,0,0,1,1,0.0,0.0
Geoană,www.news.ro,1,0,4,5,0.2,0.2
Mircea Geoană,www.news.ro,1,0,6,7,0.14285714285714285,0.14285714285714285
secretar general adjunct,www.news.ro,1,0,2,3,0.3333333333333333,0.3333333333333333
secretar general,www.news.ro,0,0,4,4,0.0,0.0
Gabriel Andronache,observatornews.ro,0,0,5,5,0.0,0.0
Ionuț Stroe,observatornews.ro,0,0,4,4,0.0,0.0
Stroe,observatornews.ro,0,0,3,3,0.0,0.0
Păun,agerpres.ro,0,0,3,3,0.0,0.0
senatoare,agerpres.ro,0,2,2,4,-0.5,0.5
pensionar,agerpres.ro,0,5,5,10,-0.5,0.5
Afganistan,www.news.ro,0,0,1,1,0.0,0.0
autor,www.news.ro,0,0,2,2,0.0,0.0
Canada,www.news.ro,0,0,1,1,0.0,0.0
Cipru,www.news.ro,0,0,1,1,0.0,0.0
Coreea de Sud,www.news.ro,0,0,1,1,0.0,0.0
Deveselu,www.news.ro,0,0,1,1,0.0,0.0
Domnul Carney,www.news.ro,1,0,0,1,1.0,1.0
Radu Carp,www.news.ro,1,0,2,3,0.3333333333333333,0.3333333333333333
Federația Rusă,www.news.ro,0,1,0,1,-1.0,1.0
Irak,www.news.ro,0,0,1,1,0.0,0.0
Iran,www.news.ro,0,1,2,3,-0.3333333333333333,0.3333333333333333
Israel,www.news.ro,0,0,1,1,0.0,0.0
Japonia,www.news.ro,1,0,2,3,0.3333333333333333,0.3333333333333333
Kogălniceanu,www.news.ro,1,0,0,1,1.0,1.0
Matei Udrea,www.news.ro,0,0,1,1,0.0,0.0
Moise,www.news.ro,0,1,0,1,-1.0,1.0
nord,www.news.ro,0,0,1,1,0.0,0.0
Norvegia,www.news.ro,0,0,1,1,0.0,0.0
Paris,www.news.ro,0,1,1,2,-0.5,0.5
Polonia,www.news.ro,0,0,5,5,0.0,0.0
Ungaria,www.news.ro,0,1,1,2,-0.5,0.5
beneficiar,www.news.ro,0,1,0,1,-1.0,1.0
Carney,www.news.ro,1,0,0,1,1.0,1.0
Hegseth,www.news.ro,0,0,1,1,0.0,0.0
Sikorski,www.news.ro,0,0,1,1,0.0,0.0
Donald Tusk,www.news.ro,0,0,1,1,0.0,0.0
Mark Carney,www.news.ro,0,0,1,1,0.0,0.0
domnul Ponta,www.news.ro,0,0,1,1,0.0,0.0
domnului Vance,www.news.ro,0,1,0,1,-1.0,1.0
hacker,www.news.ro,0,0,1,1,0.0,0.0
interlocutor,www.news.ro,1,0,2,3,0.3333333333333333,0.3333333333333333
susținător,www.news.ro,0,4,2,6,-0.6666666666666666,0.6666666666666666
Clotilde Armand,www.gandul.ro,0,4,5,9,-0.4444444444444444,0.4444444444444444
Federația Rusă,pressone.ro,0,7,0,7,-1.0,1.0
Fico,pressone.ro,0,1,0,1,-1.0,1.0
Florența,pressone.ro,0,0,1,1,0.0,0.0
Kamala Harris,pressone.ro,0,0,1,1,0.0,0.0
Marius Ghincea,pressone.ro,0,0,2,2,0.0,0.0
Washington,pressone.ro,1,3,4,8,-0.25,0.25
actorii,pressone.ro,0,2,4,6,-0.3333333333333333,0.3333333333333333
autocrație,pressone.ro,0,1,0,1,-1.0,1.0
Dâmbovița,observatornews.ro,0,0,2,2,0.0,0.0
Cărtărescu,www.activenews.ro,0,2,0,2,-1.0,1.0
Dani Mocanu,www.activenews.ro,0,1,0,1,-1.0,1.0
Mircea Cărtărescu,www.activenews.ro,0,1,0,1,-1.0,1.0
artist,www.activenews.ro,1,0,0,1,1.0,1.0
băiat,www.activenews.ro,1,2,0,3,-0.3333333333333333,0.3333333333333333
poet,www.activenews.ro,3,0,0,3,1.0,1.0
ăsta,www.activenews.ro,0,1,0,1,-1.0,1.0
Andrii Sybiha,www.gandul.ro,0,0,1,1,0.0,0.0
Emil Hurezeanu,www.gandul.ro,0,0,3,3,0.0,0.0
Serbia,www.gandul.ro,0,2,2,4,-0.5,0.5
Sudan,www.gandul.ro,0,0,2,2,0.0,0.0
manifestant,stirileprotv.ro,0,0,1,1,0.0,0.0
ambasador,agerpres.ro,0,0,2,2,0.0,0.0
George Bologan,agerpres.ro,0,0,1,1,0.0,0.0
Vatican,agerpres.ro,0,0,1,1,0.0,0.0
Lavric,www.digi24.ro,0,0,1,1,0.0,0.0
Slănic Moldova,www.digi24.ro,0,0,1,1,0.0,0.0
Sorin Lavric,www.digi24.ro,0,0,4,4,0.0,0.0
Cornelia Dumitru,agerpres.ro,0,0,2,2,0.0,0.0
Corneliu Stefan,agerpres.ro,0,0,1,1,0.0,0.0
Corneliu Ștefan,agerpres.ro,0,0,1,1,0.0,0.0
Dâmbovița,agerpres.ro,0,0,3,3,0.0,0.0
Pricopie,adevarul.ro,0,0,2,2,0.0,0.0
Rector,adevarul.ro,1,2,4,7,-0.14285714285714285,0.14285714285714285
respectiv,adevarul.ro,0,0,1,1,0.0,0.0
Turcescu,www.digi24.ro,0,0,1,1,0.0,0.0
el,www.digi24.ro,0,1,0,1,-1.0,1.0
suveranist,www.digi24.ro,0,1,0,1,-1.0,1.0
Turcan,www.mediafax.ro,0,0,1,1,0.0,0.0
Valeriu Turcan,www.mediafax.ro,0,0,1,1,0.0,0.0
analist,primanews.ro,0,1,4,5,-0.2,0.2
centrist,primanews.ro,2,0,0,2,1.0,1.0
Sergiu Mișcoiu,primanews.ro,0,0,1,1,0.0,0.0
activist,primanews.ro,0,1,2,3,-0.3333333333333333,0.3333333333333333
fiică,primanews.ro,1,0,0,1,1.0,1.0
matematician,primanews.ro,0,0,1,1,0.0,0.0
naționalist,primanews.ro,0,2,0,2,-1.0,1.0
rival,primanews.ro,0,6,1,7,-0.8571428571428571,0.8571428571428571
Moscova,a1.ro,0,1,0,1,-1.0,1.0
fotomodel,a1.ro,0,0,1,1,0.0,0.0
rival,a1.ro,0,1,0,1,-1.0,1.0
Nicoleta Pauliuc,www.antena3.ro,0,0,1,1,0.0,0.0
Slovacia,www.antena3.ro,0,1,1,2,-0.5,0.5
doamnă,www.antena3.ro,0,0,5,5,0.0,0.0
locuitor,www.antena3.ro,0,1,1,2,-0.5,0.5
Cristian Vasile Terheș,www.realitatea.net,0,0,1,1,0.0,0.0
Elena Valerica Lasconi,www.realitatea.net,0,0,1,1,0.0,0.0
George Crin Laurențiu Antonescu,www.realitatea.net,0,0,1,1,0.0,0.0
George Nicolae Simion,www.realitatea.net,0,0,1,1,0.0,0.0
Marcela Lavinia Șandru,www.realitatea.net,0,0,1,1,0.0,0.0
Petru Daniel Funeriu,www.realitatea.net,0,0,1,1,0.0,0.0
Sebastian Constantin Popescu,www.realitatea.net,0,0,1,1,0.0,0.0
Silviu Predoiu,www.realitatea.net,0,0,3,3,0.0,0.0
Cristian Popescu Piedone,www.comisarul.ro,0,0,3,3,0.0,0.0
Piedone,www.comisarul.ro,0,1,0,1,-1.0,1.0
Adina Vălean,www.antena3.ro,0,0,2,2,0.0,0.0
soț,www.antena3.ro,0,0,1,1,0.0,0.0
Corlatean,stirileprotv.ro,0,0,1,1,0.0,0.0
Sergei Lavrov,stirileprotv.ro,0,0,1,1,0.0,0.0
diplomat,stirileprotv.ro,0,0,1,1,0.0,0.0
frate,stirileprotv.ro,1,1,2,4,0.0,0.0
nimeni,www.comisarul.ro,0,0,1,1,0.0,0.0
Votanțiu,www.comisarul.ro,0,0,1,1,0.0,0.0
acționar,www.realitatea.net,0,2,1,3,-0.6666666666666666,0.6666666666666666
Periș,www.realitatea.net,0,1,0,1,-1.0,1.0
Metin Dogan,www.realitatea.net,1,0,0,1,1.0,1.0
Andrei Muraru,www.antena3.ro,0,0,3,3,0.0,0.0
Muraru,www.antena3.ro,0,0,1,1,0.0,0.0
Boșutar,pressone.ro,0,0,1,1,0.0,0.0
Cimpoi Adrian,pressone.ro,0,0,1,1,0.0,0.0
George Soros,pressone.ro,0,5,2,7,-0.7142857142857143,0.7142857142857143
Tiberiu Boșutar,pressone.ro,0,0,1,1,0.0,0.0
Tomis,pressone.ro,0,1,0,1,-1.0,1.0
aliaț,pressone.ro,0,4,0,4,-1.0,1.0
domnul Cimpoi Adrian,pressone.ro,0,0,1,1,0.0,0.0
pion,pressone.ro,0,1,0,1,-1.0,1.0
plagiatori,pressone.ro,0,3,0,3,-1.0,1.0
George Bode,pressone.ro,0,1,0,1,-1.0,1.0
rezervist,pressone.ro,0,2,0,2,-1.0,1.0
Teodosie,pressone.ro,0,1,0,1,-1.0,1.0
Claudiu Năsui,www.mediafax.ro,0,0,2,2,0.0,0.0
Cristina Prună,www.mediafax.ro,0,0,1,1,0.0,0.0
Florin Roman,www.mediafax.ro,0,1,1,2,-0.5,0.5
Insulele Canare,www.aktual24.ro,1,0,0,1,1.0,1.0
organizator,www.aktual24.ro,0,0,1,1,0.0,0.0
Tenerife,www.aktual24.ro,0,0,1,1,0.0,0.0
turist,www.aktual24.ro,0,0,1,1,0.0,0.0
vizitator,www.aktual24.ro,0,0,1,1,0.0,0.0
Daniel Horodniceanu,pressone.ro,0,0,1,1,0.0,0.0
Daniel Morar,pressone.ro,0,0,1,1,0.0,0.0
Glina,pressone.ro,0,0,1,1,0.0,0.0
Hanna Gheorghiu,pressone.ro,0,0,1,1,0.0,0.0
Laura Codruța Kövesi,pressone.ro,0,1,8,9,-0.1111111111111111,0.1111111111111111
Nicolae Răzvan,pressone.ro,0,0,1,1,0.0,0.0
Nicolae Răzvan Ciobanu,pressone.ro,0,0,1,1,0.0,0.0
Vasile Andrei,pressone.ro,0,0,1,1,0.0,0.0
Vasile Andrei Nicolae,pressone.ro,0,0,1,1,0.0,0.0
Arabia Saudită,primanews.ro,0,0,5,5,0.0,0.0
Mohammed bin Salman,primanews.ro,1,0,2,3,0.3333333333333333,0.3333333333333333
Riad,primanews.ro,0,0,1,1,0.0,0.0
Sharaa,primanews.ro,0,1,1,2,-0.5,0.5
Sirie,primanews.ro,0,1,1,2,-0.5,0.5
gazdă,primanews.ro,0,0,1,1,0.0,0.0
prinț,primanews.ro,1,0,1,2,0.5,0.5
Danut Radu,a1.ro,0,0,1,1,0.0,0.0
Marian Sarbu,a1.ro,0,0,3,3,0.0,0.0
Mariana Basuc,a1.ro,0,0,1,1,0.0,0.0
Sarbu,a1.ro,0,1,0,1,-1.0,1.0
ea,a1.ro,0,1,0,1,-1.0,1.0
inspector,a1.ro,0,1,1,2,-0.5,0.5
Nistrul,pressone.ro,0,1,0,1,-1.0,1.0
Rogozin,pressone.ro,0,0,1,1,0.0,0.0
România Mare,pressone.ro,0,1,0,1,-1.0,1.0
Tiraspol,pressone.ro,0,1,0,1,-1.0,1.0
Viorel Cibotaru,pressone.ro,0,1,1,2,-0.5,0.5
Vlad Bătrâncea,pressone.ro,0,1,0,1,-1.0,1.0
China,adevarul.ro,0,0,5,5,0.0,0.0
Câți,adevarul.ro,0,1,0,1,-1.0,1.0
Generalul Alexandru Grumaz,adevarul.ro,1,0,0,1,1.0,1.0
Grumaz,adevarul.ro,0,0,1,1,0.0,0.0
John F. Kennedy,adevarul.ro,0,0,1,1,0.0,0.0
pensionar,adevarul.ro,0,1,2,3,-0.3333333333333333,0.3333333333333333
Shanghai,adevarul.ro,0,0,1,1,0.0,0.0
consul,adevarul.ro,0,0,3,3,0.0,0.0
cunoscător,adevarul.ro,1,0,0,1,1.0,1.0
Alexandru Grumaz,adevarul.ro,1,0,0,1,1.0,1.0
generalul Grumaz,adevarul.ro,0,0,1,1,0.0,0.0
lider militar,adevarul.ro,0,1,0,1,-1.0,1.0
ofițer,adevarul.ro,0,4,7,11,-0.36363636363636365,0.36363636363636365
personal militar,adevarul.ro,0,0,1,1,0.0,0.0
prizonier,adevarul.ro,0,1,0,1,-1.0,1.0
rezervist,adevarul.ro,0,2,0,2,-1.0,1.0
subordonat,adevarul.ro,0,1,0,1,-1.0,1.0
austriac,observatornews.ro,0,3,0,3,-1.0,1.0
eurodeputat,observatornews.ro,1,0,1,2,0.5,0.5
funcționar,www.gandul.ro,0,4,0,4,-1.0,1.0
musafir,www.gandul.ro,0,1,0,1,-1.0,1.0
soacra,www.gandul.ro,0,1,0,1,-1.0,1.0
Foști,www.news.ro,0,1,0,1,-1.0,1.0
Spania,www.news.ro,0,0,1,1,0.0,0.0
Zuckerman,www.news.ro,0,0,1,1,0.0,0.0
foșt,www.news.ro,0,1,0,1,-1.0,1.0
invitat,www.news.ro,0,1,1,2,-0.5,0.5
Băluța,www.romaniatv.net,0,0,1,1,0.0,0.0
Dan Nica,www.romaniatv.net,0,1,4,5,-0.2,0.2
Negrescu,www.romaniatv.net,0,0,4,4,0.0,0.0
Nica,www.romaniatv.net,0,1,0,1,-1.0,1.0
Victor Negrescu,www.romaniatv.net,0,0,8,8,0.0,0.0
Ana Călin,adevarul.ro,0,0,1,1,0.0,0.0
Birchall,adevarul.ro,0,1,0,1,-1.0,1.0
Mizil,adevarul.ro,0,0,2,2,0.0,0.0
New York,adevarul.ro,0,0,4,4,0.0,0.0
cadru universitar,adevarul.ro,0,0,1,1,0.0,0.0
protagonistă,adevarul.ro,0,2,0,2,-1.0,1.0
Nagy,a1.ro,0,2,0,2,-1.0,1.0
Nagy Ferdinand,a1.ro,0,1,0,1,-1.0,1.0
Satu Mare,a1.ro,0,0,2,2,0.0,0.0
el,a1.ro,0,1,0,1,-1.0,1.0
Valer Marian,a1.ro,0,0,1,1,0.0,0.0
subsecretar de stat,a1.ro,0,1,1,2,-0.5,0.5
Bolocan,www.news.ro,0,0,1,1,0.0,0.0
Cristian Bolocan,www.news.ro,0,0,2,2,0.0,0.0
tânăr,www.news.ro,0,0,2,2,0.0,0.0
Anca Dragu,www.mediafax.ro,0,0,1,1,0.0,0.0
Cătălin Drulă,www.mediafax.ro,0,1,2,3,-0.3333333333333333,0.3333333333333333
Fenechiu,www.mediafax.ro,0,3,0,3,-1.0,1.0
Bihor,www.gandul.ro,0,0,1,1,0.0,0.0
Bolojan,www.gandul.ro,1,2,5,8,-0.125,0.125
Hunor,www.gandul.ro,1,0,0,1,1.0,1.0
Kelemen Hunor,www.gandul.ro,1,0,7,8,0.125,0.125
Hellvig,observatornews.ro,1,0,1,2,0.5,0.5
Bogdan Peșchir,adevarul.ro,0,0,1,1,0.0,0.0
ziarist,adevarul.ro,0,3,1,4,-0.75,0.75
Biden,recorder.ro,0,2,1,3,-0.6666666666666666,0.6666666666666666
Bogdan Ivan,recorder.ro,0,0,2,2,0.0,0.0
Laurei Vicol,recorder.ro,0,0,2,2,0.0,0.0
Kamala Harris,recorder.ro,0,0,1,1,0.0,0.0
Iohannis,recorder.ro,0,1,2,3,-0.3333333333333333,0.3333333333333333
Chinei,pressone.ro,0,2,1,3,-0.6666666666666666,0.6666666666666666
Marius Lulea,pressone.ro,0,1,1,2,-0.5,0.5
detractor,pressone.ro,0,1,0,1,-1.0,1.0
telespectator,pressone.ro,0,2,0,2,-1.0,1.0
Georgia Meloni,observatornews.ro,0,1,1,2,-0.5,0.5
Giorgia Meloni,observatornews.ro,0,0,2,2,0.0,0.0
Italia,observatornews.ro,0,0,4,4,0.0,0.0
New York,observatornews.ro,0,0,1,1,0.0,0.0
Prințesa Diana,observatornews.ro,0,1,0,1,-1.0,1.0
terorist,observatornews.ro,0,1,0,1,-1.0,1.0
Andrei Dolineaschi,pressone.ro,0,0,2,2,0.0,0.0
Pitești,pressone.ro,1,1,3,5,0.0,0.0
Rădulescu,pressone.ro,0,2,1,3,-0.6666666666666666,0.6666666666666666
Valeca,pressone.ro,0,0,1,1,0.0,0.0
comerciant,pressone.ro,0,1,1,2,-0.5,0.5
consilieră,pressone.ro,0,1,3,4,-0.25,0.25
mușter,pressone.ro,0,1,0,1,-1.0,1.0
piteștean,pressone.ro,0,1,0,1,-1.0,1.0
Șerban Valeca,pressone.ro,0,0,1,1,0.0,0.0
Adrian Veștea,www.antena3.ro,0,0,1,1,0.0,0.0
Veștea,www.antena3.ro,0,0,1,1,0.0,0.0
District of Columbia,www.news.ro,0,0,1,1,0.0,0.0
coordonator,www.news.ro,0,0,3,3,0.0,0.0
demnitar public,www.news.ro,0,0,1,1,0.0,0.0
demnitar,www.news.ro,0,1,2,3,-0.3333333333333333,0.3333333333333333
stat,www.news.ro,0,0,1,1,0.0,0.0
Excelența Sa,primanews.ro,1,0,0,1,1.0,1.0
Excelența Sale,primanews.ro,0,0,1,1,0.0,0.0
Kathleen Kavalec,primanews.ro,0,0,2,2,0.0,0.0
Statele Unite ale Americii,primanews.ro,0,0,4,4,0.0,0.0
ambasador,primanews.ro,0,0,1,1,0.0,0.0
Ana Blandiana,www.aktual24.ro,0,0,1,1,0.0,0.0
Blaga,www.aktual24.ro,0,0,1,1,0.0,0.0
Liiceanu,www.aktual24.ro,0,0,1,1,0.0,0.0
Plesu,www.aktual24.ro,0,0,1,1,0.0,0.0
Petrov,www.aktual24.ro,0,1,0,1,-1.0,1.0
Vasile Blaga,www.aktual24.ro,0,0,3,3,0.0,0.0
bariton,www.aktual24.ro,0,0,1,1,0.0,0.0
mester,www.aktual24.ro,0,0,1,1,0.0,0.0
Daniel Ghiță,www.digi24.ro,0,0,2,2,0.0,0.0
Mihai Polițeanu,www.digi24.ro,0,2,0,2,-1.0,1.0
Macovei,www.digi24.ro,0,0,1,1,0.0,0.0
protagonist,www.digi24.ro,0,0,1,1,0.0,0.0
securist,www.digi24.ro,0,1,0,1,-1.0,1.0
alegător,www.luju.ro,0,4,2,6,-0.6666666666666666,0.6666666666666666
suveranist,www.luju.ro,0,3,0,3,-1.0,1.0
Alba,stirileprotv.ro,0,0,2,2,0.0,0.0
ambasador,stirileprotv.ro,0,0,4,4,0.0,0.0
Anastase,stirileprotv.ro,0,0,1,1,0.0,0.0
Andrei Chiliman,stirileprotv.ro,0,0,1,1,0.0,0.0
Andrei Marga,stirileprotv.ro,0,0,2,2,0.0,0.0
Angela Merkel,stirileprotv.ro,1,0,5,6,0.16666666666666666,0.16666666666666666
Arad,stirileprotv.ro,0,0,3,3,0.0,0.0
Arafat,stirileprotv.ro,0,0,1,1,0.0,0.0
Aspazia Cojocaru,stirileprotv.ro,0,0,1,1,0.0,0.0
Avocatul Poporului,stirileprotv.ro,0,0,1,1,0.0,0.0
Avocat al Poporului,stirileprotv.ro,0,1,0,1,-1.0,1.0
Blaga,stirileprotv.ro,0,0,3,3,0.0,0.0
Bogdan Dragoi,stirileprotv.ro,0,0,1,1,0.0,0.0
cancelar,stirileprotv.ro,0,1,4,5,-0.2,0.2
Constantin Manoloiu,stirileprotv.ro,0,2,0,2,-1.0,1.0
Chiliman,stirileprotv.ro,0,0,1,1,0.0,0.0
Corneliu Dobritoiu,stirileprotv.ro,0,0,2,2,0.0,0.0
Cristian Popescu Piedone,stirileprotv.ro,0,0,2,2,0.0,0.0
Cristian Preda,stirileprotv.ro,0,0,2,2,0.0,0.0
Donald Tusk,stirileprotv.ro,0,0,1,1,0.0,0.0
Dorin Florea,stirileprotv.ro,0,0,1,1,0.0,0.0
Gheorghe Iancu,stirileprotv.ro,0,1,0,1,-1.0,1.0
Gordon,stirileprotv.ro,0,0,1,1,0.0,0.0
Hasotti,stirileprotv.ro,0,0,1,1,0.0,0.0
Herman Van Rompuy,stirileprotv.ro,0,0,1,1,0.0,0.0
Ioan Rus,stirileprotv.ro,0,0,1,1,0.0,0.0
Jose Barroso,stirileprotv.ro,0,0,1,1,0.0,0.0
Jose Manuel Barroso,stirileprotv.ro,0,0,2,2,0.0,0.0
judecătoare,stirileprotv.ro,0,1,0,1,-1.0,1.0
Lui Ponta,stirileprotv.ro,0,1,0,1,-1.0,1.0
Mark Gitenstein,stirileprotv.ro,0,0,1,1,0.0,0.0
Mihai Razvan Ungureanu,stirileprotv.ro,0,0,3,3,0.0,0.0
Mihai Stanisoara,stirileprotv.ro,0,0,1,1,0.0,0.0
Mircea Diaconu,stirileprotv.ro,0,0,2,2,0.0,0.0
Mircea Dușa,stirileprotv.ro,0,0,1,1,0.0,0.0
Mona Pivniceru,stirileprotv.ro,0,0,1,1,0.0,0.0
Monei Pivniceru,stirileprotv.ro,0,0,1,1,0.0,0.0
Nastase,stirileprotv.ro,1,1,1,3,0.0,0.0
Petru Filip,stirileprotv.ro,0,0,1,1,0.0,0.0
Philip Gordon,stirileprotv.ro,0,0,2,2,0.0,0.0
Piedone,stirileprotv.ro,0,1,0,1,-1.0,1.0
protestatar,stirileprotv.ro,0,4,1,5,-0.8,0.8
Radu Stroe,stirileprotv.ro,0,0,1,1,0.0,0.0
Raed Arafat,stirileprotv.ro,0,0,1,1,0.0,0.0
Roberta Anastase,stirileprotv.ro,0,0,1,1,0.0,0.0
Robert Anastase,stirileprotv.ro,0,0,1,1,0.0,0.0
Mihaela Popa,stirileprotv.ro,0,0,2,2,0.0,0.0
Serghei Stanisev,stirileprotv.ro,0,0,1,1,0.0,0.0
Sorin Blejnar,stirileprotv.ro,0,0,1,1,0.0,0.0
Sorin Frunzaverde,stirileprotv.ro,1,0,1,2,0.5,0.5
Târgu Jiu,stirileprotv.ro,0,0,1,1,0.0,0.0
Teodor Baconschi,stirileprotv.ro,0,1,0,1,-1.0,1.0
Teodor Melescanu,stirileprotv.ro,0,0,1,1,0.0,0.0
Titus Corlătean,stirileprotv.ro,0,0,1,1,0.0,0.0
Valer Dorneanu,stirileprotv.ro,0,0,1,1,0.0,0.0
Vasile Blaga,stirileprotv.ro,0,0,5,5,0.0,0.0
Victor Dobre,stirileprotv.ro,0,0,1,1,0.0,0.0
Viviane Reding,stirileprotv.ro,0,0,1,1,0.0,0.0
bugetar,stirileprotv.ro,0,1,1,2,-0.5,0.5
participant,stirileprotv.ro,0,0,1,1,0.0,0.0
pensionar,stirileprotv.ro,0,0,1,1,0.0,0.0
Adrian Nastase,stirileprotv.ro,1,2,3,6,-0.16666666666666666,0.16666666666666666
seful,stirileprotv.ro,0,2,0,2,-1.0,1.0
subsecretar de stat,stirileprotv.ro,0,0,2,2,0.0,0.0
Violeta Alexandru,www.cotidianul.ro,0,0,2,2,0.0,0.0
Violetei Alexandru,www.cotidianul.ro,0,0,1,1,0.0,0.0
Vlad Voiculescu,www.cotidianul.ro,0,0,1,1,0.0,0.0
Farfuridi,www.mediafax.ro,0,1,0,1,-1.0,1.0
oltean,www.mediafax.ro,0,1,0,1,-1.0,1.0
personaj politic,www.mediafax.ro,0,0,1,1,0.0,0.0
Alina Voina,agerpres.ro,0,0,4,4,0.0,0.0
Isabela Paulescu,agerpres.ro,0,0,5,5,0.0,0.0
Sibiu,agerpres.ro,0,0,5,5,0.0,0.0
Bogdan Trif,agerpres.ro,0,0,2,2,0.0,0.0
Buza,www.aktual24.ro,0,0,5,5,0.0,0.0
Constantin Toma,www.aktual24.ro,0,3,6,9,-0.3333333333333333,0.3333333333333333
Neacsu,www.aktual24.ro,0,1,4,5,-0.2,0.2
Pieleanu,www.aktual24.ro,0,0,2,2,0.0,0.0
Marius Pieleanu,www.aktual24.ro,0,0,3,3,0.0,0.0
Toma,www.aktual24.ro,0,1,4,5,-0.2,0.2
elvetian,www.aktual24.ro,0,0,1,1,0.0,0.0
factor,www.aktual24.ro,0,0,1,1,0.0,0.0
Andreea Dumitrescu,www.comisarul.ro,0,0,1,1,0.0,0.0
Ceban,www.comisarul.ro,0,1,0,1,-1.0,1.0
Cosmin Prelipceanu,www.comisarul.ro,0,0,1,1,0.0,0.0
Dodon,www.comisarul.ro,0,1,0,1,-1.0,1.0
Dvs,www.comisarul.ro,0,0,1,1,0.0,0.0
Macron,www.comisarul.ro,0,1,1,2,-0.5,0.5
Merz,www.comisarul.ro,0,0,1,1,0.0,0.0
Occident,www.comisarul.ro,0,0,1,1,0.0,0.0
Roșia Montană,www.comisarul.ro,0,1,0,1,-1.0,1.0
Salvini,www.comisarul.ro,0,1,0,1,-1.0,1.0
aspirant,www.comisarul.ro,0,1,0,1,-1.0,1.0
debutant,www.comisarul.ro,1,0,0,1,1.0,1.0
fermier,www.comisarul.ro,0,1,1,2,-0.5,0.5
Tate,www.comisarul.ro,0,1,1,2,-0.5,0.5
medic,www.comisarul.ro,2,0,6,8,0.25,0.25
pușcăriaș,www.comisarul.ro,0,1,0,1,-1.0,1.0
vecin,www.comisarul.ro,0,2,0,2,-1.0,1.0
bărbat,www.romaniatv.net,1,5,8,14,-0.2857142857142857,0.2857142857142857
condamnat,www.romaniatv.net,0,1,0,1,-1.0,1.0
rezervist,www.romaniatv.net,0,1,0,1,-1.0,1.0
Secretar de Stat,primanews.ro,0,0,1,1,0.0,0.0
Dubai,www.g4media.ro,0,0,2,2,0.0,0.0
Durov,www.g4media.ro,0,0,2,2,0.0,0.0
Pavel Durov,www.g4media.ro,0,0,2,2,0.0,0.0
Frunda,a1.ro,0,0,1,1,0.0,0.0
Lazaroiu,a1.ro,0,2,1,3,-0.6666666666666666,0.6666666666666666
Radu Berceanu,a1.ro,0,1,1,2,-0.5,0.5
Tata Omida,a1.ro,0,1,0,1,-1.0,1.0
satanist,a1.ro,0,1,0,1,-1.0,1.0
fost,www.news.ro,0,1,1,2,-0.5,0.5
miliardar,www.news.ro,0,2,0,2,-1.0,1.0
Năstase,agerpres.ro,0,0,1,1,0.0,0.0
intermediar,agerpres.ro,0,0,1,1,0.0,0.0
Adrian Năstase,agerpres.ro,0,0,2,2,0.0,0.0
Adrian Năstase,www.euronews.ro,0,0,4,4,0.0,0.0
Dan Matei Agathon,www.euronews.ro,0,0,1,1,0.0,0.0
Nicolae Văcăroiu,www.euronews.ro,0,0,1,1,0.0,0.0
Năstase,www.euronews.ro,0,1,1,2,-0.5,0.5
Dambovita,www.aktual24.ro,1,0,3,4,0.25,0.25
apărător,www.mediafax.ro,0,0,1,1,0.0,0.0
Veronel Rădulescu,www.mediafax.ro,0,0,2,2,0.0,0.0
Costa Rica,www.mediafax.ro,0,0,2,2,0.0,0.0
refugiat,www.mediafax.ro,0,1,3,4,-0.25,0.25
vecin,www.realitatea.net,0,1,0,1,-1.0,1.0
Blaga,agerpres.ro,0,0,2,2,0.0,0.0
Vasile Blaga,agerpres.ro,0,0,2,2,0.0,0.0
Aleksandar Vucic,www.g4media.ro,0,0,2,2,0.0,0.0
Nis,www.g4media.ro,0,0,1,1,0.0,0.0
Novi Sad,www.g4media.ro,0,0,1,1,0.0,0.0
Serbia,www.g4media.ro,0,1,0,1,-1.0,1.0
Vucic,www.g4media.ro,0,0,2,2,0.0,0.0
partizan,www.g4media.ro,0,1,1,2,-0.5,0.5
om politic,www.antena3.ro,0,3,0,3,-1.0,1.0
Bogdan Mazuru,www.digi24.ro,0,0,1,1,0.0,0.0
Florin Marius Tacu,www.digi24.ro,0,0,1,1,0.0,0.0
Principatul Liechtenstein,www.digi24.ro,0,0,1,1,0.0,0.0
Sultanatul Oman,www.digi24.ro,0,0,1,1,0.0,0.0
ales,www.euronews.ro,0,2,1,3,-0.6666666666666666,0.6666666666666666
Abrudean,pressone.ro,0,1,0,1,-1.0,1.0
Alexandru Gabriel Simu,pressone.ro,0,0,1,1,0.0,0.0
Aluniș,pressone.ro,0,0,1,1,0.0,0.0
Ambii,pressone.ro,0,2,2,4,-0.5,0.5
Beliș,pressone.ro,0,0,1,1,0.0,0.0
Borșa,pressone.ro,0,0,1,1,0.0,0.0
Clienți,pressone.ro,0,1,0,1,-1.0,1.0
Cluj Napoca,pressone.ro,0,0,1,1,0.0,0.0
Cuzdrioara,pressone.ro,0,0,1,1,0.0,0.0
Câmpia Turzii,pressone.ro,0,0,1,1,0.0,0.0
Câțcău,pressone.ro,0,0,1,1,0.0,0.0
Dorin Lojigan,pressone.ro,0,0,1,1,0.0,0.0
Dăbâca,pressone.ro,0,0,1,1,0.0,0.0
Emil Boc,pressone.ro,1,3,7,11,-0.18181818181818182,0.18181818181818182
Fizeșu Gherlii,pressone.ro,0,0,1,1,0.0,0.0
Geaca,pressone.ro,0,0,1,1,0.0,0.0
Gheorghe Funar,pressone.ro,0,1,0,1,-1.0,1.0
Gherla,pressone.ro,0,0,1,1,0.0,0.0
Gilău,pressone.ro,0,0,1,1,0.0,0.0
Horea Uioreanu,pressone.ro,0,0,1,1,0.0,0.0
Ioan Miron,pressone.ro,0,0,1,1,0.0,0.0
Marius Nicoară,pressone.ro,0,0,1,1,0.0,0.0
Mintiu Gherlii,pressone.ro,0,0,1,1,0.0,0.0
Mircea Abrudean,pressone.ro,0,0,1,1,0.0,0.0
Mărișel,pressone.ro,0,0,1,1,0.0,0.0
Nicoară,pressone.ro,0,1,0,1,-1.0,1.0
Nicolae Grosan,pressone.ro,0,0,1,1,0.0,0.0
Radu Mihai Oros,pressone.ro,0,0,1,1,0.0,0.0
taximetrist,pressone.ro,0,2,1,3,-0.6666666666666666,0.6666666666666666
Uioreanu,pressone.ro,0,1,0,1,-1.0,1.0
Vasile Trif,pressone.ro,0,0,1,1,0.0,0.0
Țaga,pressone.ro,0,0,1,1,0.0,0.0
Guvern,www.romaniatv.net,0,1,0,1,-1.0,1.0
liberal,www.romaniatv.net,0,3,1,4,-0.75,0.75
scriitor,www.romaniatv.net,0,0,1,1,0.0,0.0
Hans Klein,www.antena3.ro,0,0,2,2,0.0,0.0
Ioan Cindrea,www.antena3.ro,0,0,1,1,0.0,0.0
Klein,www.antena3.ro,0,0,1,1,0.0,0.0
edil,www.antena3.ro,0,3,3,6,-0.5,0.5
inspector general,www.antena3.ro,0,0,1,1,0.0,0.0
mentor,www.antena3.ro,1,0,1,2,0.5,0.5
decident,adevarul.ro,0,1,0,1,-1.0,1.0
Marius Septimiu Avram,agerpres.ro,0,0,2,2,0.0,0.0
Vasile Dîncu,agerpres.ro,0,0,4,4,0.0,0.0
Amedeea,snoop.ro,0,0,1,1,0.0,0.0
Bihor,snoop.ro,0,2,2,4,-0.5,0.5
Borșa,snoop.ro,0,0,1,1,0.0,0.0
Brăila,snoop.ro,0,0,2,2,0.0,0.0
Bălăceanca,snoop.ro,0,0,1,1,0.0,0.0
Cristian Teodorescu,snoop.ro,0,0,1,1,0.0,0.0
Georgiana Pascu,snoop.ro,1,0,2,3,0.3333333333333333,0.3333333333333333
Mariana Armean,snoop.ro,0,0,2,2,0.0,0.0
N,snoop.ro,0,1,0,1,-1.0,1.0
Pascu,snoop.ro,0,0,1,1,0.0,0.0
Socola,snoop.ro,0,1,0,1,-1.0,1.0
Teodorescu,snoop.ro,0,0,2,2,0.0,0.0
Ulisei Grosu,snoop.ro,0,0,1,1,0.0,0.0
Valentin,snoop.ro,0,0,2,2,0.0,0.0
Vlad Stroescu,snoop.ro,0,0,2,2,0.0,0.0
adulți,snoop.ro,0,0,2,2,0.0,0.0
asistent social,snoop.ro,0,0,3,3,0.0,0.0
comandant,snoop.ro,0,1,1,2,-0.5,0.5
cronic,snoop.ro,0,1,0,1,-1.0,1.0
infirmier,snoop.ro,0,0,1,1,0.0,0.0
miniștri,snoop.ro,0,1,3,4,-0.25,0.25
personal medical,snoop.ro,0,2,1,3,-0.6666666666666666,0.6666666666666666
profesionist,snoop.ro,1,0,2,3,0.3333333333333333,0.3333333333333333
Dan Prelipceanu,snoop.ro,0,0,2,2,0.0,0.0
tutorel,snoop.ro,0,1,0,1,-1.0,1.0
Ștei,snoop.ro,0,1,0,1,-1.0,1.0
adept,primanews.ro,1,0,1,2,0.5,0.5
Andrew Tate,primanews.ro,0,0,1,1,0.0,0.0
António Costa,primanews.ro,0,0,1,1,0.0,0.0
Donald Tusk,primanews.ro,1,0,3,4,0.25,0.25
Florin Sandu,primanews.ro,0,0,1,1,0.0,0.0
Frații,primanews.ro,0,1,0,1,-1.0,1.0
Ion Iliescu,primanews.ro,0,3,2,5,-0.6,0.6
Maia Sandu,primanews.ro,2,1,1,4,0.25,0.25
Moldova,primanews.ro,1,0,2,3,0.3333333333333333,0.3333333333333333
Nicolae Ceaușescu,primanews.ro,0,2,0,2,-1.0,1.0
Slovac,primanews.ro,0,0,1,1,0.0,0.0
Tristan Tate,primanews.ro,0,0,1,1,0.0,0.0
Ungarie,primanews.ro,0,1,3,4,-0.25,0.25
admirator,primanews.ro,0,1,1,2,-0.5,0.5
adversar,primanews.ro,0,3,0,3,-1.0,1.0
dictator,primanews.ro,0,1,0,1,-1.0,1.0
etic,primanews.ro,0,0,1,1,0.0,0.0
frate,primanews.ro,0,0,1,1,0.0,0.0
frați,primanews.ro,0,0,1,1,0.0,0.0
geniu,primanews.ro,0,0,1,1,0.0,0.0
outsider,primanews.ro,0,1,0,1,-1.0,1.0
trădător,primanews.ro,0,2,0,2,-1.0,1.0
ultranaționalist,primanews.ro,0,1,0,1,-1.0,1.0
Bogdan Ivan,www.digi24.ro,0,0,3,3,0.0,0.0
Toni Greblă,www.digi24.ro,0,0,4,4,0.0,0.0
Alvaro Paciello,www.aktual24.ro,0,0,1,1,0.0,0.0
Argentina,www.aktual24.ro,0,0,1,1,0.0,0.0
Brazilia,www.aktual24.ro,0,0,1,1,0.0,0.0
Carlos Casal,www.aktual24.ro,0,0,1,1,0.0,0.0
Claudia Sheinbaum,www.aktual24.ro,1,0,0,1,1.0,1.0
Columbia,www.aktual24.ro,0,0,1,1,0.0,0.0
Gustavo Petro,www.aktual24.ro,0,0,1,1,0.0,0.0
Jose Mujica,www.aktual24.ro,0,0,1,1,0.0,0.0
Lucia Topolansky,www.aktual24.ro,0,0,1,1,0.0,0.0
Luiz Inacio Lula da Silva,www.aktual24.ro,1,0,0,1,1.0,1.0
Montevideo,www.aktual24.ro,0,0,1,1,0.0,0.0
Mujica,www.aktual24.ro,0,0,1,1,0.0,0.0
New York,www.aktual24.ro,0,0,1,1,0.0,0.0
Pedro Sanchez,www.aktual24.ro,0,0,2,2,0.0,0.0
Rio de Janeiro,www.aktual24.ro,0,0,1,1,0.0,0.0
Tabare Vasquez,www.aktual24.ro,0,0,1,1,0.0,0.0
Uruguay,www.aktual24.ro,0,0,2,2,0.0,0.0
Walter Larus,www.aktual24.ro,0,0,1,1,0.0,0.0
Yamandu Orsi,www.aktual24.ro,0,0,1,1,0.0,0.0
bar,www.aktual24.ro,0,1,0,1,-1.0,1.0
chelner,www.aktual24.ro,0,1,0,1,-1.0,1.0
decedat,www.aktual24.ro,0,0,1,1,0.0,0.0
fondator,www.aktual24.ro,1,0,4,5,0.2,0.2
luptător,www.aktual24.ro,1,0,0,1,1.0,1.0
mostenitor,www.aktual24.ro,0,0,1,1,0.0,0.0
oaspete,www.aktual24.ro,0,0,1,1,0.0,0.0
soție,www.aktual24.ro,0,2,9,11,-0.18181818181818182,0.18181818181818182
Cristian Popescu Piedone,www.cotidianul.ro,0,0,4,4,0.0,0.0
Giurgiu,www.cotidianul.ro,0,0,2,2,0.0,0.0
Piedone,www.cotidianul.ro,0,2,0,2,-1.0,1.0
Ion Cristoiu,www.romaniatv.net,0,1,0,1,-1.0,1.0
miliardar,www.romaniatv.net,0,1,1,2,-0.5,0.5
Nea Gigi,www.romaniatv.net,0,4,0,4,-1.0,1.0
doctor,www.romaniatv.net,1,1,1,3,0.0,0.0
nea Gigi,www.romaniatv.net,0,2,0,2,-1.0,1.0
împărat,www.romaniatv.net,0,2,0,2,-1.0,1.0
Ucraina,agerpres.ro,1,0,5,6,0.16666666666666666,0.16666666666666666
admirator,agerpres.ro,0,0,1,1,0.0,0.0
adversar,agerpres.ro,0,2,0,2,-1.0,1.0
analist,agerpres.ro,0,2,7,9,-0.2222222222222222,0.2222222222222222
emigrant,agerpres.ro,0,0,1,1,0.0,0.0
șef de stat,agerpres.ro,0,0,1,1,0.0,0.0
Barnier,primanews.ro,0,0,1,1,0.0,0.0
oponent,primanews.ro,0,1,0,1,-1.0,1.0
Michel Barnier,primanews.ro,0,1,1,2,-0.5,0.5
cioloș,recorder.ro,0,0,3,3,0.0,0.0
Dan Barna,recorder.ro,0,0,5,5,0.0,0.0
Mihai Răzvan Ungureanu,recorder.ro,0,0,2,2,0.0,0.0
Nicu Ștefănuță,recorder.ro,0,0,1,1,0.0,0.0
Viorel Lis,recorder.ro,0,0,1,1,0.0,0.0
Vlad Botoș,recorder.ro,0,0,2,2,0.0,0.0
Vlad Gheorghe,recorder.ro,0,0,4,4,0.0,0.0
Cîrstoiu,www.gandul.ro,1,0,1,2,0.5,0.5
Vlad Voiculescu,www.gandul.ro,0,0,2,2,0.0,0.0
avocat,www.gandul.ro,0,0,4,4,0.0,0.0
Apostolos Tzitzikostas,www.gandul.ro,0,0,2,2,0.0,0.0
Ekaterina Zaharieva,www.gandul.ro,0,0,1,1,0.0,0.0
Roxana Mînzatu,www.gandul.ro,1,0,5,6,0.16666666666666666,0.16666666666666666
guvernator,www.gandul.ro,0,0,1,1,0.0,0.0
Dragnea,www.antena3.ro,0,2,0,2,-1.0,1.0
prezentator,www.antena3.ro,0,2,0,2,-1.0,1.0
Soros,www.antena3.ro,0,2,0,2,-1.0,1.0
adversar,www.antena3.ro,0,3,0,3,-1.0,1.0
analist,www.antena3.ro,0,1,5,6,-0.16666666666666666,0.16666666666666666
analist politic,www.antena3.ro,0,0,1,1,0.0,0.0
patriot,www.antena3.ro,1,2,1,4,-0.25,0.25
soroșist,www.antena3.ro,0,1,0,1,-1.0,1.0
Alin Cocoș,observatornews.ro,0,0,1,1,0.0,0.0
Alina Bica,observatornews.ro,0,0,1,1,0.0,0.0
Alinei Bica,observatornews.ro,0,0,1,1,0.0,0.0
apărător,observatornews.ro,0,0,1,1,0.0,0.0
avocat,observatornews.ro,0,1,7,8,-0.125,0.125
Bica,observatornews.ro,0,0,1,1,0.0,0.0
Costa Rica,observatornews.ro,0,0,2,2,0.0,0.0
Crinuța Dumitrean,observatornews.ro,0,0,1,1,0.0,0.0
Cătălin Teodorescu,observatornews.ro,0,0,1,1,0.0,0.0
Dorin Cocoș,observatornews.ro,0,0,1,1,0.0,0.0
Doru Trăilă,observatornews.ro,0,0,2,2,0.0,0.0
Dragoș Bogdan,observatornews.ro,0,0,1,1,0.0,0.0
Ionuț Mihăilescu,observatornews.ro,0,0,1,1,0.0,0.0
Lăcrămioara Alexandru,observatornews.ro,0,0,1,1,0.0,0.0
Remus Baciu,observatornews.ro,0,0,1,1,0.0,0.0
San Jose,observatornews.ro,0,0,1,1,0.0,0.0
Sebastian Ghiță,observatornews.ro,0,0,1,1,0.0,0.0
Sergiu Diacomatu,observatornews.ro,0,0,1,1,0.0,0.0
Sorina Matei,observatornews.ro,0,0,1,1,0.0,0.0
Stelian Gheorghe,observatornews.ro,0,0,1,1,0.0,0.0
Trăilă,observatornews.ro,0,0,1,1,0.0,0.0
Emil Nuțiu,observatornews.ro,0,0,1,1,0.0,0.0
fiu,observatornews.ro,0,0,2,2,0.0,0.0
medic,observatornews.ro,0,2,2,4,-0.5,0.5
refugiat,observatornews.ro,1,0,3,4,0.25,0.25
șefă,observatornews.ro,0,1,3,4,-0.25,0.25
Giorgia Meloni,www.g4media.ro,0,0,1,1,0.0,0.0
Mureș,www.g4media.ro,0,0,5,5,0.0,0.0
Satu Mare,www.g4media.ro,0,0,4,4,0.0,0.0
Dan Tănasă,www.g4media.ro,0,0,1,1,0.0,0.0
Bratovoiești,recorder.ro,0,0,1,1,0.0,0.0
Lia Olguța Vasilescu,recorder.ro,0,0,3,3,0.0,0.0
Marius Simcelescu,recorder.ro,0,0,1,1,0.0,0.0
Viorica Dăncila,recorder.ro,0,0,1,1,0.0,0.0
invitat,recorder.ro,0,0,3,3,0.0,0.0
Dominic Fritz,www.digi24.ro,0,0,2,2,0.0,0.0
Fritz,www.digi24.ro,0,0,1,1,0.0,0.0
Ionuț Moșteanu,www.digi24.ro,0,2,7,9,-0.2222222222222222,0.2222222222222222
Moșteanu,www.digi24.ro,0,1,4,5,-0.2,0.2
participanți,www.digi24.ro,0,0,1,1,0.0,0.0
Gabriel Andronache,stirileprotv.ro,0,0,1,1,0.0,0.0
Daniel David,www.cotidianul.ro,0,0,2,2,0.0,0.0
Bruno Le Maire,www.euronews.ro,0,1,0,1,-1.0,1.0
Carmen Harra,a1.ro,0,0,1,1,0.0,0.0
Corneliu Zelea Codreanu,a1.ro,0,1,0,1,-1.0,1.0
Cristela,a1.ro,1,1,10,12,0.0,0.0
Cristela Georgescu,a1.ro,0,0,6,6,0.0,0.0
Robert Morse,a1.ro,0,0,1,1,0.0,0.0
Elena,a1.ro,0,1,1,2,-0.5,0.5
Geneva,a1.ro,0,0,2,2,0.0,0.0
Ion Antonescu,a1.ro,0,2,1,3,-0.6666666666666666,0.6666666666666666
Marcian Bleahu,a1.ro,0,0,1,1,0.0,0.0
Partenera,a1.ro,0,0,1,1,0.0,0.0
Sorin Frunzăverde,a1.ro,0,0,1,1,0.0,0.0
autor,a1.ro,0,1,4,5,-0.2,0.2
cadru didactic,a1.ro,0,0,1,1,0.0,0.0
consultant,a1.ro,0,0,1,1,0.0,0.0
erou,a1.ro,1,0,1,2,0.5,0.5
inginer,a1.ro,0,2,1,3,-0.6666666666666666,0.6666666666666666
milionar,a1.ro,0,0,1,1,0.0,0.0
secretar general,a1.ro,0,1,4,5,-0.2,0.2
speaker,a1.ro,1,0,0,1,1.0,1.0
trainer,a1.ro,1,0,0,1,1.0,1.0
Gheorghe Paunescu,a1.ro,0,0,1,1,0.0,0.0
fratii Paunescu,a1.ro,0,0,1,1,0.0,0.0
Cristian Popescu Piedone,www.euronews.ro,0,1,1,2,-0.5,0.5
Armand,adevarul.ro,0,0,1,1,0.0,0.0
Ciprian Necula,adevarul.ro,0,0,1,1,0.0,0.0
Clotilde Armand,adevarul.ro,0,1,5,6,-0.16666666666666666,0.16666666666666666
Constanța,adevarul.ro,0,1,6,7,-0.14285714285714285,0.14285714285714285
Cristian Gentea,adevarul.ro,0,0,1,1,0.0,0.0
Dan Barna,adevarul.ro,0,0,7,7,0.0,0.0
George Scripcaru,adevarul.ro,0,0,1,1,0.0,0.0
George Tuță,adevarul.ro,0,0,5,5,0.0,0.0
Ionuț Mosteanu,adevarul.ro,0,0,4,4,0.0,0.0
Irineu Darău,adevarul.ro,0,1,1,2,-0.5,0.5
Nicolae Robu,adevarul.ro,0,0,2,2,0.0,0.0
Vergil Chițac,adevarul.ro,0,0,2,2,0.0,0.0
Vlad Voiculescu,adevarul.ro,0,0,3,3,0.0,0.0
Mihai Coteț,adevarul.ro,0,1,1,2,-0.5,0.5
opozant,adevarul.ro,0,2,0,2,-1.0,1.0
pucist,adevarul.ro,0,1,0,1,-1.0,1.0
Vladimir Ionaș,adevarul.ro,0,0,8,8,0.0,0.0
învingător,adevarul.ro,0,0,1,1,0.0,0.0
Mirel Palada,adevarul.ro,0,0,5,5,0.0,0.0
Cernăuți,www.gandul.ro,0,1,0,1,-1.0,1.0
Cezar Moise,www.gandul.ro,0,0,1,1,0.0,0.0
federație,www.gandul.ro,0,1,0,1,-1.0,1.0
Florin Manole,www.gandul.ro,0,0,1,1,0.0,0.0
Lulea,www.gandul.ro,0,3,0,3,-1.0,1.0
Mario De Mezzo,www.gandul.ro,0,0,1,1,0.0,0.0
Oana Țoiu,www.gandul.ro,0,0,2,2,0.0,0.0
participanți,www.gandul.ro,0,0,1,1,0.0,0.0
Radu Miruță,www.gandul.ro,0,0,1,1,0.0,0.0
Robert Sighiartău,www.gandul.ro,0,0,1,1,0.0,0.0
Sanda Nicola,www.gandul.ro,0,0,1,1,0.0,0.0
Gâdea,www.gandul.ro,0,0,1,1,0.0,0.0
Iorgovan,www.gandul.ro,0,0,1,1,0.0,0.0
dvs,www.gandul.ro,0,0,1,1,0.0,0.0
Falca,a1.ro,0,1,0,1,-1.0,1.0
George Maior,a1.ro,0,0,2,2,0.0,0.0
Cătălin Drulă,www.gandul.ro,0,0,2,2,0.0,0.0
Ionuț Moșteanu,www.gandul.ro,0,2,5,7,-0.2857142857142857,0.2857142857142857
Andrei,www.gandul.ro,0,0,1,1,0.0,0.0
fan,www.gandul.ro,1,0,1,2,0.5,0.5
IA,www.comisarul.ro,0,0,1,1,0.0,0.0
Mihaela,www.comisarul.ro,0,1,0,1,-1.0,1.0
s,www.comisarul.ro,0,1,0,1,-1.0,1.0
Amsterdam,pressone.ro,0,0,1,1,0.0,0.0
Georgescu domn Ciolacu,pressone.ro,0,1,0,1,-1.0,1.0
Gerogescu,pressone.ro,0,1,0,1,-1.0,1.0
Groningen,pressone.ro,0,0,1,1,0.0,0.0
Haga,pressone.ro,0,0,1,1,0.0,0.0
Rotterdam,pressone.ro,0,0,1,1,0.0,0.0
studentă,pressone.ro,1,2,4,7,-0.14285714285714285,0.14285714285714285
Țărilor de Jos,pressone.ro,0,0,1,1,0.0,0.0
AUR,www.activenews.ro,2,0,0,2,1.0,1.0
Alina Gorghiu,www.activenews.ro,0,0,1,1,0.0,0.0
Amantele,www.activenews.ro,0,1,0,1,-1.0,1.0
Baconschi,www.activenews.ro,0,1,0,1,-1.0,1.0
Bănescu,www.activenews.ro,0,2,0,2,-1.0,1.0
chiriarh,www.activenews.ro,0,0,1,1,0.0,0.0
cioloș,www.activenews.ro,0,2,0,2,-1.0,1.0
cleric,www.activenews.ro,0,1,1,2,-0.5,0.5
Dan Barna,www.activenews.ro,0,0,1,1,0.0,0.0
Dragnea,www.activenews.ro,0,1,0,1,-1.0,1.0
Drulă,www.activenews.ro,0,1,0,1,-1.0,1.0
Ioan,www.activenews.ro,0,0,1,1,0.0,0.0
LGBT,www.activenews.ro,0,1,0,1,-1.0,1.0
Lasconi,www.activenews.ro,0,5,2,7,-0.7142857142857143,0.7142857142857143
Mitropolitul Banatului,www.activenews.ro,0,0,1,1,0.0,0.0
Patriarh Teoctist,www.activenews.ro,0,0,1,1,0.0,0.0
Teoctist,www.activenews.ro,0,1,0,1,-1.0,1.0
Pleșu,www.activenews.ro,0,2,0,2,-1.0,1.0
Sfântul Paisie Aghioritul,www.activenews.ro,0,0,1,1,0.0,0.0
Sfântul Duh,www.activenews.ro,2,0,0,2,1.0,1.0
Virgiliu Gheorghe Vlăescu,www.activenews.ro,1,1,1,3,0.0,0.0
alegător,www.activenews.ro,0,3,1,4,-0.75,0.75
antihrișt,www.activenews.ro,0,1,0,1,-1.0,1.0
cler,www.activenews.ro,0,1,0,1,-1.0,1.0
deservenț,www.activenews.ro,0,1,0,1,-1.0,1.0
diacon,www.activenews.ro,0,1,3,4,-0.25,0.25
ea,www.activenews.ro,0,2,0,2,-1.0,1.0
enoriaș,www.activenews.ro,1,0,0,1,1.0,1.0
iștilor,www.activenews.ro,0,1,0,1,-1.0,1.0
lor,www.activenews.ro,0,2,0,2,-1.0,1.0
militant,www.activenews.ro,0,1,0,1,-1.0,1.0
monahie,www.activenews.ro,0,0,1,1,0.0,0.0
sclav,www.activenews.ro,0,1,0,1,-1.0,1.0
senator,www.activenews.ro,0,1,3,4,-0.25,0.25
slugă,www.activenews.ro,0,5,0,5,-1.0,1.0
Alexandru Rafila,observatornews.ro,0,0,3,3,0.0,0.0
Angel Tîlvăr,observatornews.ro,0,0,3,3,0.0,0.0
Ciprian Șerban,observatornews.ro,0,0,1,1,0.0,0.0
Daniel Mipe,observatornews.ro,0,0,1,1,0.0,0.0
Emil Hurezeanu,observatornews.ro,0,2,3,5,-0.4,0.4
Florin-Ionuț Barbu,observatornews.ro,0,0,1,1,0.0,0.0
Natalia Intotero,observatornews.ro,0,0,3,3,0.0,0.0
Oprescu,observatornews.ro,0,0,1,1,0.0,0.0
Simona Bucura,observatornews.ro,0,0,1,1,0.0,0.0
India,www.aktual24.ro,0,0,2,2,0.0,0.0
Modi,www.aktual24.ro,0,1,0,1,-1.0,1.0
Poonam Muttreja,www.aktual24.ro,0,0,1,1,0.0,0.0
conducător,www.aktual24.ro,0,4,0,4,-1.0,1.0
soție,www.cotidianul.ro,0,0,6,6,0.0,0.0
străbun,www.cotidianul.ro,1,0,0,1,1.0,1.0
Cotroceni,www.realitatea.net,0,0,4,4,0.0,0.0
Horațiu Potra,observatornews.ro,0,1,2,3,-0.3333333333333333,0.3333333333333333
Marin Burcea,observatornews.ro,0,0,2,2,0.0,0.0
bodyguard,observatornews.ro,0,1,0,1,-1.0,1.0
Rusia,agerpres.ro,0,2,0,2,-1.0,1.0
Duduieni,www.gandul.ro,0,1,0,1,-1.0,1.0
Emi Pian,www.gandul.ro,0,1,0,1,-1.0,1.0
politic,www.gandul.ro,0,0,1,1,0.0,0.0
Silviu Mototolea,www.gandul.ro,0,1,0,1,-1.0,1.0
Simona,www.gandul.ro,0,0,1,1,0.0,0.0
Simona Spătaru,www.gandul.ro,0,1,0,1,-1.0,1.0
moralist,www.gandul.ro,0,1,0,1,-1.0,1.0
văduvă,www.gandul.ro,0,1,0,1,-1.0,1.0
văr primar,www.gandul.ro,0,1,0,1,-1.0,1.0
Beijingul,www.euronews.ro,0,0,1,1,0.0,0.0
Chinei,www.euronews.ro,0,0,1,1,0.0,0.0
Graham Doyle,www.euronews.ro,0,0,1,1,0.0,0.0
Statele Unite ale Americii,www.euronews.ro,0,0,2,2,0.0,0.0
posesor,www.euronews.ro,0,0,1,1,0.0,0.0
purtător de cuvânt,www.euronews.ro,0,1,11,12,-0.08333333333333333,0.08333333333333333
utilizator,www.euronews.ro,0,0,2,2,0.0,0.0
Dominic,www.comisarul.ro,0,0,1,1,0.0,0.0
Fritz,www.comisarul.ro,0,1,1,2,-0.5,0.5
moderator,www.comisarul.ro,0,1,4,5,-0.2,0.2
Bogdan Ivan,www.euronews.ro,0,0,2,2,0.0,0.0
Gabriela Firea,www.euronews.ro,0,1,9,10,-0.1,0.1
Lia Olguța Vasilescu,www.euronews.ro,0,0,1,1,0.0,0.0
Paul Stănescu,www.euronews.ro,0,1,2,3,-0.3333333333333333,0.3333333333333333
factor,www.euronews.ro,0,0,1,1,0.0,0.0
Ceaușescu,www.gandul.ro,0,3,0,3,-1.0,1.0
colaborator,www.gandul.ro,0,6,0,6,-1.0,1.0
Dan Voiculescu,www.gandul.ro,0,1,2,3,-0.3333333333333333,0.3333333333333333
Florin Pâslaru,www.gandul.ro,0,1,0,1,-1.0,1.0
Galați,www.gandul.ro,0,0,2,2,0.0,0.0
consul,www.gandul.ro,0,1,1,2,-0.5,0.5
Voiculescu,www.gandul.ro,0,1,1,2,-0.5,0.5
intelectual,www.gandul.ro,0,1,0,1,-1.0,1.0
slugă,www.gandul.ro,0,4,0,4,-1.0,1.0
trădător,www.gandul.ro,0,1,0,1,-1.0,1.0
Varujan Pambuccian,www.euronews.ro,0,0,3,3,0.0,0.0
America,www.cotidianul.ro,1,1,0,2,0.0,0.0
Andrei,www.cotidianul.ro,1,0,0,1,1.0,1.0
Băsescu,www.cotidianul.ro,0,3,1,4,-0.75,0.75
China,www.cotidianul.ro,0,0,4,4,0.0,0.0
Coreea de Nord,www.cotidianul.ro,0,2,0,2,-1.0,1.0
Geoană,www.cotidianul.ro,0,2,1,3,-0.6666666666666666,0.6666666666666666
Irina,www.cotidianul.ro,1,0,0,1,1.0,1.0
Năstase,www.cotidianul.ro,0,1,0,1,-1.0,1.0
Ponta,www.cotidianul.ro,0,7,1,8,-0.875,0.875
coechipier,www.cotidianul.ro,0,1,0,1,-1.0,1.0
consultant,www.cotidianul.ro,0,1,0,1,-1.0,1.0
om de stat,www.cotidianul.ro,1,0,0,1,1.0,1.0
Netanyahu,www.cotidianul.ro,0,1,0,1,-1.0,1.0
profesionist,www.cotidianul.ro,2,0,1,3,0.6666666666666666,0.6666666666666666
sfătuitor,www.cotidianul.ro,0,0,1,1,0.0,0.0
suporter,www.cotidianul.ro,0,1,0,1,-1.0,1.0
Harkov,recorder.ro,0,0,1,1,0.0,0.0
Kremlin,recorder.ro,0,2,0,2,-1.0,1.0
Ursu,recorder.ro,0,1,0,1,-1.0,1.0
evazioniști,recorder.ro,0,1,0,1,-1.0,1.0
pesediști,recorder.ro,0,2,0,2,-1.0,1.0
securist,recorder.ro,0,2,0,2,-1.0,1.0
afacerist,www.antena3.ro,0,4,0,4,-1.0,1.0
Daniel Zamfir,adevarul.ro,0,2,1,3,-0.6666666666666666,0.6666666666666666
Ursu,www.luju.ro,0,0,1,1,0.0,0.0
secretar de stat,www.luju.ro,0,0,2,2,0.0,0.0
Kathleen Kavalec,www.news.ro,0,0,1,1,0.0,0.0
Mihai Tudose,www.news.ro,0,1,4,5,-0.2,0.2
Tudose,www.news.ro,0,0,1,1,0.0,0.0
ambasadoare,www.news.ro,0,1,0,1,-1.0,1.0
băiat,www.news.ro,0,1,1,2,-0.5,0.5
tineret,www.news.ro,1,0,0,1,1.0,1.0
bugetar,www.cotidianul.ro,0,1,0,1,-1.0,1.0
Adrian Cozma,recorder.ro,0,0,2,2,0.0,0.0
Doha,recorder.ro,0,0,1,1,0.0,0.0
Mureș,recorder.ro,0,0,3,3,0.0,0.0
Peter Ferenc,recorder.ro,0,0,1,1,0.0,0.0
Qatar,recorder.ro,0,1,1,2,-0.5,0.5
responsabil,recorder.ro,0,2,0,2,-1.0,1.0
Robert Sighiartău,recorder.ro,0,0,2,2,0.0,0.0
Satu Mare,recorder.ro,0,0,4,4,0.0,0.0
Târgu Mureș,recorder.ro,0,0,3,3,0.0,0.0
Unora,recorder.ro,0,1,0,1,-1.0,1.0
bistrițean,recorder.ro,0,0,1,1,0.0,0.0
datornic,recorder.ro,0,1,0,1,-1.0,1.0
emisar,recorder.ro,0,2,4,6,-0.3333333333333333,0.3333333333333333
ostaș,recorder.ro,0,1,0,1,-1.0,1.0
Netanyahu,recorder.ro,0,2,0,2,-1.0,1.0
Dan Barna,www.g4media.ro,0,0,2,2,0.0,0.0
eurodeputat,www.g4media.ro,0,1,0,1,-1.0,1.0
García,www.g4media.ro,0,0,1,1,0.0,0.0
Iratxe García,www.g4media.ro,0,0,1,1,0.0,0.0
Manfred Weber,www.g4media.ro,0,1,0,1,-1.0,1.0
Weber,www.g4media.ro,0,0,1,1,0.0,0.0
Adrian Solomon,primanews.ro,0,0,1,1,0.0,0.0
magistrat,primanews.ro,0,2,4,6,-0.3333333333333333,0.3333333333333333
Tanczos Barna,agerpres.ro,0,0,2,2,0.0,0.0
Alexandrescu,www.aktual24.ro,0,1,0,1,-1.0,1.0
Dianei Sosoaca,www.aktual24.ro,0,1,5,6,-0.16666666666666666,0.16666666666666666
Sosoaca,www.aktual24.ro,0,6,3,9,-0.6666666666666666,0.6666666666666666
delegat,www.aktual24.ro,0,0,1,1,0.0,0.0
Adrian Năstase,www.cotidianul.ro,0,2,0,2,-1.0,1.0
Alina Ștefania Ghorghiu,www.cotidianul.ro,0,1,0,1,-1.0,1.0
Avram Iancu,www.cotidianul.ro,1,0,0,1,1.0,1.0
Blaj,www.cotidianul.ro,0,0,1,1,0.0,0.0
Constantin Dăscălescu,www.cotidianul.ro,0,0,1,1,0.0,0.0
Cristian Diaconescu,www.cotidianul.ro,0,0,1,1,0.0,0.0
Cristinel,www.cotidianul.ro,1,2,0,3,-0.3333333333333333,0.3333333333333333
Dacian Cioloș,www.cotidianul.ro,0,0,1,1,0.0,0.0
Dan Voiculescu,www.cotidianul.ro,0,2,0,2,-1.0,1.0
Elena Udrea,www.cotidianul.ro,0,3,0,3,-1.0,1.0
Enache,www.cotidianul.ro,0,0,2,2,0.0,0.0
Florian Coldea,www.cotidianul.ro,0,0,2,2,0.0,0.0
Flutur,www.cotidianul.ro,0,1,1,2,-0.5,0.5
Gabriel Oprea,www.cotidianul.ro,0,1,0,1,-1.0,1.0
Gheorghe Flutur,www.cotidianul.ro,0,2,0,2,-1.0,1.0
Horea,www.cotidianul.ro,0,0,1,1,0.0,0.0
Iancu,www.cotidianul.ro,1,0,0,1,1.0,1.0
Iași,www.cotidianul.ro,0,1,3,4,-0.25,0.25
Ioan Oltean,www.cotidianul.ro,0,1,0,1,-1.0,1.0
Ioan Rus,www.cotidianul.ro,0,2,0,2,-1.0,1.0
Ion Marcel Ciolacu,www.cotidianul.ro,0,2,0,2,-1.0,1.0
Cristinel Grosu,www.cotidianul.ro,0,2,0,2,-1.0,1.0
Liviu Dăscălescu,www.cotidianul.ro,0,0,1,1,0.0,0.0
Lucian Pahonțu,www.cotidianul.ro,0,0,1,1,0.0,0.0
oficial,www.cotidianul.ro,0,3,1,4,-0.75,0.75
Sebastian Ghiță,www.cotidianul.ro,0,1,0,1,-1.0,1.0
Traian Băsescu,www.cotidianul.ro,0,4,1,5,-0.8,0.8
Valeriu Stoica,www.cotidianul.ro,0,1,0,1,-1.0,1.0
Vasile Milea,www.cotidianul.ro,0,0,1,1,0.0,0.0
Viorel Hrebenciuc,www.cotidianul.ro,0,1,0,1,-1.0,1.0
amic,www.cotidianul.ro,0,2,0,2,-1.0,1.0
director,www.cotidianul.ro,0,2,3,5,-0.4,0.4
erou,www.cotidianul.ro,2,1,0,3,0.3333333333333333,0.3333333333333333
general,www.cotidianul.ro,0,7,2,9,-0.7777777777777778,0.7777777777777778
Gheorghe Dan,www.cotidianul.ro,0,0,1,1,0.0,0.0
Grosu,www.cotidianul.ro,0,1,0,1,-1.0,1.0
Maricel Nechita,www.cotidianul.ro,0,0,1,1,0.0,0.0
jupân,www.cotidianul.ro,0,0,1,1,0.0,0.0
nepot,www.cotidianul.ro,0,1,1,2,-0.5,0.5
Călin Popescu-Tăriceanu,www.cotidianul.ro,0,0,1,1,0.0,0.0
premierul Ion Marcel Ciolacu,www.cotidianul.ro,0,1,0,1,-1.0,1.0
subaltern,www.cotidianul.ro,0,2,0,2,-1.0,1.0
Gheorghe Diaconescu,www.cotidianul.ro,0,0,1,1,0.0,0.0
Gheorghiță,www.cotidianul.ro,0,2,0,2,-1.0,1.0
Virgil Ardelean,www.cotidianul.ro,0,0,1,1,0.0,0.0
director general,primanews.ro,0,0,1,1,0.0,0.0
Giurgiu,primanews.ro,0,0,2,2,0.0,0.0
Viktor Orban,primanews.ro,0,1,3,4,-0.25,0.25
amândoi,primanews.ro,0,0,1,1,0.0,0.0
președintele Klaus Iohannis,primanews.ro,0,0,1,1,0.0,0.0
Firea,www.aktual24.ro,0,2,6,8,-0.25,0.25
Gabriela Firea,www.aktual24.ro,0,6,7,13,-0.46153846153846156,0.46153846153846156
Coțofănești,www.cotidianul.ro,0,0,1,1,0.0,0.0
Olanda,www.cotidianul.ro,0,1,0,1,-1.0,1.0
Raluca Turcan,www.cotidianul.ro,0,1,0,1,-1.0,1.0
Sarmizegetusa,www.cotidianul.ro,1,0,0,1,1.0,1.0
Schengen,www.cotidianul.ro,0,1,1,2,-0.5,0.5
străin,www.cotidianul.ro,1,0,0,1,1.0,1.0
Andrei Traian Poenariu,snoop.ro,0,0,1,1,0.0,0.0
Camelia,snoop.ro,0,0,1,1,0.0,0.0
Corina,snoop.ro,0,0,2,2,0.0,0.0
Cristian Piedone,snoop.ro,0,0,1,1,0.0,0.0
Cristian Popescu Piedone,snoop.ro,0,1,8,9,-0.1111111111111111,0.1111111111111111
Dan Voiculescu,snoop.ro,0,0,2,2,0.0,0.0
Diana Maria Cristea,snoop.ro,0,0,1,1,0.0,0.0
Dinastia Piedone,snoop.ro,0,0,1,1,0.0,0.0
Geca,snoop.ro,0,1,0,1,-1.0,1.0
Gelu,snoop.ro,0,0,1,1,0.0,0.0
Gelu Palamaru,snoop.ro,0,0,1,1,0.0,0.0
Gheorghe Flutur,snoop.ro,0,0,1,1,0.0,0.0
Ilie,snoop.ro,0,0,1,1,0.0,0.0
Ion Mateș,snoop.ro,0,0,4,4,0.0,0.0
Ionel Ilie,snoop.ro,0,0,1,1,0.0,0.0
Ionel Tucmuruz,snoop.ro,0,2,2,4,-0.5,0.5
Iulian Cârlogea,snoop.ro,0,0,3,3,0.0,0.0
Mircea Horațiu Nicolaidis,snoop.ro,0,0,1,1,0.0,0.0
Măgurele,snoop.ro,0,0,1,1,0.0,0.0
Octav Ganea,snoop.ro,0,0,3,3,0.0,0.0
Palamaru,snoop.ro,0,0,1,1,0.0,0.0
Piedone,snoop.ro,0,7,4,11,-0.6363636363636364,0.6363636363636364
Piedone senior,snoop.ro,0,0,1,1,0.0,0.0
Poenariu,snoop.ro,0,1,0,1,-1.0,1.0
sector,snoop.ro,0,1,1,2,-0.5,0.5
Suceava,snoop.ro,0,0,3,3,0.0,0.0
Valeria Tudora,snoop.ro,0,0,1,1,0.0,0.0
Verona,snoop.ro,0,0,1,1,0.0,0.0
Vlad,snoop.ro,0,0,1,1,0.0,0.0
Vlad Piedone,snoop.ro,0,0,2,2,0.0,0.0
voluntar,snoop.ro,0,0,1,1,0.0,0.0
acesta,snoop.ro,0,0,2,2,0.0,0.0
cioban,snoop.ro,0,0,2,2,0.0,0.0
city manager,snoop.ro,0,0,2,2,0.0,0.0
director general,snoop.ro,0,0,2,2,0.0,0.0
hacker,snoop.ro,0,7,0,7,-1.0,1.0
Vlad Popescu Piedone,snoop.ro,0,0,1,1,0.0,0.0
Voiculescu,snoop.ro,0,0,1,1,0.0,0.0
verișor,snoop.ro,0,1,1,2,-0.5,0.5
Claudiu Tîrziu,www.comisarul.ro,0,0,1,1,0.0,0.0
Golanul,www.comisarul.ro,0,1,0,1,-1.0,1.0
Hodor,www.comisarul.ro,0,1,0,1,-1.0,1.0
Mădălin Hodor,www.comisarul.ro,0,0,1,1,0.0,0.0
Rohm,www.comisarul.ro,0,0,1,1,0.0,0.0
Sosoaca,www.comisarul.ro,0,1,0,1,-1.0,1.0
Tarziu,www.comisarul.ro,0,2,0,2,-1.0,1.0
a,www.comisarul.ro,0,1,0,1,-1.0,1.0
finanțator,www.comisarul.ro,0,2,1,3,-0.6666666666666666,0.6666666666666666
garant,www.comisarul.ro,1,1,0,2,0.0,0.0
georgist,www.comisarul.ro,0,1,0,1,-1.0,1.0
golanet,www.comisarul.ro,0,1,0,1,-1.0,1.0
golan,www.comisarul.ro,0,1,0,1,-1.0,1.0
locțiitor,www.comisarul.ro,0,1,0,1,-1.0,1.0
lor,www.comisarul.ro,0,1,0,1,-1.0,1.0
mentor,www.comisarul.ro,0,0,2,2,0.0,0.0
succesor,www.comisarul.ro,0,1,0,1,-1.0,1.0
înlocuitor,www.comisarul.ro,0,1,0,1,-1.0,1.0
Tánczos Barna,www.romaniatv.net,0,0,1,1,0.0,0.0
antreprenor,www.romaniatv.net,1,2,1,4,-0.25,0.25
contribuabil,www.romaniatv.net,0,1,1,2,-0.5,0.5
proprietar,www.romaniatv.net,0,1,0,1,-1.0,1.0
George Gima,www.antena3.ro,0,0,1,1,0.0,0.0
Gima,www.antena3.ro,0,0,1,1,0.0,0.0
Ionuț Moșteanu,www.antena3.ro,0,3,10,13,-0.23076923076923078,0.23076923076923078
Moșteanu,www.antena3.ro,0,0,3,3,0.0,0.0
Dominic Fritz,www.g4media.ro,0,0,3,3,0.0,0.0
Fritz,www.g4media.ro,0,0,3,3,0.0,0.0
agresor,www.g4media.ro,0,1,0,1,-1.0,1.0
secretar general,agerpres.ro,0,0,8,8,0.0,0.0
Stănescu,agerpres.ro,0,0,1,1,0.0,0.0
Ion Iliescu,www.euronews.ro,0,0,4,4,0.0,0.0
turist,www.euronews.ro,0,1,0,1,-1.0,1.0
înainte,www.gandul.ro,0,0,1,1,0.0,0.0
Aleș,pressone.ro,0,2,1,3,-0.6666666666666666,0.6666666666666666
Bianca Gavriliță,pressone.ro,0,0,1,1,0.0,0.0
Bodog Florian,pressone.ro,0,1,0,1,-1.0,1.0
Dana Grecu,pressone.ro,0,0,1,1,0.0,0.0
Șimon,pressone.ro,0,1,1,2,-0.5,0.5
Gabriel Leș,pressone.ro,0,0,2,2,0.0,0.0
Gheorghe Baciu,pressone.ro,0,0,2,2,0.0,0.0
Ion Mocioalcă,pressone.ro,0,0,1,1,0.0,0.0
Ion Spânu,pressone.ro,0,0,1,1,0.0,0.0
Luminița Jivan,pressone.ro,0,1,0,1,-1.0,1.0
Marina Coste,pressone.ro,0,0,1,1,0.0,0.0
Robert Simonis,pressone.ro,0,1,0,1,-1.0,1.0
Ioan Chisăliță,pressone.ro,0,0,1,1,0.0,0.0
Ioan Narcis Chisăliță,pressone.ro,0,1,0,1,-1.0,1.0
Teodor Meleșcanu,pressone.ro,0,0,6,6,0.0,0.0
Viorel Ștefan,pressone.ro,0,0,1,1,0.0,0.0
Vlad Alexandrescu,pressone.ro,0,2,3,5,-0.4,0.4
altor,pressone.ro,0,1,0,1,-1.0,1.0
majoritari,pressone.ro,0,1,0,1,-1.0,1.0
mascaț,pressone.ro,0,1,0,1,-1.0,1.0
moderatoare,pressone.ro,0,0,1,1,0.0,0.0
securistă,pressone.ro,0,1,0,1,-1.0,1.0
Eugen Dogariu,pressone.ro,0,0,2,2,0.0,0.0
Aladel,www.comisarul.ro,0,0,1,1,0.0,0.0
Amara Aladel,www.comisarul.ro,0,0,1,1,0.0,0.0
educator,www.comisarul.ro,0,0,1,1,0.0,0.0
Baconschi,www.mediafax.ro,0,0,3,3,0.0,0.0
Baconshi,www.mediafax.ro,0,0,1,1,0.0,0.0
Ellen Tauscher,www.mediafax.ro,0,0,1,1,0.0,0.0
negociator,www.mediafax.ro,0,0,1,1,0.0,0.0
critic,www.realitatea.net,0,1,0,1,-1.0,1.0
Teodor Baconschi,www.mediafax.ro,0,0,2,2,0.0,0.0
demnitar,www.cotidianul.ro,0,2,0,2,-1.0,1.0
Mihnea Costoiu,www.g4media.ro,0,0,5,5,0.0,0.0
Elena Băsescu,stirileprotv.ro,0,0,1,1,0.0,0.0
Gabriel Berca,stirileprotv.ro,0,0,2,2,0.0,0.0
Sebastian Lazaroiu,stirileprotv.ro,0,0,2,2,0.0,0.0
fiică,stirileprotv.ro,0,1,1,2,-0.5,0.5
Emil Boc,www.realitatea.net,0,0,2,2,0.0,0.0
romantic,www.realitatea.net,1,0,0,1,1.0,1.0
Cazanciuc,www.antena3.ro,0,0,2,2,0.0,0.0
Daniel Suciu,www.antena3.ro,0,0,1,1,0.0,0.0
Robert Cazanciuc,www.antena3.ro,0,0,2,2,0.0,0.0
Suciu,www.antena3.ro,0,0,1,1,0.0,0.0
Alexandrescu,www.gandul.ro,0,0,1,1,0.0,0.0
Anca Alexandrescu,www.gandul.ro,0,0,1,1,0.0,0.0
Ciuca,www.gandul.ro,0,1,0,1,-1.0,1.0
moderator,www.gandul.ro,0,0,2,2,0.0,0.0
voi,www.gandul.ro,0,1,1,2,-0.5,0.5
câștigător,www.gandul.ro,1,1,1,3,0.0,0.0
Șoșoacă,www.gandul.ro,0,1,0,1,-1.0,1.0
Lucian Romașcanu,www.digi24.ro,0,2,2,4,-0.5,0.5
Naumescu,www.digi24.ro,0,0,1,1,0.0,0.0
Valentin Naumescu,www.digi24.ro,0,0,1,1,0.0,0.0
electorat,www.digi24.ro,1,3,4,8,-0.25,0.25
independent,www.digi24.ro,0,0,2,2,0.0,0.0
Ludovic Orban,www.news.ro,0,0,3,3,0.0,0.0
Orban,www.news.ro,0,0,4,4,0.0,0.0
Pârvulescu,www.news.ro,0,1,0,1,-1.0,1.0
elector,www.news.ro,0,0,4,4,0.0,0.0
Moldova,www.realitatea.net,0,1,1,2,-0.5,0.5
Moscova,www.realitatea.net,0,1,0,1,-1.0,1.0
trimis,www.realitatea.net,0,1,0,1,-1.0,1.0
Claudiu Richard Târziu,www.comisarul.ro,0,0,1,1,0.0,0.0
Târziu,www.comisarul.ro,0,2,4,6,-0.3333333333333333,0.3333333333333333
Aurescu,adevarul.ro,0,0,2,2,0.0,0.0
Republica Irlanda,adevarul.ro,0,0,1,1,0.0,0.0
Simon Coveney,adevarul.ro,0,0,1,1,0.0,0.0
Belgia,www.comisarul.ro,0,0,3,3,0.0,0.0
Ialomița,www.comisarul.ro,0,0,2,2,0.0,0.0
Sălaj,www.comisarul.ro,0,0,1,1,0.0,0.0
Timiș,www.comisarul.ro,0,0,3,3,0.0,0.0
aia,www.comisarul.ro,0,1,0,1,-1.0,1.0
cineva,www.comisarul.ro,0,0,1,1,0.0,0.0
Dinu Patriciu,www.mediafax.ro,0,1,0,1,-1.0,1.0
Gorj,www.mediafax.ro,1,0,0,1,1.0,1.0
Radu Berceanu,www.mediafax.ro,0,0,1,1,0.0,0.0
Raluca Turcanu,www.mediafax.ro,0,0,1,1,0.0,0.0
Teodor Stolojan,www.mediafax.ro,0,0,1,1,0.0,0.0
Târgu Jiu,www.mediafax.ro,0,0,1,1,0.0,0.0
Udrea,www.mediafax.ro,0,0,1,1,0.0,0.0
Viorel Hrebenciuc,www.mediafax.ro,0,1,0,1,-1.0,1.0
organizator,www.mediafax.ro,0,0,1,1,0.0,0.0
Călin Popescu-Tăriceanu,www.mediafax.ro,0,1,1,2,-0.5,0.5
Claudiu Damian,www.aktual24.ro,0,0,1,1,0.0,0.0
Damian,www.aktual24.ro,0,0,1,1,0.0,0.0
Romascanu,www.aktual24.ro,0,0,5,5,0.0,0.0
Teleorman,www.aktual24.ro,0,0,2,2,0.0,0.0
manager,www.aktual24.ro,0,1,1,2,-0.5,0.5
BobbyD,www.aktual24.ro,0,1,0,1,-1.0,1.0
Bogdan Dumitru,www.aktual24.ro,0,1,0,1,-1.0,1.0
Decebal Fagadau,www.aktual24.ro,0,1,0,1,-1.0,1.0
Dumitrache,www.aktual24.ro,0,0,1,1,0.0,0.0
Enache,www.aktual24.ro,0,0,3,3,0.0,0.0
Fagadau,www.aktual24.ro,0,1,0,1,-1.0,1.0
Ion Dumitrache,www.aktual24.ro,0,0,3,3,0.0,0.0
Mihai Enache,www.aktual24.ro,0,0,1,1,0.0,0.0
Stroe,www.aktual24.ro,0,1,0,1,-1.0,1.0
Eugen Tomac,www.aktual24.ro,0,0,1,1,0.0,0.0
Vergil Chitac,www.aktual24.ro,0,1,1,2,-0.5,0.5
Bridget Brink,www.mediafax.ro,0,0,1,1,0.0,0.0
ambasadoare,www.mediafax.ro,0,1,0,1,-1.0,1.0
comandant,www.mediafax.ro,0,0,1,1,0.0,0.0
comandant militar,www.mediafax.ro,0,1,0,1,-1.0,1.0
oficial,www.mediafax.ro,0,9,2,11,-0.8181818181818182,0.8181818181818182
Coroești,www.antena3.ro,0,1,0,1,-1.0,1.0
Lucian Romașcanu,www.antena3.ro,0,0,2,2,0.0,0.0
Oana Țoiu,www.antena3.ro,0,0,1,1,0.0,0.0
Olt,www.antena3.ro,0,1,0,1,-1.0,1.0
Suceava,www.antena3.ro,0,0,3,3,0.0,0.0
Vaslui,www.antena3.ro,0,1,0,1,-1.0,1.0
domnul,www.antena3.ro,0,1,0,1,-1.0,1.0
observator,www.antena3.ro,0,2,0,2,-1.0,1.0
Dmitrii Peskov,primanews.ro,0,1,0,1,-1.0,1.0
civil,primanews.ro,0,2,1,3,-0.6666666666666666,0.6666666666666666
localnic,primanews.ro,0,1,1,2,-0.5,0.5
prizonier,primanews.ro,0,0,1,1,0.0,0.0
Stefan Ciochinaru,www.realitatea.net,0,0,1,1,0.0,0.0
electorat,www.realitatea.net,0,2,2,4,-0.5,0.5
Sandra Stoicescu,observatornews.ro,0,0,1,1,0.0,0.0
secretar general,observatornews.ro,0,0,2,2,0.0,0.0
vinovat,observatornews.ro,0,1,0,1,-1.0,1.0
Aiud,primanews.ro,0,0,1,1,0.0,0.0
Cluj,primanews.ro,0,0,4,4,0.0,0.0
Gherla,primanews.ro,0,1,0,1,-1.0,1.0
Jilava,primanews.ro,0,1,0,1,-1.0,1.0
Râmnicu Sărat,primanews.ro,0,0,2,2,0.0,0.0
Sighet,primanews.ro,0,0,1,1,0.0,0.0
Târgu Ocna,primanews.ro,0,0,1,1,0.0,0.0
Văcărești,primanews.ro,0,0,1,1,0.0,0.0
Bartolomeu Anania,primanews.ro,0,0,1,1,0.0,0.0
designer,primanews.ro,0,0,1,1,0.0,0.0
deținut,primanews.ro,0,1,0,1,-1.0,1.0
deținut politic,primanews.ro,0,1,0,1,-1.0,1.0
erou,primanews.ro,1,0,0,1,1.0,1.0
intelectual,primanews.ro,0,3,1,4,-0.75,0.75
istoric,primanews.ro,0,1,2,3,-0.3333333333333333,0.3333333333333333
martor,primanews.ro,1,0,1,2,0.5,0.5
martir,primanews.ro,1,0,0,1,1.0,1.0
mitropolit,primanews.ro,0,0,1,1,0.0,0.0
Ana Blandiana,primanews.ro,0,0,1,1,0.0,0.0
popoare,primanews.ro,0,0,1,1,0.0,0.0
Romulus Rusan,primanews.ro,0,0,1,1,0.0,0.0
soț,primanews.ro,0,0,1,1,0.0,0.0
victimă,primanews.ro,0,1,1,2,-0.5,0.5
Ciorbea,adevarul.ro,0,1,2,3,-0.3333333333333333,0.3333333333333333
Constantin Timoc,adevarul.ro,0,0,1,1,0.0,0.0
Timoc,adevarul.ro,0,1,0,1,-1.0,1.0
Paul Păcuraru,www.mediafax.ro,0,0,5,5,0.0,0.0
Marko Bela,a1.ro,0,2,2,4,-0.5,0.5
executor,a1.ro,0,1,0,1,-1.0,1.0
Dochiana Bejan,pressone.ro,0,0,1,1,0.0,0.0
Doru Curteanu,pressone.ro,0,0,1,1,0.0,0.0
Paul Marinescu,pressone.ro,0,0,1,1,0.0,0.0
Sorin Toma,pressone.ro,0,0,1,1,0.0,0.0
Viorel Cornescu,pressone.ro,0,0,1,1,0.0,0.0
coautor,pressone.ro,0,1,1,2,-0.5,0.5
prodecan,pressone.ro,0,0,1,1,0.0,0.0
Bruxelles,www.cotidianul.ro,0,2,3,5,-0.4,0.4
Tanczos Barna,www.cotidianul.ro,0,0,1,1,0.0,0.0
miniștri,www.cotidianul.ro,0,1,2,3,-0.3333333333333333,0.3333333333333333
Dobrovolschi,recorder.ro,0,1,0,1,-1.0,1.0
consilier Mihalache,recorder.ro,0,1,0,1,-1.0,1.0
impostor,recorder.ro,0,2,0,2,-1.0,1.0
ins,recorder.ro,0,1,0,1,-1.0,1.0
purtătoare de cuvânt,recorder.ro,0,1,0,1,-1.0,1.0
rival,recorder.ro,0,1,0,1,-1.0,1.0
subalternă,recorder.ro,0,1,0,1,-1.0,1.0
înlocuitor,recorder.ro,0,2,0,2,-1.0,1.0
Annalena Baerbock,www.g4media.ro,0,0,1,1,0.0,0.0
Armin Laschet,www.g4media.ro,0,0,1,1,0.0,0.0
Bavaria,www.g4media.ro,0,0,1,1,0.0,0.0
Gaza,www.g4media.ro,0,1,0,1,-1.0,1.0
Johann Wadephul,www.g4media.ro,0,0,1,1,0.0,0.0
Karin Prien,www.g4media.ro,0,0,2,2,0.0,0.0
Volodîmîr Zelenski,www.g4media.ro,0,0,1,1,0.0,0.0
Vovan,www.g4media.ro,0,0,1,1,0.0,0.0
Wadephul,www.g4media.ro,0,0,1,1,0.0,0.0
purtător de cuvânt,www.g4media.ro,0,0,3,3,0.0,0.0
Orban,observatornews.ro,0,0,5,5,0.0,0.0
Târgoviște,observatornews.ro,0,0,1,1,0.0,0.0
Samuel von Brukenthal,observatornews.ro,0,0,1,1,0.0,0.0
favorit,observatornews.ro,0,0,1,1,0.0,0.0
Valentin Ivancea,www.gandul.ro,0,0,2,2,0.0,0.0
Saligny,recorder.ro,0,1,0,1,-1.0,1.0
Săvădisla,recorder.ro,0,1,0,1,-1.0,1.0
Liviu Tamás Gebe,recorder.ro,0,1,0,1,-1.0,1.0
Bogdan Aurescu,www.digi24.ro,1,0,1,2,0.5,0.5
Ionuț Stroe,www.euronews.ro,0,0,4,4,0.0,0.0
Vladimir Ionaș,www.euronews.ro,0,0,3,3,0.0,0.0
Dan Motreanu,www.antena3.ro,0,0,1,1,0.0,0.0
Ursula von der Leyen,www.antena3.ro,0,0,2,2,0.0,0.0
Alina Frolova,pressone.ro,1,0,0,1,1.0,1.0
Basat Öztürk,pressone.ro,0,0,1,1,0.0,0.0
Constantinescu,pressone.ro,0,1,2,3,-0.3333333333333333,0.3333333333333333
Kiev,pressone.ro,1,1,3,5,0.0,0.0
Luminița Odobescu,pressone.ro,0,0,2,2,0.0,0.0
Nataša Pirc Mustar,pressone.ro,0,0,1,1,0.0,0.0
Petr Pavel,pressone.ro,0,0,1,1,0.0,0.0
Rosen Plevneliev,pressone.ro,0,0,1,1,0.0,0.0
Tobias Elwood,pressone.ro,0,0,1,1,0.0,0.0
adjunct,pressone.ro,0,1,2,3,-0.3333333333333333,0.3333333333333333
doamna Lasconi,pressone.ro,0,2,0,2,-1.0,1.0
elită,pressone.ro,0,5,0,5,-1.0,1.0
locatar,pressone.ro,0,2,2,4,-0.5,0.5
meditator,pressone.ro,0,1,0,1,-1.0,1.0
profitor,pressone.ro,0,2,0,2,-1.0,1.0
sclav,pressone.ro,0,1,0,1,-1.0,1.0
țarului Nicolae I,pressone.ro,0,1,0,1,-1.0,1.0
Alice Weidel,www.comisarul.ro,0,0,2,2,0.0,0.0
Angela Merkel,www.comisarul.ro,0,0,3,3,0.0,0.0
Berlin,www.comisarul.ro,0,1,3,4,-0.25,0.25
Boris Pistorius,www.comisarul.ro,0,0,1,1,0.0,0.0
cancelar,www.comisarul.ro,0,3,1,4,-0.75,0.75
Christian Lindner,www.comisarul.ro,0,0,1,1,0.0,0.0
Dani Rockhoff,www.comisarul.ro,0,0,1,1,0.0,0.0
Einsiedeln,www.comisarul.ro,0,1,0,1,-1.0,1.0
favorit,www.comisarul.ro,0,0,1,1,0.0,0.0
Friedrich Merz,www.comisarul.ro,0,0,4,4,0.0,0.0
Habeck,www.comisarul.ro,0,1,0,1,-1.0,1.0
Markus Ziener,www.comisarul.ro,0,0,1,1,0.0,0.0
Olaf Scholz,www.comisarul.ro,0,0,3,3,0.0,0.0
Robert Habeck,www.comisarul.ro,0,0,2,2,0.0,0.0
român,www.comisarul.ro,1,0,2,3,0.3333333333333333,0.3333333333333333
Scholz,www.comisarul.ro,0,0,1,1,0.0,0.0
Ursula von der Leyen,www.comisarul.ro,0,1,1,2,-0.5,0.5
Viktor Orbán,www.comisarul.ro,0,0,1,1,0.0,0.0
Weidel,www.comisarul.ro,0,0,1,1,0.0,0.0
cancelare,www.comisarul.ro,0,1,0,1,-1.0,1.0
corespondent,www.comisarul.ro,0,0,1,1,0.0,0.0
demonstrant,www.comisarul.ro,0,1,0,1,-1.0,1.0
locuitor,www.comisarul.ro,0,1,5,6,-0.16666666666666666,0.16666666666666666
migrant,www.comisarul.ro,0,3,1,4,-0.75,0.75
perdanț,www.comisarul.ro,0,1,0,1,-1.0,1.0
responsabil,www.comisarul.ro,0,3,0,3,-1.0,1.0
străin,www.comisarul.ro,0,2,0,2,-1.0,1.0
țap,www.comisarul.ro,0,1,0,1,-1.0,1.0
Mircia Chelaru,www.aktual24.ro,0,0,1,1,0.0,0.0
Dominic Fritz,www.antena3.ro,0,1,8,9,-0.1111111111111111,0.1111111111111111
Fritz,www.antena3.ro,0,1,2,3,-0.3333333333333333,0.3333333333333333
Mihaiu,www.antena3.ro,0,0,2,2,0.0,0.0
Radu Mihaiu,www.antena3.ro,0,0,2,2,0.0,0.0
contestatar,www.antena3.ro,0,3,0,3,-1.0,1.0
Adrian Veștea,snoop.ro,0,0,1,1,0.0,0.0
Bolojan,snoop.ro,0,0,2,2,0.0,0.0
Iulia Roșu,snoop.ro,0,0,7,7,0.0,0.0
Marius Deak,snoop.ro,0,0,1,1,0.0,0.0
Veștea,snoop.ro,0,0,1,1,0.0,0.0
Volintiru,snoop.ro,0,0,1,1,0.0,0.0
creditor,snoop.ro,0,1,0,1,-1.0,1.0
familia Păcuraru,snoop.ro,0,2,0,2,-1.0,1.0
salariaț,snoop.ro,0,0,1,1,0.0,0.0
Andrei Bușe,adevarul.ro,0,0,1,1,0.0,0.0
Cezar Bujeniță Batog,adevarul.ro,0,0,1,1,0.0,0.0
Cristian Mihai,adevarul.ro,0,0,1,1,0.0,0.0
Fadi Haifawi,adevarul.ro,0,0,1,1,0.0,0.0
Gabriel Comănescu,adevarul.ro,0,0,1,1,0.0,0.0
Gabriel Radu-Constantinescu,adevarul.ro,0,0,1,1,0.0,0.0
Horațiu Iancu,adevarul.ro,0,0,1,1,0.0,0.0
Iulian Iancu,adevarul.ro,0,0,1,1,0.0,0.0
Mihai Doinița,adevarul.ro,0,0,1,1,0.0,0.0
Mihai Ionuț Pop,adevarul.ro,0,0,1,1,0.0,0.0
Antonel Mocanu,adevarul.ro,0,0,1,1,0.0,0.0
pop,adevarul.ro,0,1,0,1,-1.0,1.0
Sebastian Ghiță,adevarul.ro,0,4,2,6,-0.6666666666666666,0.6666666666666666
magnat,adevarul.ro,0,1,0,1,-1.0,1.0
împuternicit,adevarul.ro,0,0,1,1,0.0,0.0
Florin Cîțu,www.mediafax.ro,0,2,3,5,-0.4,0.4
populație,www.mediafax.ro,0,0,6,6,0.0,0.0
Negrescu,www.comisarul.ro,0,0,3,3,0.0,0.0
senator,observatornews.ro,1,6,17,24,-0.20833333333333334,0.20833333333333334
Adi Crăciunoiu,stirileprotv.ro,0,0,1,1,0.0,0.0
bărbat,stirileprotv.ro,0,1,3,4,-0.25,0.25
Cătălin Bota,stirileprotv.ro,0,0,2,2,0.0,0.0
Daniel Blaj,stirileprotv.ro,0,0,1,1,0.0,0.0
grădinar,stirileprotv.ro,0,0,1,1,0.0,0.0
Gurahonț,stirileprotv.ro,0,1,0,1,-1.0,1.0
Iulia Petcu,stirileprotv.ro,0,0,1,1,0.0,0.0
Laura Culiță,stirileprotv.ro,0,0,1,1,0.0,0.0
Predeal,stirileprotv.ro,0,0,1,1,0.0,0.0
Primăria,stirileprotv.ro,0,1,0,1,-1.0,1.0
reporter,stirileprotv.ro,0,0,1,1,0.0,0.0
Septimius Pârvu,stirileprotv.ro,0,0,1,1,0.0,0.0
Sîngeorz Băi,stirileprotv.ro,0,1,0,1,-1.0,1.0
vice,stirileprotv.ro,0,1,0,1,-1.0,1.0
Ștefan Tatu,stirileprotv.ro,0,0,1,1,0.0,0.0
Adrian Cozma,www.b1tv.ro,0,1,5,6,-0.16666666666666666,0.16666666666666666
Pantelimon,www.b1tv.ro,0,0,1,1,0.0,0.0
artist,www.b1tv.ro,1,0,2,3,0.3333333333333333,0.3333333333333333
Chirilă,www.b1tv.ro,0,1,1,2,-0.5,0.5
Tudor Chirilă,www.b1tv.ro,0,1,1,2,-0.5,0.5
Brăila,www.comisarul.ro,0,0,3,3,0.0,0.0
Botoșani,www.euronews.ro,0,0,1,1,0.0,0.0
Dâmbovița,www.euronews.ro,0,0,2,2,0.0,0.0
Nicușor Dan Crin Antonescu,www.euronews.ro,0,0,1,1,0.0,0.0
Victor,www.antena3.ro,0,1,0,1,-1.0,1.0
suveranist,www.antena3.ro,0,2,1,3,-0.6666666666666666,0.6666666666666666
Raluca Turcan,www.g4media.ro,0,0,1,1,0.0,0.0
responsabil,www.g4media.ro,0,0,1,1,0.0,0.0
Predoiu,observatornews.ro,0,0,3,3,0.0,0.0
Dăncilă,www.digi24.ro,0,1,1,2,-0.5,0.5
Eugen Teodorovici,www.digi24.ro,0,1,0,1,-1.0,1.0
imigrant,www.digi24.ro,0,2,0,2,-1.0,1.0
migrant,www.digi24.ro,0,1,0,1,-1.0,1.0
polițist,www.digi24.ro,0,2,3,5,-0.4,0.4
premiu,www.digi24.ro,0,0,2,2,0.0,0.0
refugiat,www.digi24.ro,0,1,0,1,-1.0,1.0
suflet,www.digi24.ro,0,1,0,1,-1.0,1.0
delegat,agerpres.ro,0,0,3,3,0.0,0.0
Granada,www.gandul.ro,0,0,1,1,0.0,0.0
Kiev,www.gandul.ro,0,0,1,1,0.0,0.0
Marcel,www.gandul.ro,0,1,1,2,-0.5,0.5
cu,www.gandul.ro,0,0,1,1,0.0,0.0
Blaga,www.digi24.ro,1,0,1,2,0.5,0.5
Andrzej Duda,www.realitatea.net,0,0,1,1,0.0,0.0
Belgia,www.realitatea.net,1,0,0,1,1.0,1.0
Cehia,www.realitatea.net,1,0,1,2,0.5,0.5
Italia,www.realitatea.net,1,0,0,1,1.0,1.0
Karol Nawrocki,www.realitatea.net,1,0,0,1,1.0,1.0
Polonia,www.realitatea.net,3,0,4,7,0.42857142857142855,0.42857142857142855
prieteni,www.realitatea.net,1,0,0,1,1.0,1.0
Claudiu Manda,observatornews.ro,0,0,2,2,0.0,0.0
Emanoil Savin,observatornews.ro,0,0,1,1,0.0,0.0
Emilia Meiroșu,observatornews.ro,0,0,1,1,0.0,0.0
Remus Borza,observatornews.ro,0,0,1,1,0.0,0.0
Violeta Alexandru,observatornews.ro,0,0,1,1,0.0,0.0
actor,observatornews.ro,0,4,1,5,-0.8,0.8
diplomat,observatornews.ro,0,0,1,1,0.0,0.0
economișt,observatornews.ro,0,0,1,1,0.0,0.0
juriști,observatornews.ro,0,0,1,1,0.0,0.0
militar,observatornews.ro,2,0,2,4,0.5,0.5
ofițer,observatornews.ro,1,1,1,3,0.0,0.0
tot,observatornews.ro,0,1,0,1,-1.0,1.0
vânzător,observatornews.ro,0,1,0,1,-1.0,1.0
Ionuț Lupu,www.antena3.ro,0,0,1,1,0.0,0.0
finalist,adevarul.ro,1,0,1,2,0.5,0.5
predecesor,adevarul.ro,0,1,0,1,-1.0,1.0
Corneliu Tudor,www.mediafax.ro,0,0,1,1,0.0,0.0
George Becali,www.mediafax.ro,0,0,3,3,0.0,0.0
Gigi Becali,www.mediafax.ro,0,0,3,3,0.0,0.0
europarlamentar,www.mediafax.ro,0,5,8,13,-0.38461538461538464,0.38461538461538464
șefă,www.mediafax.ro,0,1,1,2,-0.5,0.5
Alexandru Badea,observatornews.ro,0,0,1,1,0.0,0.0
Badea,observatornews.ro,0,0,1,1,0.0,0.0
Bogdan Mateescu,observatornews.ro,0,0,1,1,0.0,0.0
Corbu,observatornews.ro,0,0,1,1,0.0,0.0
Corina Alina Corbu,observatornews.ro,0,0,1,1,0.0,0.0
Corina Corbu,observatornews.ro,0,0,1,1,0.0,0.0
Laura Vicol,observatornews.ro,0,1,0,1,-1.0,1.0
Nicușor Halici,observatornews.ro,0,1,0,1,-1.0,1.0
Vicol,observatornews.ro,0,1,0,1,-1.0,1.0
doamnă,observatornews.ro,0,0,2,2,0.0,0.0
Alfred Simonis,pressone.ro,0,0,1,1,0.0,0.0
Ovidu Voicu,pressone.ro,0,0,1,1,0.0,0.0
Virgil Popescu,pressone.ro,0,1,3,4,-0.25,0.25
bătăuș,pressone.ro,0,3,0,3,-1.0,1.0
Stoica,pressone.ro,0,1,0,1,-1.0,1.0
cipriot,adevarul.ro,0,0,1,1,0.0,0.0
Cipru,adevarul.ro,0,0,2,2,0.0,0.0
Fidias,adevarul.ro,1,0,0,1,1.0,1.0
Fidias Panayiotou,adevarul.ro,0,0,1,1,0.0,0.0
Gina,adevarul.ro,1,0,0,1,1.0,1.0
Gina Voinea,adevarul.ro,2,0,0,2,1.0,1.0
Japonia,adevarul.ro,0,0,5,5,0.0,0.0
Nicosia,adevarul.ro,0,0,1,1,0.0,0.0
Panayiotou,adevarul.ro,0,0,1,1,0.0,0.0
Strasbourg,adevarul.ro,0,0,3,3,0.0,0.0
YouTuber,adevarul.ro,1,0,1,2,0.5,0.5
abonat,adevarul.ro,0,0,2,2,0.0,0.0
celebritate,adevarul.ro,0,0,1,1,0.0,0.0
consilier parlamentar,adevarul.ro,0,0,1,1,0.0,0.0
controlor,adevarul.ro,0,1,0,1,-1.0,1.0
călugăr,adevarul.ro,0,0,1,1,0.0,0.0
oaspete,adevarul.ro,0,0,1,1,0.0,0.0
s,adevarul.ro,0,1,0,1,-1.0,1.0
youtuber,adevarul.ro,0,0,2,2,0.0,0.0
Barna,www.digi24.ro,0,0,1,1,0.0,0.0
contracandidat,www.digi24.ro,0,4,5,9,-0.4444444444444444,0.4444444444444444
Poiana Brașov,www.digi24.ro,0,0,1,1,0.0,0.0
Sibiu,www.digi24.ro,0,0,5,5,0.0,0.0
colaborator,www.digi24.ro,0,2,2,4,-0.5,0.5
delegat,www.digi24.ro,0,0,3,3,0.0,0.0
expert,www.digi24.ro,0,2,6,8,-0.25,0.25
militant,www.digi24.ro,0,1,2,3,-0.3333333333333333,0.3333333333333333
Ionela Gavril,agerpres.ro,0,0,2,2,0.0,0.0
Irina Andreea Cristea,agerpres.ro,0,0,1,1,0.0,0.0
Dragnea,www.comisarul.ro,0,6,0,6,-1.0,1.0
Ionescu,www.comisarul.ro,0,0,1,1,0.0,0.0
Liviu Dragnea,www.comisarul.ro,0,1,2,3,-0.3333333333333333,0.3333333333333333
Pahonțu,www.comisarul.ro,0,0,1,1,0.0,0.0
colaborator,www.romaniatv.net,0,1,0,1,-1.0,1.0
profesionist,www.romaniatv.net,1,3,0,4,-0.5,0.5
Gabriela Firea,www.comisarul.ro,0,1,5,6,-0.16666666666666666,0.16666666666666666
Silviu Prigoană,www.comisarul.ro,0,0,1,1,0.0,0.0
Sorin Oprescu,www.comisarul.ro,0,0,1,1,0.0,0.0
Bucureștean,www.comisarul.ro,1,0,2,3,0.3333333333333333,0.3333333333333333
Gergescu,stirileprotv.ro,0,0,1,1,0.0,0.0
prezidențiabil,stirileprotv.ro,0,1,0,1,-1.0,1.0
Elon Musk,recorder.ro,0,0,3,3,0.0,0.0
Emmanuel Macron,recorder.ro,0,0,1,1,0.0,0.0
Ion Dumitrache,recorder.ro,0,1,0,1,-1.0,1.0
Ionuț Moșteanu,recorder.ro,0,1,1,2,-0.5,0.5
Mihai Teodorescu,recorder.ro,0,0,1,1,0.0,0.0
Paul Stănescu,recorder.ro,2,1,4,7,0.14285714285714285,0.14285714285714285
Toni Greblă,recorder.ro,0,3,1,4,-0.75,0.75
Keir Starmer,recorder.ro,0,0,1,1,0.0,0.0
vameș,recorder.ro,0,1,0,1,-1.0,1.0
Bode,www.b1tv.ro,0,0,1,1,0.0,0.0
multor,www.b1tv.ro,0,1,0,1,-1.0,1.0
Andrea Pirro,www.comisarul.ro,0,0,1,1,0.0,0.0
Băsescu,www.comisarul.ro,0,5,2,7,-0.7142857142857143,0.7142857142857143
Doamna Meloni,www.comisarul.ro,1,0,0,1,1.0,1.0
India,www.comisarul.ro,0,0,2,2,0.0,0.0
Pakistan,www.comisarul.ro,0,0,1,1,0.0,0.0
Sorina Soare,www.comisarul.ro,0,0,2,2,0.0,0.0
ales,www.comisarul.ro,0,1,2,3,-0.3333333333333333,0.3333333333333333
antreprenor,www.comisarul.ro,0,0,3,3,0.0,0.0
cercetător,www.comisarul.ro,0,0,3,3,0.0,0.0
doamnă,www.comisarul.ro,2,0,4,6,0.3333333333333333,0.3333333333333333
doamna Meloni,www.comisarul.ro,1,0,0,1,1.0,1.0
dumnealui,www.comisarul.ro,0,1,0,1,-1.0,1.0
dușman,www.comisarul.ro,0,1,0,1,-1.0,1.0
militant,www.comisarul.ro,0,3,0,3,-1.0,1.0
simpatizant,www.comisarul.ro,0,1,2,3,-0.3333333333333333,0.3333333333333333
Dan Dungaciu,www.antena3.ro,0,0,10,10,0.0,0.0
Dan Puric,www.antena3.ro,0,0,3,3,0.0,0.0
Gavrilă,www.antena3.ro,0,0,2,2,0.0,0.0
Cristian Pîrvulescu,www.romaniatv.net,0,0,4,4,0.0,0.0
Marcel,www.romaniatv.net,0,1,2,3,-0.3333333333333333,0.3333333333333333
Pîrvulescu,www.romaniatv.net,0,1,1,2,-0.5,0.5
contracandidat,www.realitatea.net,0,3,0,3,-1.0,1.0
Hunedoara,adevarul.ro,0,1,4,5,-0.2,0.2
Motreanu,adevarul.ro,0,0,2,2,0.0,0.0
Vasile Dîncu,adevarul.ro,0,0,1,1,0.0,0.0
eu,adevarul.ro,0,2,2,4,-0.5,0.5
Bogdan Peșchir,snoop.ro,0,1,1,2,-0.5,0.5
Kelemen Hunor,snoop.ro,1,0,3,4,0.25,0.25
Peșchir,snoop.ro,0,1,0,1,-1.0,1.0
mandatar,snoop.ro,0,1,2,3,-0.3333333333333333,0.3333333333333333
procuror,snoop.ro,0,12,14,26,-0.46153846153846156,0.46153846153846156
Andrei Dolineaschi,www.mediafax.ro,0,0,1,1,0.0,0.0
Claudiu Manda,www.mediafax.ro,0,0,6,6,0.0,0.0
Constantin Niță,www.mediafax.ro,0,0,1,1,0.0,0.0
Dan Nica,www.mediafax.ro,0,0,2,2,0.0,0.0
Georgian Pop,www.mediafax.ro,0,0,1,1,0.0,0.0
Marian Vanghelie,www.mediafax.ro,0,0,1,1,0.0,0.0
Rodica Nassar,www.mediafax.ro,0,0,1,1,0.0,0.0
Rovana Plumb,www.mediafax.ro,0,0,3,3,0.0,0.0
Valeriu Zgonea,www.mediafax.ro,0,0,2,2,0.0,0.0
domnie,pressone.ro,1,6,2,9,-0.5555555555555556,0.5555555555555556
Bode,pressone.ro,0,1,0,1,-1.0,1.0
gigea,pressone.ro,0,1,0,1,-1.0,1.0
mafia,pressone.ro,0,1,0,1,-1.0,1.0
mafios,pressone.ro,0,1,0,1,-1.0,1.0
mafioț,pressone.ro,0,2,0,2,-1.0,1.0
proxenet,pressone.ro,0,1,0,1,-1.0,1.0
proștilor,pressone.ro,0,1,0,1,-1.0,1.0
reformator,pressone.ro,1,1,1,3,0.0,0.0
reformist,pressone.ro,0,2,0,2,-1.0,1.0
spălător,pressone.ro,0,1,0,1,-1.0,1.0
traficant,pressone.ro,0,2,0,2,-1.0,1.0
tăietor,pressone.ro,0,1,0,1,-1.0,1.0
austriac,adevarul.ro,0,2,1,3,-0.6666666666666666,0.6666666666666666
Ghincea,adevarul.ro,0,1,2,3,-0.3333333333333333,0.3333333333333333
Hurezanu,adevarul.ro,0,1,0,1,-1.0,1.0
Marius Ghincea,adevarul.ro,0,1,5,6,-0.16666666666666666,0.16666666666666666
Bălți,recorder.ro,0,0,1,1,0.0,0.0
Igor Dodon,recorder.ro,0,1,1,2,-0.5,0.5
Ilan Șor,recorder.ro,0,1,0,1,-1.0,1.0
profesor universitar,recorder.ro,0,0,1,1,0.0,0.0
Renato Usatîi,recorder.ro,0,0,1,1,0.0,0.0
Usatîi,recorder.ro,0,0,1,1,0.0,0.0
general,recorder.ro,0,2,6,8,-0.25,0.25
Gheorghiță Vlad,recorder.ro,0,0,2,2,0.0,0.0
oligarh,recorder.ro,0,2,0,2,-1.0,1.0
pilot,recorder.ro,0,1,1,2,-0.5,0.5
Alexandr Stoianoglo,recorder.ro,0,0,1,1,0.0,0.0
Daniel Fenechiu,www.cotidianul.ro,0,0,1,1,0.0,0.0
Fenechiu,www.cotidianul.ro,0,0,1,1,0.0,0.0
Alin Tișe,pressone.ro,0,0,1,1,0.0,0.0
Bușoi,pressone.ro,0,0,4,4,0.0,0.0
Iulian Dumitrescu,pressone.ro,0,0,1,1,0.0,0.0
Papa Francisc,pressone.ro,0,0,1,1,0.0,0.0
Papei,pressone.ro,0,0,1,1,0.0,0.0
Stolojan,pressone.ro,0,0,1,1,0.0,0.0
Sălaj,pressone.ro,0,0,4,4,0.0,0.0
Teodor Atanasiu,pressone.ro,0,0,2,2,0.0,0.0
Viorel Cataramă,pressone.ro,0,1,1,2,-0.5,0.5
Vlad Nistor,pressone.ro,0,0,3,3,0.0,0.0
absent,pressone.ro,0,1,0,1,-1.0,1.0
celor,pressone.ro,0,0,3,3,0.0,0.0
Theodor Stolojan,pressone.ro,0,0,1,1,0.0,0.0
gospodar,pressone.ro,0,0,1,1,0.0,0.0
Dan Ivan,observatornews.ro,0,0,1,1,0.0,0.0
Filip Hăvârneanu,observatornews.ro,0,0,1,1,0.0,0.0
Rocky Balboa,observatornews.ro,1,0,0,1,1.0,1.0
Superman,observatornews.ro,0,0,1,1,0.0,0.0
aleș,observatornews.ro,0,2,2,4,-0.5,0.5
internaut,observatornews.ro,0,1,0,1,-1.0,1.0
internat,observatornews.ro,0,0,1,1,0.0,0.0
lider politic,observatornews.ro,0,0,1,1,0.0,0.0
tânăr,observatornews.ro,2,0,2,4,0.5,0.5
urmăritor,observatornews.ro,0,1,0,1,-1.0,1.0
Dana Rozalia Varga,www.antena3.ro,0,0,1,1,0.0,0.0
Dana Varga,www.antena3.ro,0,0,1,1,0.0,0.0
Dan Trifu,www.news.ro,0,0,1,1,0.0,0.0
Gabriela Firea,www.news.ro,0,0,2,2,0.0,0.0
Laurei Vicol,www.news.ro,0,0,1,1,0.0,0.0
activist,www.news.ro,0,0,1,1,0.0,0.0
arhitect șef,www.news.ro,0,1,0,1,-1.0,1.0
dezvoltator,www.news.ro,0,1,0,1,-1.0,1.0
Micșunescu,www.news.ro,0,0,1,1,0.0,0.0
Ciorbă,www.news.ro,0,3,1,4,-0.75,0.75
interpuși,www.news.ro,0,1,0,1,-1.0,1.0
patron,www.news.ro,0,1,3,4,-0.25,0.25
primar general,www.news.ro,0,1,1,2,-0.5,0.5
soț,www.news.ro,0,0,3,3,0.0,0.0
Blaga,www.romaniatv.net,0,0,1,1,0.0,0.0
Cocoș,www.cotidianul.ro,0,1,0,1,-1.0,1.0
Iliescu,www.cotidianul.ro,0,1,1,2,-0.5,0.5
monopolist,www.cotidianul.ro,0,1,0,1,-1.0,1.0
Pambuccian,www.cotidianul.ro,0,1,0,1,-1.0,1.0
Pippidi,www.cotidianul.ro,0,1,0,1,-1.0,1.0
Udrea,www.cotidianul.ro,0,1,0,1,-1.0,1.0
lume,www.cotidianul.ro,0,1,1,2,-0.5,0.5
votant,www.cotidianul.ro,0,5,1,6,-0.8333333333333334,0.8333333333333334
Florian Coldea,pressone.ro,0,3,4,7,-0.42857142857142855,0.42857142857142855
Otto von Bismarck,pressone.ro,0,0,1,1,0.0,0.0
Tăriceanu,www.euronews.ro,0,0,1,1,0.0,0.0
guvernant,www.euronews.ro,0,2,0,2,-1.0,1.0
Adrian Alexandrov,a1.ro,0,0,1,1,0.0,0.0
Alexandru Alexandrov,a1.ro,0,0,1,1,0.0,0.0
Alina Bica,a1.ro,0,0,1,1,0.0,0.0
Buzoianca,a1.ro,0,0,1,1,0.0,0.0
Costa Rica,a1.ro,0,0,1,1,0.0,0.0
Cotroceni,a1.ro,0,0,7,7,0.0,0.0
Dan Voiculescu,a1.ro,0,0,3,3,0.0,0.0
Dinu Patriciu,a1.ro,0,1,1,2,-0.5,0.5
Dinu Pescariu,a1.ro,0,0,1,1,0.0,0.0
Dorin Cocoș,a1.ro,0,1,0,1,-1.0,1.0
Pleșcoi,a1.ro,0,0,1,1,0.0,0.0
Rudel Obreja,a1.ro,0,0,1,1,0.0,0.0
Theodor Stolojan,a1.ro,0,0,2,2,0.0,0.0
Tudorel Toader,a1.ro,0,1,1,2,-0.5,0.5
Tăriceanu,a1.ro,0,2,0,2,-1.0,1.0
Valeriu Stoica,a1.ro,0,0,1,1,0.0,0.0
buzoiancă,a1.ro,0,0,1,1,0.0,0.0
mămică,a1.ro,0,0,1,1,0.0,0.0
personaj,a1.ro,0,1,0,1,-1.0,1.0
procuror general,a1.ro,0,0,1,1,0.0,0.0
victimă,a1.ro,0,1,0,1,-1.0,1.0
șefă,a1.ro,0,1,1,2,-0.5,0.5
Ciprian Șerban,www.romaniatv.net,0,0,1,1,0.0,0.0
Dan Diaconescu,www.romaniatv.net,0,0,2,2,0.0,0.0
Șerban Ciprian Constantin,www.romaniatv.net,0,0,2,2,0.0,0.0
Dumitru Coarnă,www.romaniatv.net,0,0,1,1,0.0,0.0
Gabriel Oprea,www.romaniatv.net,0,0,1,1,0.0,0.0
Dumitru Coarmă,www.romaniatv.net,0,0,1,1,0.0,0.0
Barbu Mateescu,www.aktual24.ro,0,0,3,3,0.0,0.0
Birchall,www.aktual24.ro,0,0,2,2,0.0,0.0
Cristian Diaconescu,www.aktual24.ro,0,1,2,3,-0.3333333333333333,0.3333333333333333
Diaconescu,www.aktual24.ro,0,1,0,1,-1.0,1.0
Diana Sosoaca,www.aktual24.ro,0,1,4,5,-0.2,0.2
Mateescu,www.aktual24.ro,0,0,1,1,0.0,0.0
Mirel Palada,www.aktual24.ro,1,0,1,2,0.5,0.5
Nastase,www.aktual24.ro,1,1,1,3,0.0,0.0
Oprescu,www.aktual24.ro,0,1,0,1,-1.0,1.0
Orban,www.aktual24.ro,0,2,3,5,-0.4,0.4
Vadim,www.aktual24.ro,0,1,0,1,-1.0,1.0
Verifield,www.aktual24.ro,0,1,0,1,-1.0,1.0
cativă,www.aktual24.ro,0,1,0,1,-1.0,1.0
competitor,www.aktual24.ro,0,0,1,1,0.0,0.0
las,www.aktual24.ro,0,1,0,1,-1.0,1.0
orator,www.aktual24.ro,0,1,0,1,-1.0,1.0
proprietar,www.aktual24.ro,0,2,0,2,-1.0,1.0
sosoc,www.aktual24.ro,0,1,0,1,-1.0,1.0
tehnocrat,www.aktual24.ro,0,0,2,2,0.0,0.0
Elisabeta Lipă,www.cotidianul.ro,0,0,1,1,0.0,0.0
Florin Jianu,www.cotidianul.ro,0,0,1,1,0.0,0.0
Constantin Brâncuși,adevarul.ro,0,0,1,1,0.0,0.0
Grecia,adevarul.ro,0,0,2,2,0.0,0.0
Târgu Jiu,adevarul.ro,1,0,0,1,1.0,1.0
Helsinki,observatornews.ro,1,0,0,1,1.0,1.0
Alina Mungiu Pippidi,www.realitatea.net,0,0,1,1,0.0,0.0
Monica Macovei,www.realitatea.net,0,0,2,2,0.0,0.0
Pippidi,www.realitatea.net,0,0,1,1,0.0,0.0
Kelemen,a1.ro,0,0,1,1,0.0,0.0
Sebastian Popescu,a1.ro,0,0,2,2,0.0,0.0
Toni Greblă,a1.ro,0,0,1,1,0.0,0.0
Adina Vălean,www.comisarul.ro,0,0,3,3,0.0,0.0
Eduard Hellvig,www.comisarul.ro,0,1,0,1,-1.0,1.0
Vălean,www.comisarul.ro,0,0,1,1,0.0,0.0
semidocți,www.comisarul.ro,0,1,0,1,-1.0,1.0
Blaj,observatornews.ro,0,0,1,1,0.0,0.0
Dumnezeu,observatornews.ro,2,1,1,4,0.25,0.25
participanț,observatornews.ro,0,0,2,2,0.0,0.0
guvern,www.euronews.ro,0,1,0,1,-1.0,1.0
Tanczos Barna,www.euronews.ro,0,0,4,4,0.0,0.0
Daniel David,agerpres.ro,0,0,5,5,0.0,0.0
Peia,agerpres.ro,0,0,1,1,0.0,0.0
Firea,observatornews.ro,0,0,4,4,0.0,0.0
adversar,observatornews.ro,0,4,0,4,-1.0,1.0
Robertei Metsola,www.gandul.ro,1,0,0,1,1.0,1.0
doamna Metsola,www.gandul.ro,1,0,0,1,1.0,1.0
Sinaia,adevarul.ro,0,0,2,2,0.0,0.0
Valeriu,adevarul.ro,0,0,1,1,0.0,0.0
Valeriu Stoica,adevarul.ro,0,1,2,3,-0.3333333333333333,0.3333333333333333
Borbely,www.mediafax.ro,0,0,2,2,0.0,0.0
Sfântu Gheorghe,www.mediafax.ro,0,0,1,1,0.0,0.0
Botoșani,agerpres.ro,0,0,3,3,0.0,0.0
Budăi,agerpres.ro,0,0,1,1,0.0,0.0
Curtești,agerpres.ro,0,0,1,1,0.0,0.0
Marius Budăi,agerpres.ro,0,0,1,1,0.0,0.0
Mark Rutte,www.cotidianul.ro,0,0,1,1,0.0,0.0
Secretar General,www.cotidianul.ro,1,0,1,2,0.5,0.5
Carlo Azeglio Ciampi,stirileprotv.ro,0,0,1,1,0.0,0.0
Gelu Voican Voiculescu,stirileprotv.ro,0,0,1,1,0.0,0.0
George W. Bush,stirileprotv.ro,0,0,1,1,0.0,0.0
Gianni de Michelis,stirileprotv.ro,0,0,1,1,0.0,0.0
Giulio Andreotti,stirileprotv.ro,0,0,1,1,0.0,0.0
Iosif Rus,stirileprotv.ro,0,1,0,1,-1.0,1.0
Istanbul,stirileprotv.ro,1,0,1,2,0.5,0.5
Italia,stirileprotv.ro,1,0,0,1,1.0,1.0
Marco Panella,stirileprotv.ro,1,0,0,1,1.0,1.0
milennial,stirileprotv.ro,0,1,0,1,-1.0,1.0
Nicolae Ceaușescu,stirileprotv.ro,0,0,1,1,0.0,0.0
Oltenița,stirileprotv.ro,1,0,0,1,1.0,1.0
Paris,stirileprotv.ro,1,0,0,1,1.0,1.0
Giorgio Napolitano,stirileprotv.ro,0,0,1,1,0.0,0.0
Rio de Janeiro,stirileprotv.ro,1,0,0,1,1.0,1.0
Roma,stirileprotv.ro,1,0,0,1,1.0,1.0
San Francisco,stirileprotv.ro,1,0,0,1,1.0,1.0
Süleyman Demirel,stirileprotv.ro,0,0,1,1,0.0,0.0
Vulpescu,stirileprotv.ro,0,0,1,1,0.0,0.0
boomer,stirileprotv.ro,0,1,0,1,-1.0,1.0
bunic,stirileprotv.ro,0,0,1,1,0.0,0.0
bătrân,stirileprotv.ro,1,0,0,1,1.0,1.0
conducător,stirileprotv.ro,0,2,1,3,-0.6666666666666666,0.6666666666666666
generație,stirileprotv.ro,0,0,1,1,0.0,0.0
om politic,stirileprotv.ro,0,4,0,4,-1.0,1.0
patriot,stirileprotv.ro,1,0,0,1,1.0,1.0
prieten,stirileprotv.ro,2,2,0,4,0.0,0.0
respondent,stirileprotv.ro,0,0,3,3,0.0,0.0
turist,stirileprotv.ro,0,0,1,1,0.0,0.0
vicepremier,stirileprotv.ro,0,0,3,3,0.0,0.0
Macron,www.romaniatv.net,0,0,1,1,0.0,0.0
Papa Francisc,www.romaniatv.net,0,0,1,1,0.0,0.0
pacient,www.romaniatv.net,0,2,0,2,-1.0,1.0
Slănic Moldova,adevarul.ro,0,0,2,2,0.0,0.0
militar,primanews.ro,2,0,1,3,0.6666666666666666,0.6666666666666666
simpatizant,primanews.ro,0,1,1,2,-0.5,0.5
Bogdan Ivan,www.g4media.ro,0,0,3,3,0.0,0.0
Daniel David,www.g4media.ro,1,0,8,9,0.1111111111111111,0.1111111111111111
Marian Neacșu,www.g4media.ro,0,0,3,3,0.0,0.0
Secretar General,stirileprotv.ro,0,0,1,1,0.0,0.0
magistrat,www.news.ro,1,2,4,7,-0.14285714285714285,0.14285714285714285
Assen,www.cotidianul.ro,0,0,1,1,0.0,0.0
Caramitru,www.cotidianul.ro,0,0,1,1,0.0,0.0
Țările de Jos,www.cotidianul.ro,0,0,1,1,0.0,0.0
Alba Iulia,www.gandul.ro,0,1,1,2,-0.5,0.5
Blaga,www.gandul.ro,0,1,1,2,-0.5,0.5
Vasile Blaga,www.gandul.ro,0,1,2,3,-0.3333333333333333,0.3333333333333333
autor,www.euronews.ro,0,2,1,3,-0.6666666666666666,0.6666666666666666
locuitor,www.euronews.ro,0,0,6,6,0.0,0.0
omolog,www.euronews.ro,0,1,2,3,-0.3333333333333333,0.3333333333333333
Alexandra Presură,adevarul.ro,0,0,2,2,0.0,0.0
Firea,adevarul.ro,0,0,1,1,0.0,0.0
Gorghiu,adevarul.ro,0,0,2,2,0.0,0.0
Ligia Deca,adevarul.ro,0,0,2,2,0.0,0.0
Sorin Cîmpeanu,adevarul.ro,0,0,2,2,0.0,0.0
coordonator,www.gandul.ro,0,1,2,3,-0.3333333333333333,0.3333333333333333
George Crin Laurențiu Antonescu,www.gandul.ro,0,0,2,2,0.0,0.0
Varujan Pambuccian,www.gandul.ro,0,0,1,1,0.0,0.0
mandatar,www.gandul.ro,0,0,1,1,0.0,0.0
fiu,www.b1tv.ro,1,1,2,4,0.0,0.0
pe,www.b1tv.ro,0,0,1,1,0.0,0.0
părinte,www.b1tv.ro,0,1,2,3,-0.3333333333333333,0.3333333333333333
soț,www.b1tv.ro,0,1,1,2,-0.5,0.5
soție,www.b1tv.ro,0,0,5,5,0.0,0.0
Barbu,www.mediafax.ro,0,1,1,2,-0.5,0.5
Cozmin Gușă,www.mediafax.ro,0,0,1,1,0.0,0.0
Raluca Turcan,www.mediafax.ro,0,0,1,1,0.0,0.0
Sulfina Barbu,www.mediafax.ro,0,1,1,2,-0.5,0.5
internaut,a1.ro,1,3,3,7,-0.2857142857142857,0.2857142857142857
Philipp Plein,a1.ro,0,0,1,1,0.0,0.0
urmăritor,a1.ro,0,2,0,2,-1.0,1.0
Crimeea,adevarul.ro,0,0,1,1,0.0,0.0
Ema Prișcă,adevarul.ro,0,0,1,1,0.0,0.0
Vladimir Gundeaev,adevarul.ro,0,0,1,1,0.0,0.0
occidental,adevarul.ro,0,1,0,1,-1.0,1.0
Kirill,adevarul.ro,0,1,0,1,-1.0,1.0
acești,adevarul.ro,0,1,0,1,-1.0,1.0
izolaționist,adevarul.ro,0,1,0,1,-1.0,1.0
ocupant,adevarul.ro,0,0,1,1,0.0,0.0
Brătescu,www.news.ro,0,0,1,1,0.0,0.0
Liviu Brătescu,www.news.ro,0,0,3,3,0.0,0.0
interlocutor,primanews.ro,0,0,1,1,0.0,0.0
Mark Rutte,primanews.ro,0,0,1,1,0.0,0.0
Regatul Unit,primanews.ro,0,0,3,3,0.0,0.0
Rutte,primanews.ro,0,0,1,1,0.0,0.0
Tirana,primanews.ro,0,0,1,1,0.0,0.0
Vladimir Medinski,primanews.ro,0,0,2,2,0.0,0.0
consilier,primanews.ro,0,4,5,9,-0.4444444444444444,0.4444444444444444
Canadei,www.gandul.ro,0,0,1,1,0.0,0.0
Groenlanda,www.gandul.ro,0,0,1,1,0.0,0.0
Hartmann,www.gandul.ro,0,0,2,2,0.0,0.0
Merkel,www.gandul.ro,0,1,0,1,-1.0,1.0
Statele Unite ale Americii,www.gandul.ro,0,2,4,6,-0.3333333333333333,0.3333333333333333
Justin Trudeau,www.gandul.ro,0,1,0,1,-1.0,1.0
Von der Leyen,www.gandul.ro,0,1,2,3,-0.3333333333333333,0.3333333333333333
analfabet,www.gandul.ro,0,1,0,1,-1.0,1.0
băiat,www.gandul.ro,0,1,3,4,-0.25,0.25
profiler,www.gandul.ro,0,1,0,1,-1.0,1.0
spion,www.gandul.ro,0,4,0,4,-1.0,1.0
Pawel Zalewsky,www.digi24.ro,0,0,1,1,0.0,0.0
Tîlvăr,www.digi24.ro,0,0,1,1,0.0,0.0
Zalewsky,www.digi24.ro,0,0,1,1,0.0,0.0
Ministrul Angel Tîlvăr,www.digi24.ro,0,0,1,1,0.0,0.0
Amândoi,www.antena3.ro,0,0,1,1,0.0,0.0
China,www.antena3.ro,0,1,4,5,-0.2,0.2
Cristian Diaconescu,www.antena3.ro,0,1,6,7,-0.14285714285714285,0.14285714285714285
Cristian Terheș,www.antena3.ro,0,0,7,7,0.0,0.0
Kelemen Hunor,www.antena3.ro,0,1,13,14,-0.07142857142857142,0.07142857142857142
Marius Lulea,www.antena3.ro,0,0,1,1,0.0,0.0
independent,www.antena3.ro,0,0,5,5,0.0,0.0
Boc,pressone.ro,1,4,1,6,-0.5,0.5
Domnul Dragnea,pressone.ro,0,1,0,1,-1.0,1.0
Elena Udrea,pressone.ro,0,3,2,5,-0.6,0.6
Ioan Rus,pressone.ro,1,0,2,3,0.3333333333333333,0.3333333333333333
Kövesi,pressone.ro,0,0,5,5,0.0,0.0
Mitropolit Andrei,pressone.ro,0,0,1,1,0.0,0.0
Olguța,pressone.ro,0,0,1,1,0.0,0.0
Sebastian Ghiță,pressone.ro,0,5,2,7,-0.7142857142857143,0.7142857142857143
boier,pressone.ro,0,1,0,1,-1.0,1.0
Alina Bica,pressone.ro,0,0,1,1,0.0,0.0
Oprea,pressone.ro,0,6,3,9,-0.6666666666666666,0.6666666666666666
Tiberiu Nițu,pressone.ro,0,0,3,3,0.0,0.0
dansator,pressone.ro,1,1,2,4,0.0,0.0
latifundiar,pressone.ro,0,3,0,3,-1.0,1.0
mediator,pressone.ro,0,0,3,3,0.0,0.0
mesager,pressone.ro,0,0,1,1,0.0,0.0
mulți,pressone.ro,0,0,1,1,0.0,0.0
nepot,pressone.ro,0,5,3,8,-0.625,0.625
pesediști,pressone.ro,0,3,0,3,-1.0,1.0
pilot,pressone.ro,1,1,1,3,0.0,0.0
plagiator,pressone.ro,0,6,0,6,-1.0,1.0
răniț,pressone.ro,0,2,0,2,-1.0,1.0
învingător,pressone.ro,1,1,1,3,0.0,0.0
ști,pressone.ro,0,1,0,1,-1.0,1.0
Constantin,observatornews.ro,0,0,1,1,0.0,0.0
Mihai Constantin,observatornews.ro,0,0,1,1,0.0,0.0
EL,www.aktual24.ro,0,1,0,1,-1.0,1.0
demagog,www.aktual24.ro,0,1,0,1,-1.0,1.0
fugar,www.aktual24.ro,0,2,0,2,-1.0,1.0
Cristian Pantazi,www.aktual24.ro,0,0,1,1,0.0,0.0
nebun,www.aktual24.ro,0,1,0,1,-1.0,1.0
aleș,www.g4media.ro,1,0,0,1,1.0,1.0
beneficiar,www.g4media.ro,0,2,0,2,-1.0,1.0
votant,www.g4media.ro,1,2,3,6,-0.16666666666666666,0.16666666666666666
Machiavelli,www.comisarul.ro,0,1,1,2,-0.5,0.5
Ninel Peia,www.comisarul.ro,0,0,1,1,0.0,0.0
Virgil Alexandru Zidaru,www.comisarul.ro,0,1,1,2,-0.5,0.5
consilier parlamentar,www.comisarul.ro,0,1,1,2,-0.5,0.5
Băasescu,www.comisarul.ro,0,1,0,1,-1.0,1.0
Căcărău,www.comisarul.ro,0,1,0,1,-1.0,1.0
Dan Voiculescu,www.comisarul.ro,0,1,1,2,-0.5,0.5
Jose Barrosso,www.comisarul.ro,0,0,1,1,0.0,0.0
Monaco,www.comisarul.ro,0,0,1,1,0.0,0.0
Nora,www.comisarul.ro,0,0,1,1,0.0,0.0
Philip Gordon,www.comisarul.ro,0,0,1,1,0.0,0.0
Virgil Măgureanu,www.comisarul.ro,0,1,0,1,-1.0,1.0
comisar,www.comisarul.ro,0,1,1,2,-0.5,0.5
Adriean Videanu,www.mediafax.ro,0,0,1,1,0.0,0.0
Bistrița,www.mediafax.ro,0,0,1,1,0.0,0.0
Videanu,www.mediafax.ro,0,0,1,1,0.0,0.0
Septimius Pârvu,adevarul.ro,0,0,2,2,0.0,0.0
Mișcoiu,adevarul.ro,0,0,2,2,0.0,0.0
Sergiu Mișcoiu,adevarul.ro,0,0,4,4,0.0,0.0
martir,adevarul.ro,1,0,0,1,1.0,1.0
Blaga,www.g4media.ro,0,0,4,4,0.0,0.0
Vasile Blaga,www.g4media.ro,0,0,4,4,0.0,0.0
Bistrița,www.euronews.ro,0,0,1,1,0.0,0.0
Daniel Harpa,www.euronews.ro,0,0,1,1,0.0,0.0
Gabriel Zetea,www.euronews.ro,0,0,1,1,0.0,0.0
Gheorghe Flutur,www.euronews.ro,0,0,1,1,0.0,0.0
Horia Teodorescu,www.euronews.ro,0,0,1,1,0.0,0.0
Ion Mînzînă,www.euronews.ro,0,0,1,1,0.0,0.0
Ionel Arsene,www.euronews.ro,0,0,1,1,0.0,0.0
Laurențiu Nistor,www.euronews.ro,0,1,0,1,-1.0,1.0
Radu Moldovan,www.euronews.ro,0,0,1,1,0.0,0.0
Mihai Tudose,www.mediafax.ro,0,3,7,10,-0.3,0.3
premiu,www.mediafax.ro,0,1,3,4,-0.25,0.25
Secretar General adjunct,adevarul.ro,0,0,1,1,0.0,0.0
Iulian Bulai,agerpres.ro,2,0,0,2,1.0,1.0
Lavrin Covaci,primanews.ro,0,0,1,1,0.0,0.0
mascaț,agerpres.ro,0,1,0,1,-1.0,1.0
mască,agerpres.ro,0,0,1,1,0.0,0.0
ofițer,agerpres.ro,0,1,1,2,-0.5,0.5
practică,agerpres.ro,0,1,0,1,-1.0,1.0
procuror,agerpres.ro,0,2,1,3,-0.6666666666666666,0.6666666666666666
Corneliu Coposu,www.digi24.ro,0,0,2,2,0.0,0.0
Ion Iliescu,www.digi24.ro,0,3,3,6,-0.5,0.5
român,www.digi24.ro,1,3,0,4,-0.5,0.5
erou,www.digi24.ro,2,1,0,3,0.3333333333333333,0.3333333333333333
golan,www.digi24.ro,0,1,0,1,-1.0,1.0
urmaș,www.digi24.ro,0,1,0,1,-1.0,1.0
Alexandru Panait,adevarul.ro,0,0,1,1,0.0,0.0
Ceaușescu,www.euronews.ro,0,1,0,1,-1.0,1.0
Marcele,www.euronews.ro,0,1,0,1,-1.0,1.0
domn,www.euronews.ro,0,2,0,2,-1.0,1.0
Boloș,www.euronews.ro,0,1,0,1,-1.0,1.0
Georgescu,www.euronews.ro,0,5,2,7,-0.7142857142857143,0.7142857142857143
familie,www.euronews.ro,3,2,1,6,0.16666666666666666,0.16666666666666666
nebun,www.euronews.ro,0,1,0,1,-1.0,1.0
pensionar,www.euronews.ro,0,1,2,3,-0.3333333333333333,0.3333333333333333
securist,www.euronews.ro,0,1,0,1,-1.0,1.0
strateg,www.euronews.ro,0,1,0,1,-1.0,1.0
Cenad,pressone.ro,0,1,0,1,-1.0,1.0
Cerbăl,pressone.ro,0,0,1,1,0.0,0.0
tineret,pressone.ro,1,1,3,5,0.0,0.0
Vasile Dâncu,adevarul.ro,0,0,1,1,0.0,0.0
dvs,adevarul.ro,1,1,2,4,0.0,0.0
Blaga,www.cotidianul.ro,0,0,2,2,0.0,0.0
protestarul Marian Ceaușescu,www.cotidianul.ro,0,1,0,1,-1.0,1.0
Adolf Hitler,observatornews.ro,0,1,0,1,-1.0,1.0
Bianca Firezar,www.antena3.ro,0,0,1,1,0.0,0.0
consilier prezidențial,www.antena3.ro,0,0,2,2,0.0,0.0
Ciprian Necula,recorder.ro,0,0,1,1,0.0,0.0
Roșia Montană,recorder.ro,0,2,0,2,-1.0,1.0
Steve Witkoff,recorder.ro,0,0,1,1,0.0,0.0
cadavru,recorder.ro,0,1,0,1,-1.0,1.0
farmacist,recorder.ro,1,1,2,4,0.0,0.0
mort,recorder.ro,0,2,1,3,-0.6666666666666666,0.6666666666666666
pasager,recorder.ro,0,1,1,2,-0.5,0.5
Robert Sighiartău,agerpres.ro,0,0,5,5,0.0,0.0
Sighiartău,agerpres.ro,0,0,3,3,0.0,0.0
Tina Dumitrescu,agerpres.ro,0,0,4,4,0.0,0.0
Franks,www.mediafax.ro,0,0,1,1,0.0,0.0
Jeffrey Franks,www.mediafax.ro,0,0,1,1,0.0,0.0
domnului,www.digi24.ro,0,0,1,1,0.0,0.0
Iisus Hristos,www.digi24.ro,0,0,1,1,0.0,0.0
Ierusalim,www.digi24.ro,0,0,2,2,0.0,0.0
mântuitor,www.digi24.ro,1,0,0,1,1.0,1.0
credincios,www.digi24.ro,0,0,1,1,0.0,0.0
președinte interimar,www.digi24.ro,0,1,2,3,-0.3333333333333333,0.3333333333333333
Andrei George Plujar,recorder.ro,0,0,1,1,0.0,0.0
Bernard Werber,recorder.ro,0,0,1,1,0.0,0.0
Bocșa,recorder.ro,0,0,1,1,0.0,0.0
Băile Herculane,recorder.ro,1,0,0,1,1.0,1.0
CaranSebeș,recorder.ro,0,0,1,1,0.0,0.0
Caransebeș,recorder.ro,0,0,2,2,0.0,0.0
Dostoievski Gabriel,recorder.ro,0,0,1,1,0.0,0.0
Dumitru Rujan,recorder.ro,0,0,1,1,0.0,0.0
Florin Silviu Hurduzeu,recorder.ro,0,0,1,1,0.0,0.0
Ion Chisăliță,recorder.ro,0,0,1,1,0.0,0.0
Ion Mocioalcă,recorder.ro,0,0,1,1,0.0,0.0
Ionuț Mihai Popovici,recorder.ro,0,0,1,1,0.0,0.0
Karl May,recorder.ro,0,0,1,1,0.0,0.0
Marcel Vela,recorder.ro,0,1,0,1,-1.0,1.0
Marius Romulus Damian,recorder.ro,0,0,1,1,0.0,0.0
Moldova Nouă,recorder.ro,0,1,1,2,-0.5,0.5
Reșița,recorder.ro,0,0,1,1,0.0,0.0
Ungaria,recorder.ro,1,2,5,8,-0.125,0.125
Victor Nafiru,recorder.ro,0,0,1,1,0.0,0.0
geolog,recorder.ro,0,0,1,1,0.0,0.0
guvernant,recorder.ro,0,1,0,1,-1.0,1.0
Jaro Norbert Marșalic,recorder.ro,0,0,1,1,0.0,0.0
critic,www.mediafax.ro,0,2,0,2,-1.0,1.0
China,www.gandul.ro,0,2,3,5,-0.4,0.4
Chinei,www.gandul.ro,0,1,1,2,-0.5,0.5
Iordan Bărbulescu,www.gandul.ro,0,0,2,2,0.0,0.0
Xi Jinping,www.gandul.ro,0,0,1,1,0.0,0.0
finalist,www.news.ro,0,1,2,3,-0.3333333333333333,0.3333333333333333
Belgrad,www.activenews.ro,0,1,0,1,-1.0,1.0
Diana Șoșoacă,www.activenews.ro,0,3,1,4,-0.75,0.75
istoric,www.activenews.ro,0,2,0,2,-1.0,1.0
Nicolae Ceaușescu,www.activenews.ro,0,3,0,3,-1.0,1.0
politică,www.activenews.ro,0,1,0,1,-1.0,1.0
Serb,www.activenews.ro,0,1,0,1,-1.0,1.0
Victor Ponta,www.activenews.ro,0,3,1,4,-0.75,0.75
admirator,www.activenews.ro,0,0,1,1,0.0,0.0
matematician,www.activenews.ro,0,1,0,1,-1.0,1.0
outsider,www.activenews.ro,0,1,0,1,-1.0,1.0
Ion Cristoiu,www.news.ro,1,0,1,2,0.5,0.5
Predoiu,www.news.ro,0,0,4,4,0.0,0.0
Alba,primanews.ro,0,0,1,1,0.0,0.0
Bihor,primanews.ro,0,1,1,2,-0.5,0.5
Constanța,primanews.ro,0,0,1,1,0.0,0.0
Harghita,primanews.ro,0,0,1,1,0.0,0.0
Hunedoara,primanews.ro,0,0,1,1,0.0,0.0
Sălaj,primanews.ro,0,0,1,1,0.0,0.0
Timiș,primanews.ro,0,0,1,1,0.0,0.0
Tulcea,primanews.ro,0,0,1,1,0.0,0.0
Chinei,www.realitatea.net,0,0,1,1,0.0,0.0
Federația Rusă,www.realitatea.net,0,3,0,3,-1.0,1.0
Iran,www.realitatea.net,0,0,1,1,0.0,0.0
Vladimir Putin,www.realitatea.net,0,0,5,5,0.0,0.0
Riad,www.realitatea.net,0,0,1,1,0.0,0.0
Cristian Pîrvulescu,pressone.ro,0,0,10,10,0.0,0.0
Ferentari,pressone.ro,0,0,1,1,0.0,0.0
Gorghiu,pressone.ro,0,2,0,2,-1.0,1.0
Ludovic,pressone.ro,0,0,1,1,0.0,0.0
Octav Ganea Boc,pressone.ro,0,1,0,1,-1.0,1.0
Rât,pressone.ro,0,1,0,1,-1.0,1.0
Violeta Alexandru,pressone.ro,0,0,1,1,0.0,0.0
alor,pressone.ro,0,1,0,1,-1.0,1.0
indecit,pressone.ro,0,1,0,1,-1.0,1.0
Tasnadi Szilard,pressone.ro,0,1,0,1,-1.0,1.0
Adrian Pintea,snoop.ro,0,0,1,1,0.0,0.0
afumat,snoop.ro,0,0,1,1,0.0,0.0
Agrigoroaie,snoop.ro,0,1,0,1,-1.0,1.0
Andruș,snoop.ro,0,0,1,1,0.0,0.0
Apolena Rychlíková,snoop.ro,0,0,1,1,0.0,0.0
Barcelonei,snoop.ro,0,0,1,1,0.0,0.0
Bruxelles,snoop.ro,0,0,3,3,0.0,0.0
Bârlad,snoop.ro,0,0,2,2,0.0,0.0
cercetătoare,snoop.ro,0,0,1,1,0.0,0.0
Corina Petridi,snoop.ro,0,0,1,1,0.0,0.0
Cristești,snoop.ro,0,1,0,1,-1.0,1.0
Daniela,snoop.ro,0,0,2,2,0.0,0.0
Daniela Dărângă,snoop.ro,1,0,2,3,0.3333333333333333,0.3333333333333333
Dănuț Andruș,snoop.ro,0,0,2,2,0.0,0.0
editor,snoop.ro,0,0,1,1,0.0,0.0
Elena Ledda,snoop.ro,0,0,1,1,0.0,0.0
fermier,snoop.ro,0,0,6,6,0.0,0.0
Florentina Constantin,snoop.ro,0,0,1,1,0.0,0.0
Flămânzi,snoop.ro,0,1,0,1,-1.0,1.0
Ianca,snoop.ro,0,0,1,1,0.0,0.0
Iliana Papangeli,snoop.ro,0,0,1,1,0.0,0.0
Iordache,snoop.ro,0,1,0,1,-1.0,1.0
Paulina Olszanka,snoop.ro,0,0,1,1,0.0,0.0
Polonia,snoop.ro,0,0,4,4,0.0,0.0
Ramona Duminicioiu,snoop.ro,0,0,1,1,0.0,0.0
agricultor,snoop.ro,0,0,3,3,0.0,0.0
furnizor,snoop.ro,0,1,1,2,-0.5,0.5
guvernant,snoop.ro,0,1,0,1,-1.0,1.0
protestatar,snoop.ro,0,1,1,2,-0.5,0.5
Reporterul Snoop,snoop.ro,0,1,3,4,-0.25,0.25
străin,snoop.ro,0,1,0,1,-1.0,1.0
suroră,snoop.ro,0,0,2,2,0.0,0.0
transportator,snoop.ro,0,0,1,1,0.0,0.0
țăran,snoop.ro,0,0,1,1,0.0,0.0
Boiko Borisov,www.euronews.ro,0,1,1,2,-0.5,0.5
Dimităr Glavcev,www.euronews.ro,0,0,1,1,0.0,0.0
Ekaterina Zaharieva,www.euronews.ro,0,0,1,1,0.0,0.0
Rumen Radev,www.euronews.ro,0,1,2,3,-0.3333333333333333,0.3333333333333333
Serghei Stanișev,www.euronews.ro,0,0,1,1,0.0,0.0
Ursula von der Leyen,www.euronews.ro,1,1,4,6,0.0,0.0
Dimitar Glavchev,www.euronews.ro,0,0,1,1,0.0,0.0
Iliana Ivanova,www.euronews.ro,0,0,1,1,0.0,0.0
Mihaiela Vasiescu,www.luju.ro,0,0,1,1,0.0,0.0
Maricela Dragan,www.luju.ro,0,0,1,1,0.0,0.0
Roxana Chiuariu,www.luju.ro,0,0,2,2,0.0,0.0
Tudor Chiuariu,www.luju.ro,0,0,1,1,0.0,0.0
Elena Blicaru Mateescu,www.luju.ro,0,0,1,1,0.0,0.0
Ileana Mihăela Ancuța,www.luju.ro,0,0,1,1,0.0,0.0
Ianela Claudia Gura,www.luju.ro,0,0,1,1,0.0,0.0
Iulia Lulciuc,www.luju.ro,0,0,1,1,0.0,0.0
doamnă,www.luju.ro,0,1,1,2,-0.5,0.5
Mihnea Stoicescu,www.luju.ro,0,0,1,1,0.0,0.0
Gheorghe Ștefan,www.luju.ro,0,0,1,1,0.0,0.0
formator,www.luju.ro,0,0,3,3,0.0,0.0
Austria,observatornews.ro,0,1,2,3,-0.3333333333333333,0.3333333333333333
Hurezeanu,observatornews.ro,0,0,1,1,0.0,0.0
Olanda,observatornews.ro,0,0,2,2,0.0,0.0
Viena,observatornews.ro,0,1,1,2,-0.5,0.5
Aloke Bajpai,www.cotidianul.ro,0,0,1,1,0.0,0.0
Ankarei,www.cotidianul.ro,0,1,0,1,-1.0,1.0
Azerbaidjan,www.cotidianul.ro,0,0,1,1,0.0,0.0
Delhi,www.cotidianul.ro,0,1,0,1,-1.0,1.0
India,www.cotidianul.ro,0,1,2,3,-0.3333333333333333,0.3333333333333333
Pakistan,www.cotidianul.ro,0,2,1,3,-0.6666666666666666,0.6666666666666666
Rajeev Chandrasekhar,www.cotidianul.ro,0,0,1,1,0.0,0.0
Turcia,www.cotidianul.ro,0,1,1,2,-0.5,0.5
Turciei,www.cotidianul.ro,0,1,0,1,-1.0,1.0
turiști,www.cotidianul.ro,0,1,0,1,-1.0,1.0
călător,www.cotidianul.ro,0,0,2,2,0.0,0.0
turișt,www.cotidianul.ro,0,2,2,4,-0.5,0.5
Coposu,adevarul.ro,0,0,1,1,0.0,0.0
Tabără,adevarul.ro,0,0,2,2,0.0,0.0
Valeriu Tabără,adevarul.ro,0,1,1,2,-0.5,0.5
Hunor Kelemen,www.romaniatv.net,0,0,1,1,0.0,0.0
Carmen Dumitrescu,recorder.ro,0,0,1,1,0.0,0.0
corabie,recorder.ro,1,0,0,1,1.0,1.0
Cungrea,recorder.ro,0,0,1,1,0.0,0.0
Gigel Știrbu,recorder.ro,0,0,1,1,0.0,0.0
Ion Grecu,recorder.ro,0,0,1,1,0.0,0.0
Liviu Voiculescu,recorder.ro,0,0,1,1,0.0,0.0
Louise Voss,recorder.ro,0,0,1,1,0.0,0.0
Marius Iancu,recorder.ro,0,0,1,1,0.0,0.0
Mihai Niță,recorder.ro,0,0,1,1,0.0,0.0
Neagu Djuvara,recorder.ro,0,0,1,1,0.0,0.0
Olt,recorder.ro,0,1,1,2,-0.5,0.5
Roșieni,recorder.ro,0,0,1,1,0.0,0.0
Siminica Mirea,recorder.ro,0,0,1,1,0.0,0.0
Slatina,recorder.ro,0,0,3,3,0.0,0.0
angajator,recorder.ro,0,3,1,4,-0.75,0.75
flotant,recorder.ro,0,1,0,1,-1.0,1.0
ordonator,recorder.ro,0,1,0,1,-1.0,1.0
proiectant,recorder.ro,0,0,1,1,0.0,0.0
teolog,recorder.ro,0,0,3,3,0.0,0.0
artist,a1.ro,0,1,3,4,-0.25,0.25
Delia,a1.ro,0,0,3,3,0.0,0.0
Traian Maier,recorder.ro,0,0,1,1,0.0,0.0
bebeluș,recorder.ro,0,1,1,2,-0.5,0.5
militant,recorder.ro,1,3,0,4,-0.5,0.5
Benjamin Netanyahu,recorder.ro,0,1,0,1,-1.0,1.0
răniț,recorder.ro,0,2,0,2,-1.0,1.0
Daniel Fenechiu,recorder.ro,0,0,3,3,0.0,0.0
Resita,a1.ro,0,1,1,2,-0.5,0.5
Vanghelie,a1.ro,0,3,1,4,-0.75,0.75
Nicolai,adevarul.ro,0,0,2,2,0.0,0.0
Norica Nicolai,adevarul.ro,0,0,2,2,0.0,0.0
Micutzu,www.romaniatv.net,0,0,1,1,0.0,0.0
actorii,www.romaniatv.net,0,1,0,1,-1.0,1.0
vizitator,www.romaniatv.net,0,1,0,1,-1.0,1.0
Franța,www.mediafax.ro,0,0,8,8,0.0,0.0
Le Pen,www.mediafax.ro,0,3,0,3,-1.0,1.0
Marine Le Pen,www.mediafax.ro,0,2,2,4,-0.5,0.5
AUR,www.cotidianul.ro,1,1,0,2,0.0,0.0
cetate,www.cotidianul.ro,0,0,1,1,0.0,0.0
Hristos,www.cotidianul.ro,1,0,0,1,1.0,1.0
Târgoviște,www.cotidianul.ro,0,0,1,1,0.0,0.0
domnitor,www.cotidianul.ro,0,2,0,2,-1.0,1.0
pământPrietenii,www.cotidianul.ro,1,0,0,1,1.0,1.0
Anca Alexandrescu,pressone.ro,0,2,0,2,-1.0,1.0
Anwar Sadat,pressone.ro,0,0,1,1,0.0,0.0
Beniamin Netanyahu,pressone.ro,0,0,1,1,0.0,0.0
Bruce Willis,pressone.ro,0,0,1,1,0.0,0.0
Egipt,pressone.ro,0,0,2,2,0.0,0.0
Harlem,pressone.ro,0,0,1,1,0.0,0.0
Ierusalim,pressone.ro,0,0,3,3,0.0,0.0
Iordania,pressone.ro,0,0,1,1,0.0,0.0
Jimmy Carter,pressone.ro,1,0,0,1,1.0,1.0
Klughaft,pressone.ro,0,1,1,2,-0.5,0.5
Knesset,pressone.ro,0,0,1,1,0.0,0.0
Menachem Begin,pressone.ro,0,0,1,1,0.0,0.0
Mesia,pressone.ro,0,0,1,1,0.0,0.0
Milos Zeman,pressone.ro,0,0,1,1,0.0,0.0
Moshe Klughaft,pressone.ro,1,0,0,1,1.0,1.0
muzician,pressone.ro,1,0,0,1,1.0,1.0
mântuitor,pressone.ro,1,0,0,1,1.0,1.0
Naftali Bennet,pressone.ro,0,1,0,1,-1.0,1.0
Naftali Bennett,pressone.ro,0,0,1,1,0.0,0.0
Netanyahu,pressone.ro,1,0,1,2,0.5,0.5
Nicolae Ceaușescu,pressone.ro,0,1,1,2,-0.5,0.5
oraș,pressone.ro,0,0,1,1,0.0,0.0
patriarh,pressone.ro,0,2,1,3,-0.6666666666666666,0.6666666666666666
Pesah,pressone.ro,1,0,0,1,1.0,1.0
profet,pressone.ro,1,0,0,1,1.0,1.0
Reuven Rivlin,pressone.ro,0,0,1,1,0.0,0.0
Sefi Shaked,pressone.ro,0,0,1,1,0.0,0.0
sfânt,pressone.ro,1,0,1,2,0.5,0.5
Shaked,pressone.ro,0,1,0,1,-1.0,1.0
Tel Aviv,pressone.ro,0,0,3,3,0.0,0.0
Zeman,pressone.ro,0,0,1,1,0.0,0.0
diplomat,pressone.ro,0,1,0,1,-1.0,1.0
drept,pressone.ro,1,0,0,1,1.0,1.0
Moshe Dayan,pressone.ro,0,0,1,1,0.0,0.0
magnat,pressone.ro,0,1,1,2,-0.5,0.5
poet,pressone.ro,0,0,3,3,0.0,0.0
prim,pressone.ro,0,1,0,1,-1.0,1.0
regelui,pressone.ro,0,1,0,1,-1.0,1.0
regele David,pressone.ro,0,0,1,1,0.0,0.0
scenarist,pressone.ro,1,0,0,1,1.0,1.0
strateg,pressone.ro,0,0,1,1,0.0,0.0
Saladin,pressone.ro,0,0,1,1,0.0,0.0
terorist,pressone.ro,0,1,0,1,-1.0,1.0
învia,pressone.ro,0,0,1,1,0.0,0.0
Ștefan Andrei,pressone.ro,0,0,1,1,0.0,0.0
șef de stat,pressone.ro,0,0,2,2,0.0,0.0
Andrei Pințur,www.cotidianul.ro,0,0,1,1,0.0,0.0
Cristina Elena Dinu,www.cotidianul.ro,0,0,1,1,0.0,0.0
Marian Mina,www.cotidianul.ro,0,0,1,1,0.0,0.0
Preda,stirileprotv.ro,0,0,2,2,0.0,0.0
Sever Voinescu,stirileprotv.ro,0,0,1,1,0.0,0.0
Voinescu,stirileprotv.ro,0,0,1,1,0.0,0.0
reformist,stirileprotv.ro,0,0,1,1,0.0,0.0
Ionuț Maricel Păcuraru,www.romaniatv.net,0,1,0,1,-1.0,1.0
Maricel Păcuraru,www.romaniatv.net,0,1,0,1,-1.0,1.0
Marine Le Pen,www.romaniatv.net,0,2,1,3,-0.6666666666666666,0.6666666666666666
nepoată,www.romaniatv.net,0,2,0,2,-1.0,1.0
Catalina Macovei,www.aktual24.ro,0,1,0,1,-1.0,1.0
Iași,www.aktual24.ro,0,0,2,2,0.0,0.0
Silviu Macovei,www.aktual24.ro,0,1,0,1,-1.0,1.0
Ionel Rusen,adevarul.ro,0,1,0,1,-1.0,1.0
cunoscut,adevarul.ro,0,0,2,2,0.0,0.0
respectivul,adevarul.ro,0,0,1,1,0.0,0.0
Gheorghe Tinca,www.comisarul.ro,0,0,1,1,0.0,0.0
politic,www.comisarul.ro,0,0,1,1,0.0,0.0
Teodor Meleșcanu,www.comisarul.ro,0,0,1,1,0.0,0.0
Tinca,www.comisarul.ro,0,0,1,1,0.0,0.0
Văcăroiu,www.comisarul.ro,0,0,2,2,0.0,0.0
apropiat,www.comisarul.ro,0,2,3,5,-0.4,0.4
Radu Tudor,www.comisarul.ro,0,0,1,1,0.0,0.0
judecător,www.gandul.ro,0,4,1,5,-0.8,0.8
Antal Arpad,observatornews.ro,0,0,1,1,0.0,0.0
Antal Arpad András,observatornews.ro,0,0,1,1,0.0,0.0
Cseke Atilla,observatornews.ro,0,0,1,1,0.0,0.0
Sfântul Gheorghe,observatornews.ro,0,0,1,1,0.0,0.0
Predoiu,www.gandul.ro,0,0,2,2,0.0,0.0
doamna Lasconi,www.gandul.ro,0,1,0,1,-1.0,1.0
Bădescu,pressone.ro,0,0,1,1,0.0,0.0
Gabriel Bădescu,pressone.ro,0,0,1,1,0.0,0.0
Noua Zeelandă,pressone.ro,0,0,2,2,0.0,0.0
Portugalia,pressone.ro,1,0,5,6,0.16666666666666666,0.16666666666666666
Regatul Unit,pressone.ro,0,0,4,4,0.0,0.0
adulți,pressone.ro,0,0,1,1,0.0,0.0
subiect,pressone.ro,0,0,1,1,0.0,0.0
Africa de Sud,recorder.ro,0,1,1,2,-0.5,0.5
Inculpați,recorder.ro,0,1,0,1,-1.0,1.0
Mateea Petrescu,recorder.ro,0,0,1,1,0.0,0.0
Matei Petrescu,recorder.ro,0,0,1,1,0.0,0.0
Tate,recorder.ro,0,0,3,3,0.0,0.0
protagonist,recorder.ro,0,0,1,1,0.0,0.0
Cătălina Manea,recorder.ro,0,0,1,1,0.0,0.0
Elena Udrea,recorder.ro,0,1,1,2,-0.5,0.5
Elene Udrea,recorder.ro,0,0,1,1,0.0,0.0
Gheorghe Ștefan,recorder.ro,0,1,0,1,-1.0,1.0
Luxembourg,recorder.ro,0,0,1,1,0.0,0.0
Siegfried Mureșan,recorder.ro,0,0,5,5,0.0,0.0
protejat,recorder.ro,0,0,1,1,0.0,0.0
Dana Budeanu,www.romaniatv.net,0,4,0,4,-1.0,1.0
mort,www.romaniatv.net,0,1,0,1,-1.0,1.0
voluntar,www.romaniatv.net,0,1,3,4,-0.25,0.25
grefier,www.realitatea.net,0,0,1,1,0.0,0.0
Tudorel Toader,www.antena3.ro,0,0,4,4,0.0,0.0
atacator,www.euronews.ro,0,2,0,2,-1.0,1.0
Brazilia,www.euronews.ro,0,0,2,2,0.0,0.0
hacker,www.euronews.ro,0,3,0,3,-1.0,1.0
Ciuhandu,pressone.ro,0,1,0,1,-1.0,1.0
Coliban,pressone.ro,0,0,2,2,0.0,0.0
Cristian Popescu Piedone,pressone.ro,0,2,1,3,-0.6666666666666666,0.6666666666666666
Fritz,pressone.ro,0,1,1,2,-0.5,0.5
Gheorghe Ciuhandu,pressone.ro,0,1,0,1,-1.0,1.0
Ghișe,pressone.ro,0,1,0,1,-1.0,1.0
Ioan Ghișe,pressone.ro,0,0,1,1,0.0,0.0
Onțanu,pressone.ro,0,1,1,2,-0.5,0.5
Oprescu,pressone.ro,0,1,0,1,-1.0,1.0
Scripcaru,pressone.ro,1,0,0,1,1.0,1.0
Vanghelie,pressone.ro,0,0,1,1,0.0,0.0
ipocrit,pressone.ro,0,1,0,1,-1.0,1.0
pretendent,pressone.ro,0,2,0,2,-1.0,1.0
Stolojan,www.mediafax.ro,0,2,0,2,-1.0,1.0
Donald Tusk,adevarul.ro,1,0,2,3,0.3333333333333333,0.3333333333333333
Jaroslaw Kaczynski,adevarul.ro,0,1,0,1,-1.0,1.0
protejat,www.romaniatv.net,1,1,1,3,0.0,0.0
Făgăraș,www.euronews.ro,0,0,1,1,0.0,0.0
Cătălin Teniță,www.b1tv.ro,0,1,0,1,-1.0,1.0
electorat,www.b1tv.ro,0,3,1,4,-0.75,0.75
Banner,a1.ro,0,0,1,1,0.0,0.0
Călin Popescu-Tăriceanu,a1.ro,0,0,2,2,0.0,0.0
Iosif Boda,a1.ro,0,0,1,1,0.0,0.0
Marian Enache,a1.ro,0,0,1,1,0.0,0.0
Melescanu,a1.ro,0,0,2,2,0.0,0.0
Mircea Cosea,a1.ro,0,0,2,2,0.0,0.0
Nicolae Vacaroiu,a1.ro,0,0,2,2,0.0,0.0
Prahova,a1.ro,0,0,4,4,0.0,0.0
Suceava,a1.ro,0,0,1,1,0.0,0.0
Teodor Melescanu,a1.ro,0,0,4,4,0.0,0.0
George Crin Laurențiu Antonescu,adevarul.ro,0,0,1,1,0.0,0.0
urmărit,adevarul.ro,0,1,0,1,-1.0,1.0
Hrebenciuc,www.news.ro,0,1,0,1,-1.0,1.0
Silvestru Șoșoacă,www.news.ro,0,1,1,2,-0.5,0.5
băcan,www.gandul.ro,0,0,1,1,0.0,0.0
Gabriela Mihai,www.gandul.ro,0,0,1,1,0.0,0.0
Lucian Viziteu,www.gandul.ro,0,0,2,2,0.0,0.0
artizan,www.gandul.ro,0,0,2,2,0.0,0.0
Becali,www.digi24.ro,0,4,0,4,-1.0,1.0
Gigi Becali,www.digi24.ro,0,1,3,4,-0.25,0.25
Giurgiu,www.digi24.ro,0,0,1,1,0.0,0.0
Simionaș,www.digi24.ro,1,0,0,1,1.0,1.0
Viorel Hrebenciuc,www.digi24.ro,0,0,1,1,0.0,0.0
familist,www.digi24.ro,1,0,0,1,1.0,1.0
patriot,www.digi24.ro,1,0,0,1,1.0,1.0
operator,observatornews.ro,0,0,1,1,0.0,0.0
radiodifuzor,observatornews.ro,0,1,3,4,-0.25,0.25
realizator,observatornews.ro,0,0,2,2,0.0,0.0
colaborator,observatornews.ro,0,1,2,3,-0.3333333333333333,0.3333333333333333
competitor,observatornews.ro,0,0,1,1,0.0,0.0
depunător,observatornews.ro,0,0,1,1,0.0,0.0
ii,observatornews.ro,0,0,1,1,0.0,0.0
invitat,observatornews.ro,0,1,2,3,-0.3333333333333333,0.3333333333333333
lucrător,observatornews.ro,0,0,2,2,0.0,0.0
moderator,observatornews.ro,0,0,3,3,0.0,0.0
producător,observatornews.ro,0,0,1,1,0.0,0.0
solicitant,observatornews.ro,0,0,1,1,0.0,0.0
populație,primanews.ro,1,0,3,4,0.25,0.25
Suceava,www.news.ro,0,0,2,2,0.0,0.0
bucureștean,www.realitatea.net,0,1,1,2,-0.5,0.5
locuitor,www.realitatea.net,0,1,0,1,-1.0,1.0
primar general,www.realitatea.net,0,2,1,3,-0.6666666666666666,0.6666666666666666
Cristoiu,www.gandul.ro,0,2,1,3,-0.6666666666666666,0.6666666666666666
Ion Cristoiu,www.gandul.ro,0,3,2,5,-0.6,0.6
Ionuț Cristache,www.gandul.ro,0,0,2,2,0.0,0.0
Nicușor,www.gandul.ro,0,1,0,1,-1.0,1.0
Cristache,www.gandul.ro,0,0,1,1,0.0,0.0
Bulgaria,www.antena3.ro,1,1,5,7,0.0,0.0
Sorin Moisă,www.antena3.ro,0,0,1,1,0.0,0.0
Christian Terheș,www.romaniatv.net,0,0,1,1,0.0,0.0
Sebastian Popescu,www.romaniatv.net,0,0,1,1,0.0,0.0
Canada,observatornews.ro,0,0,1,1,0.0,0.0
China,observatornews.ro,0,0,2,2,0.0,0.0
Mosacova,observatornews.ro,0,1,0,1,-1.0,1.0
Vladimir Putin,observatornews.ro,0,3,2,5,-0.6,0.6
personaj,observatornews.ro,0,2,2,4,-0.5,0.5
Alexandru Rafila,www.news.ro,0,0,2,2,0.0,0.0
sindicalist,www.news.ro,0,0,1,1,0.0,0.0
angajator,www.news.ro,0,0,1,1,0.0,0.0
Boloș,www.romaniatv.net,0,0,1,1,0.0,0.0
Marcel Boloș,www.romaniatv.net,1,0,6,7,0.14285714285714285,0.14285714285714285
Vlad Voiculescu,www.romaniatv.net,0,2,1,3,-0.6666666666666666,0.6666666666666666
taximetrist,www.romaniatv.net,0,0,2,2,0.0,0.0
guvern,www.luju.ro,0,1,0,1,-1.0,1.0
Kelemen Hunor,www.luju.ro,0,1,3,4,-0.25,0.25
PE,www.luju.ro,0,1,0,1,-1.0,1.0
Elena Costache,www.luju.ro,0,1,5,6,-0.16666666666666666,0.16666666666666666
Anamaria Gavrilă,www.b1tv.ro,0,0,3,3,0.0,0.0
latifundiar,www.b1tv.ro,0,1,0,1,-1.0,1.0
personaj,www.b1tv.ro,0,2,0,2,-1.0,1.0
simpatizant,www.b1tv.ro,0,1,0,1,-1.0,1.0
Marian Mitrea,www.mediafax.ro,0,0,2,2,0.0,0.0
Romulus Mincă,www.mediafax.ro,0,0,2,2,0.0,0.0
Antonio Andrușceac,www.antena3.ro,0,0,2,2,0.0,0.0
contabil,www.antena3.ro,0,1,1,2,-0.5,0.5
Onoriu,www.antena3.ro,0,1,0,1,-1.0,1.0
Ringo Dămureanu,www.antena3.ro,0,0,1,1,0.0,0.0
Timotei Onoriu,www.antena3.ro,0,0,2,2,0.0,0.0
capitală,www.romaniatv.net,0,1,3,4,-0.25,0.25
Clotilde Armand,www.romaniatv.net,0,0,1,1,0.0,0.0
Cristian Ghinea,www.romaniatv.net,0,0,2,2,0.0,0.0
Cristian Popescu Piedone,www.romaniatv.net,0,1,1,2,-0.5,0.5
Cătălin Drulă,www.romaniatv.net,0,0,1,1,0.0,0.0
Donald Tusk,www.romaniatv.net,0,0,2,2,0.0,0.0
Florian Coldea,www.romaniatv.net,0,1,1,2,-0.5,0.5
Făgăraș,www.romaniatv.net,0,0,2,2,0.0,0.0
Lasconi,www.romaniatv.net,1,2,4,7,-0.14285714285714285,0.14285714285714285
Roșia Montană,www.romaniatv.net,0,2,0,2,-1.0,1.0
Silviu Prigoană,www.romaniatv.net,0,1,1,2,-0.5,0.5
Sorin Oprescu,www.romaniatv.net,0,1,2,3,-0.3333333333333333,0.3333333333333333
adjunct,www.romaniatv.net,0,0,1,1,0.0,0.0
competitor,www.romaniatv.net,0,3,0,3,-1.0,1.0
dezvoltator,www.romaniatv.net,0,0,1,1,0.0,0.0
jandarm,www.romaniatv.net,0,2,2,4,-0.5,0.5
matematician,www.romaniatv.net,0,1,2,3,-0.3333333333333333,0.3333333333333333
rival,www.romaniatv.net,0,5,0,5,-1.0,1.0
secretar de stat,www.romaniatv.net,0,0,2,2,0.0,0.0
Corneliu Coposu,www.mediafax.ro,0,0,1,1,0.0,0.0
domnul general,www.news.ro,0,1,0,1,-1.0,1.0
general Ciucă,www.news.ro,0,1,0,1,-1.0,1.0
purtător de cuvânt,www.news.ro,0,0,3,3,0.0,0.0
Romașcanu,www.news.ro,0,1,2,3,-0.3333333333333333,0.3333333333333333
Lucian Romașcanu,www.news.ro,0,0,3,3,0.0,0.0
Cristian Hrituc,www.aktual24.ro,0,0,4,4,0.0,0.0
Hrituc,www.aktual24.ro,0,0,2,2,0.0,0.0
bugetar,www.aktual24.ro,0,3,0,3,-1.0,1.0
Silvio Berlusconi,a1.ro,0,0,1,1,0.0,0.0
politist,a1.ro,0,3,0,3,-1.0,1.0
Barbu,www.activenews.ro,0,3,0,3,-1.0,1.0
Cătălin Antohe,www.activenews.ro,0,1,0,1,-1.0,1.0
fermier,www.activenews.ro,0,2,1,3,-0.6666666666666666,0.6666666666666666
Florin Barbu,www.activenews.ro,0,2,0,2,-1.0,1.0
Ministrul Barbu,www.activenews.ro,0,1,0,1,-1.0,1.0
Paul Stănescu,www.activenews.ro,0,0,2,2,0.0,0.0
Prahova,www.activenews.ro,0,0,2,2,0.0,0.0
Sorin Ghica,www.activenews.ro,0,1,0,1,-1.0,1.0
Stănescu,www.activenews.ro,0,1,0,1,-1.0,1.0
Vrancea,www.activenews.ro,0,0,2,2,0.0,0.0
agricultor,www.activenews.ro,0,1,0,1,-1.0,1.0
expert,www.activenews.ro,1,1,0,2,0.0,0.0
secretar general,www.activenews.ro,0,0,2,2,0.0,0.0
"Ștefan Stănescu, fiul",www.activenews.ro,0,1,0,1,-1.0,1.0
Andreea Crăciun,snoop.ro,0,0,2,2,0.0,0.0
Andreei,snoop.ro,0,0,1,1,0.0,0.0
Avocatul Poporului,snoop.ro,0,0,1,1,0.0,0.0
Dan Zaharescu,snoop.ro,0,0,1,1,0.0,0.0
Irimia,snoop.ro,0,0,1,1,0.0,0.0
Irlanda,snoop.ro,0,0,2,2,0.0,0.0
Lugoj,snoop.ro,0,0,1,1,0.0,0.0
Malta,snoop.ro,0,2,0,2,-1.0,1.0
Andrei Ungureanu,snoop.ro,0,0,2,2,0.0,0.0
Olanda,snoop.ro,0,0,4,4,0.0,0.0
Mihai Marinca,snoop.ro,0,0,1,1,0.0,0.0
Paul Fehlner,snoop.ro,0,0,1,1,0.0,0.0
Schenker,snoop.ro,0,0,1,1,0.0,0.0
Ungaria,snoop.ro,0,1,0,1,-1.0,1.0
Valeria Herdea,snoop.ro,0,0,1,1,0.0,0.0
Zaharescu,snoop.ro,0,0,1,1,0.0,0.0
asigurat,snoop.ro,0,1,0,1,-1.0,1.0
avocat Ellen,snoop.ro,0,0,1,1,0.0,0.0
distribuitor,snoop.ro,0,1,0,1,-1.0,1.0
farmacist,snoop.ro,0,0,1,1,0.0,0.0
finanțator,snoop.ro,0,1,1,2,-0.5,0.5
Marinca,snoop.ro,0,0,1,1,0.0,0.0
medic oncolog,snoop.ro,0,0,1,1,0.0,0.0
Michael Schenker,snoop.ro,0,0,1,1,0.0,0.0
producător,snoop.ro,0,1,1,2,-0.5,0.5
Attila Cseke,www.digi24.ro,0,0,2,2,0.0,0.0
Varujan Pambuccian,www.digi24.ro,0,0,1,1,0.0,0.0
Anglia,www.gandul.ro,0,0,1,1,0.0,0.0
Arad,www.gandul.ro,0,0,1,1,0.0,0.0
director general,www.gandul.ro,0,0,3,3,0.0,0.0
Dansul,www.gandul.ro,0,1,0,1,-1.0,1.0
Dânș,www.gandul.ro,0,1,0,1,-1.0,1.0
Hebenciuc,www.gandul.ro,0,0,1,1,0.0,0.0
Keir Starmer,www.gandul.ro,0,0,2,2,0.0,0.0
Nisa,www.gandul.ro,0,0,1,1,0.0,0.0
Regatul Unit al Marii Britanii,www.gandul.ro,1,0,1,2,0.5,0.5
Regatul Unit al Marii Britanii și Irlandei de Nord,www.gandul.ro,0,0,1,1,0.0,0.0
agent,www.gandul.ro,0,1,1,2,-0.5,0.5
coleg parlamentar,www.gandul.ro,0,0,1,1,0.0,0.0
compatriot,www.gandul.ro,1,0,0,1,1.0,1.0
de,www.gandul.ro,0,0,1,1,0.0,0.0
deștept,www.gandul.ro,0,1,0,1,-1.0,1.0
Eugen Tîlvăr,www.gandul.ro,0,0,1,1,0.0,0.0
Mînzatu,www.gandul.ro,0,1,0,1,-1.0,1.0
doamnă ambasador,www.gandul.ro,0,0,2,2,0.0,0.0
Boc,www.gandul.ro,0,0,2,2,0.0,0.0
Botei,www.gandul.ro,0,0,1,1,0.0,0.0
Tîlvăr,www.gandul.ro,1,0,1,2,0.5,0.5
Iohannis,www.gandul.ro,0,1,0,1,-1.0,1.0
dansator,www.gandul.ro,0,1,0,1,-1.0,1.0
dânș,www.gandul.ro,0,1,1,2,-0.5,0.5
neam,www.gandul.ro,0,1,0,1,-1.0,1.0
omolog,www.gandul.ro,0,0,3,3,0.0,0.0
Denys Shmyhal,www.gandul.ro,0,0,1,1,0.0,0.0
profesionist,www.gandul.ro,2,0,0,2,1.0,1.0
sală,www.gandul.ro,0,0,1,1,0.0,0.0
ul,www.gandul.ro,0,1,0,1,-1.0,1.0
bunic,www.luju.ro,0,0,1,1,0.0,0.0
cei,www.luju.ro,0,1,0,1,-1.0,1.0
părinte,www.luju.ro,1,0,3,4,0.25,0.25
Cseke,agerpres.ro,0,0,1,1,0.0,0.0
Ialomițean,primanews.ro,0,0,1,1,0.0,0.0
miriuță,primanews.ro,0,0,1,1,0.0,0.0
covăsnean,primanews.ro,0,1,0,1,-1.0,1.0
Carlo Fidanza,observatornews.ro,0,0,1,1,0.0,0.0
Marion Marechal,observatornews.ro,0,0,1,1,0.0,0.0
Mateusz Moravietki,observatornews.ro,0,0,2,2,0.0,0.0
Meloni,observatornews.ro,0,0,1,1,0.0,0.0
Simion,observatornews.ro,0,1,5,6,-0.16666666666666666,0.16666666666666666
contracandidat,observatornews.ro,0,1,2,3,-0.3333333333333333,0.3333333333333333
nepot,observatornews.ro,0,0,1,1,0.0,0.0
Cosea,a1.ro,0,0,1,1,0.0,0.0
Eckstein Kovacs,a1.ro,0,1,0,1,-1.0,1.0
Olt,a1.ro,0,0,4,4,0.0,0.0
Traian Igas,a1.ro,0,1,2,3,-0.3333333333333333,0.3333333333333333
mascarici,a1.ro,0,1,0,1,-1.0,1.0
administrator,www.romaniatv.net,0,1,0,1,-1.0,1.0
Bec,www.comisarul.ro,0,1,0,1,-1.0,1.0
Eduard Hellvig,www.cotidianul.ro,0,0,1,1,0.0,0.0
Hellvig,www.cotidianul.ro,1,0,0,1,1.0,1.0
aventurier,www.cotidianul.ro,0,1,0,1,-1.0,1.0
mamașă,www.cotidianul.ro,0,1,0,1,-1.0,1.0
Japonia,observatornews.ro,0,0,1,1,0.0,0.0
Shinzo Abe,observatornews.ro,0,0,1,1,0.0,0.0
general,observatornews.ro,0,2,0,2,-1.0,1.0
Adina Alberts,snoop.ro,0,0,1,1,0.0,0.0
Albania,snoop.ro,0,1,1,2,-0.5,0.5
Alexandru Niță,snoop.ro,0,0,2,2,0.0,0.0
Ana Maria Negrilă,snoop.ro,0,1,0,1,-1.0,1.0
Andrei Laslau,snoop.ro,0,1,0,1,-1.0,1.0
Andrei Laslău,snoop.ro,0,3,0,3,-1.0,1.0
Belgrad,snoop.ro,0,1,1,2,-0.5,0.5
Chiper,snoop.ro,0,1,1,2,-0.5,0.5
cititor,snoop.ro,2,2,1,5,0.0,0.0
civil,snoop.ro,0,1,0,1,-1.0,1.0
Columbia,snoop.ro,0,0,1,1,0.0,0.0
Cristela Georgescu,snoop.ro,0,0,2,2,0.0,0.0
Cătalina Chiper,snoop.ro,0,0,1,1,0.0,0.0
Cătălin Georgescu,snoop.ro,0,1,0,1,-1.0,1.0
Cătălin Straton,snoop.ro,0,0,1,1,0.0,0.0
Cătălina Chiper,snoop.ro,0,1,1,2,-0.5,0.5
Cătălinei Chiper,snoop.ro,0,1,0,1,-1.0,1.0
Dan,snoop.ro,0,0,5,5,0.0,0.0
Daniel Polifrone,snoop.ro,0,1,0,1,-1.0,1.0
Daniil Starkov,snoop.ro,0,0,1,1,0.0,0.0
Mehmet Oz,snoop.ro,0,1,0,1,-1.0,1.0
Emilian Mihailov,snoop.ro,1,0,1,2,0.5,0.5
Ewan Tolladay,snoop.ro,0,0,1,1,0.0,0.0
Gică Hagi,snoop.ro,0,0,1,1,0.0,0.0
IPS Teodosie,snoop.ro,0,1,0,1,-1.0,1.0
Ilan,snoop.ro,0,1,0,1,-1.0,1.0
Ilie Cătălin Straton,snoop.ro,0,0,1,1,0.0,0.0
Kazahstan,snoop.ro,0,1,0,1,-1.0,1.0
Kremlin,snoop.ro,0,2,0,2,-1.0,1.0
Laslau,snoop.ro,0,1,0,1,-1.0,1.0
Laslău,snoop.ro,0,2,0,2,-1.0,1.0
Irina Dobrot,snoop.ro,0,0,1,1,0.0,0.0
Leo Anders,snoop.ro,1,1,1,3,0.0,0.0
Leo Grasset,snoop.ro,1,0,0,1,1.0,1.0
Letonia,snoop.ro,0,1,1,2,-0.5,0.5
Rodica Zafiu,snoop.ro,0,1,0,1,-1.0,1.0
Maya Oprescu,snoop.ro,0,1,0,1,-1.0,1.0
Mesia,snoop.ro,0,1,0,1,-1.0,1.0
Mihailov,snoop.ro,0,0,1,1,0.0,0.0
Mirko Drotschman,snoop.ro,0,0,1,1,0.0,0.0
Nicoleta Miulescu,snoop.ro,0,0,1,1,0.0,0.0
Oltenia,snoop.ro,0,1,0,1,-1.0,1.0
Oprea,snoop.ro,0,1,0,1,-1.0,1.0
Polifrone,snoop.ro,0,1,0,1,-1.0,1.0
Raed Arafat,snoop.ro,0,0,1,1,0.0,0.0
Sebastian Ghiță,snoop.ro,0,2,0,2,-1.0,1.0
Serbia,snoop.ro,0,0,2,2,0.0,0.0
Singapore,snoop.ro,0,0,1,1,0.0,0.0
Slovacia,snoop.ro,0,0,3,3,0.0,0.0
Slovac,snoop.ro,0,0,2,2,0.0,0.0
Stanislav Fesenko,snoop.ro,0,1,2,3,-0.3333333333333333,0.3333333333333333
Starkov,snoop.ro,0,0,1,1,0.0,0.0
Straton,snoop.ro,0,0,1,1,0.0,0.0
Virgil Popescu,snoop.ro,0,0,1,1,0.0,0.0
Yulia Serebryanskaya,snoop.ro,0,0,1,1,0.0,0.0
absolvent,snoop.ro,0,0,2,2,0.0,0.0
alegător,snoop.ro,0,2,2,4,-0.5,0.5
bogat,snoop.ro,0,1,0,1,-1.0,1.0
cardiac,snoop.ro,0,1,0,1,-1.0,1.0
Adina Marincea,snoop.ro,0,0,1,1,0.0,0.0
craiovan,snoop.ro,0,0,1,1,0.0,0.0
credul,snoop.ro,0,1,0,1,-1.0,1.0
cumpărător,snoop.ro,0,1,1,2,-0.5,0.5
diabetic,snoop.ro,0,1,0,1,-1.0,1.0
doctoriță,snoop.ro,0,0,1,1,0.0,0.0
episcop,snoop.ro,0,1,0,1,-1.0,1.0
fugar,snoop.ro,0,2,0,2,-1.0,1.0
individ,snoop.ro,0,1,1,2,-0.5,0.5
lingvist,snoop.ro,0,1,0,1,-1.0,1.0
oligarh,snoop.ro,0,3,0,3,-1.0,1.0
omolog,snoop.ro,0,0,1,1,0.0,0.0
promotoare,snoop.ro,0,1,0,1,-1.0,1.0
soții Miulescu,snoop.ro,0,0,1,1,0.0,0.0
Răzvan,snoop.ro,0,0,1,1,0.0,0.0
subalternă,snoop.ro,0,1,0,1,-1.0,1.0
vizitator,snoop.ro,0,0,3,3,0.0,0.0
votant,snoop.ro,0,4,3,7,-0.5714285714285714,0.5714285714285714
vânzător,snoop.ro,0,0,2,2,0.0,0.0
văr,snoop.ro,0,1,0,1,-1.0,1.0
Țiriac,snoop.ro,0,0,1,1,0.0,0.0
Petre Daea,stirileprotv.ro,0,1,0,1,-1.0,1.0
Cristi Hrițuc,www.euronews.ro,0,0,2,2,0.0,0.0
Mihai Mazăre,www.euronews.ro,0,0,1,1,0.0,0.0
Paul Neagu,www.euronews.ro,0,0,1,1,0.0,0.0
Radu Mazăre,www.euronews.ro,0,1,0,1,-1.0,1.0
antrenor,www.euronews.ro,0,1,4,5,-0.2,0.2
consilier prezidențial,www.euronews.ro,0,0,1,1,0.0,0.0
frate,www.euronews.ro,1,0,1,2,0.5,0.5
martor,www.euronews.ro,0,0,1,1,0.0,0.0
mort,www.euronews.ro,0,2,0,2,-1.0,1.0
procuror,www.euronews.ro,0,7,4,11,-0.6363636363636364,0.6363636363636364
Dan Jurcan,www.euronews.ro,0,0,3,3,0.0,0.0
sportiv,www.euronews.ro,2,0,5,7,0.2857142857142857,0.2857142857142857
Hamburg,www.activenews.ro,0,0,1,1,0.0,0.0
Ierusalim,adevarul.ro,0,0,1,1,0.0,0.0
Iisus Hristos,adevarul.ro,2,0,0,2,1.0,1.0
credincios,adevarul.ro,0,1,4,5,-0.2,0.2
președintele interimar,adevarul.ro,0,0,1,1,0.0,0.0
Spania,observatornews.ro,0,0,1,1,0.0,0.0
analișt,observatornews.ro,0,0,1,1,0.0,0.0
Băluță,stirileprotv.ro,0,0,1,1,0.0,0.0
Dan Șucu,stirileprotv.ro,0,0,2,2,0.0,0.0
Daniel Băluță,stirileprotv.ro,0,0,2,2,0.0,0.0
Sebastian Burduja,stirileprotv.ro,0,0,5,5,0.0,0.0
Tiberiu Florescu,stirileprotv.ro,0,0,1,1,0.0,0.0
autor,stirileprotv.ro,0,0,2,2,0.0,0.0
fin,stirileprotv.ro,0,0,1,1,0.0,0.0
Cătălin Cârstoiu,stirileprotv.ro,0,0,1,1,0.0,0.0
respectivul,stirileprotv.ro,0,1,0,1,-1.0,1.0
Alexandra Păcuraru,adevarul.ro,0,0,1,1,0.0,0.0
exportator,www.aktual24.ro,0,1,0,1,-1.0,1.0
investitor,www.aktual24.ro,0,2,6,8,-0.25,0.25
bucureștean,www.romaniatv.net,0,0,2,2,0.0,0.0
cumpărător,primanews.ro,0,0,1,1,0.0,0.0
dezvoltator,primanews.ro,0,1,0,1,-1.0,1.0
Mircea Abrudean,primanews.ro,0,0,2,2,0.0,0.0
AUR,www.g4media.ro,0,0,1,1,0.0,0.0
Eugen Sechila,www.g4media.ro,0,1,0,1,-1.0,1.0
Zoe Rădulescu,www.g4media.ro,0,0,1,1,0.0,0.0
legionar,www.g4media.ro,0,2,0,2,-1.0,1.0
neolegionar,www.g4media.ro,0,2,0,2,-1.0,1.0
pro,www.g4media.ro,0,1,0,1,-1.0,1.0
soacră,www.g4media.ro,0,1,0,1,-1.0,1.0
BogPr,www.activenews.ro,0,1,0,1,-1.0,1.0
Corneliu Tudor,www.activenews.ro,0,1,0,1,-1.0,1.0
Cristoiu,www.activenews.ro,0,0,1,1,0.0,0.0
Gabriela Ștefan,www.activenews.ro,1,0,0,1,1.0,1.0
Marco Rubio,www.activenews.ro,0,0,1,1,0.0,0.0
Marius Tucă,www.activenews.ro,0,1,2,3,-0.3333333333333333,0.3333333333333333
Robert Turcescu,www.activenews.ro,0,0,3,3,0.0,0.0
Tucă,www.activenews.ro,0,1,0,1,-1.0,1.0
anonim,www.activenews.ro,0,1,0,1,-1.0,1.0
dependent,www.activenews.ro,0,1,0,1,-1.0,1.0
doamna Popa,www.activenews.ro,1,0,0,1,1.0,1.0
influencer,www.activenews.ro,0,6,0,6,-1.0,1.0
puști,www.activenews.ro,0,2,0,2,-1.0,1.0
Alis Popa,www.activenews.ro,0,0,1,1,0.0,0.0
traficant,www.activenews.ro,0,1,0,1,-1.0,1.0
Keir Starmer,observatornews.ro,0,0,2,2,0.0,0.0
Kremlin,observatornews.ro,0,1,0,1,-1.0,1.0
Marea Britanie,observatornews.ro,0,0,2,2,0.0,0.0
Moscova,observatornews.ro,0,2,1,3,-0.6666666666666666,0.6666666666666666
soldat,observatornews.ro,0,0,2,2,0.0,0.0
trimis,observatornews.ro,0,0,2,2,0.0,0.0
Flutur,primanews.ro,0,0,1,1,0.0,0.0
Marian Andronache,primanews.ro,0,0,1,1,0.0,0.0
Băsescu,www.romaniatv.net,0,7,2,9,-0.7777777777777778,0.7777777777777778
Câmpulung,www.romaniatv.net,0,0,1,1,0.0,0.0
cinvea,www.romaniatv.net,0,1,0,1,-1.0,1.0
călugăriță,www.romaniatv.net,0,1,0,1,-1.0,1.0
doamna Lasconi,www.romaniatv.net,0,1,0,1,-1.0,1.0
independent,www.romaniatv.net,0,0,3,3,0.0,0.0
Corneliu Tudor,www.comisarul.ro,0,0,1,1,0.0,0.0
Cristian Terheș,www.comisarul.ro,0,0,4,4,0.0,0.0
Daniel Funeriu,www.comisarul.ro,0,0,7,7,0.0,0.0
Ion M Ioniță,www.comisarul.ro,0,0,1,1,0.0,0.0
Ion M. Ioniță,www.comisarul.ro,0,0,2,2,0.0,0.0
Ionaș-Vladimir,www.comisarul.ro,0,0,1,1,0.0,0.0
Ioniță,www.comisarul.ro,0,0,1,1,0.0,0.0
Lavinia Șandru,www.comisarul.ro,0,0,4,4,0.0,0.0
Sebastian Pricop,www.comisarul.ro,0,0,1,1,0.0,0.0
sociolog,www.comisarul.ro,0,0,7,7,0.0,0.0
redactor șef,www.comisarul.ro,0,0,2,2,0.0,0.0
Anghel Iordănescu,pressone.ro,0,0,1,1,0.0,0.0
Gabriel Zetea,pressone.ro,0,0,1,1,0.0,0.0
Ilie Năstase,pressone.ro,0,0,1,1,0.0,0.0
Talpoș,pressone.ro,0,1,0,1,-1.0,1.0
traseist,pressone.ro,0,1,0,1,-1.0,1.0
Barna,primanews.ro,0,0,1,1,0.0,0.0
Ninel Peia,primanews.ro,0,0,2,2,0.0,0.0
Andrei Pungovschi,recorder.ro,0,1,0,1,-1.0,1.0
Helmuth Duckadam,recorder.ro,0,0,1,1,0.0,0.0
Mairan Enache,recorder.ro,0,0,1,1,0.0,0.0
Marian Enache,recorder.ro,0,0,3,3,0.0,0.0
Venera Dimulescu,recorder.ro,0,1,0,1,-1.0,1.0
oier,recorder.ro,0,1,0,1,-1.0,1.0
Horațiu Potra,www.comisarul.ro,0,3,0,3,-1.0,1.0
Mediaș,www.comisarul.ro,0,0,2,2,0.0,0.0
Potra,www.comisarul.ro,0,1,0,1,-1.0,1.0
Prahova,www.comisarul.ro,0,0,3,3,0.0,0.0
asociat,www.comisarul.ro,0,0,2,2,0.0,0.0
luptător,www.comisarul.ro,0,0,1,1,0.0,0.0
mască,www.comisarul.ro,0,1,0,1,-1.0,1.0
mercenar,www.comisarul.ro,0,2,1,3,-0.6666666666666666,0.6666666666666666
Brandenburg,www.comisarul.ro,0,0,1,1,0.0,0.0
Saxonia,www.comisarul.ro,0,0,1,1,0.0,0.0
Tino Chrupalla,www.comisarul.ro,0,0,1,1,0.0,0.0
Turingia,www.comisarul.ro,0,0,1,1,0.0,0.0
imigrant,www.comisarul.ro,0,1,0,1,-1.0,1.0
Belize,www.comisarul.ro,0,0,1,1,0.0,0.0
Borca,www.comisarul.ro,0,0,1,1,0.0,0.0
Dubai,www.comisarul.ro,0,0,1,1,0.0,0.0
Gura Humorului,www.comisarul.ro,0,0,1,1,0.0,0.0
Maldive,www.comisarul.ro,0,0,1,1,0.0,0.0
Neamț,www.comisarul.ro,0,0,1,1,0.0,0.0
Caras Severin,a1.ro,0,0,1,1,0.0,0.0
Cristian Topescu,a1.ro,0,0,1,1,0.0,0.0
Eugen Nicolaescu,a1.ro,0,0,2,2,0.0,0.0
Gabriel Grozavu,a1.ro,0,0,1,1,0.0,0.0
Liviu Mazilu,a1.ro,0,0,1,1,0.0,0.0
Marcel Vela,a1.ro,0,0,1,1,0.0,0.0
Mihai Volinturu,a1.ro,0,0,1,1,0.0,0.0
Rares Manescu,a1.ro,0,0,1,1,0.0,0.0
Ioan Ghise,a1.ro,0,0,1,1,0.0,0.0
Victor Ciorbea,a1.ro,0,0,1,1,0.0,0.0
Vlad Moisescu,a1.ro,0,0,1,1,0.0,0.0
conduc,a1.ro,0,0,1,1,0.0,0.0
coordonator,a1.ro,0,1,2,3,-0.3333333333333333,0.3333333333333333
Petre Roman,a1.ro,0,0,1,1,0.0,0.0
Dr. Gulati,www.comisarul.ro,0,0,1,1,0.0,0.0
Martha Gulati,www.comisarul.ro,0,0,1,1,0.0,0.0
Razan Hallak,www.comisarul.ro,0,0,1,1,0.0,0.0
dr. Batheja,www.comisarul.ro,0,0,1,1,0.0,0.0
dr. Gulati,www.comisarul.ro,0,0,1,1,0.0,0.0
Sapna Batheja,www.comisarul.ro,0,0,1,1,0.0,0.0
profesor asistent,www.comisarul.ro,0,0,1,1,0.0,0.0
Alba,www.mediafax.ro,0,1,1,2,-0.5,0.5
Brătianu,www.mediafax.ro,0,1,0,1,-1.0,1.0
Băișanu,www.mediafax.ro,0,0,1,1,0.0,0.0
Cazan,www.mediafax.ro,0,0,1,1,0.0,0.0
Călin,www.mediafax.ro,0,1,0,1,-1.0,1.0
Gheorghe Dragomir,www.mediafax.ro,0,3,0,3,-1.0,1.0
Gabriel Oprea,www.mediafax.ro,0,1,2,3,-0.3333333333333333,0.3333333333333333
George Scutaru,www.mediafax.ro,0,0,2,2,0.0,0.0
Holban,www.mediafax.ro,0,0,1,1,0.0,0.0
Horea Uioreanu,www.mediafax.ro,0,0,1,1,0.0,0.0
Hunedoara,www.mediafax.ro,0,0,1,1,0.0,0.0
Hunedoarei,www.mediafax.ro,0,1,0,1,-1.0,1.0
Ion Tămâian,www.mediafax.ro,0,0,1,1,0.0,0.0
Mihai Volintiru,www.mediafax.ro,0,0,1,1,0.0,0.0
Motreanu,www.mediafax.ro,0,1,0,1,-1.0,1.0
Scutaru,www.mediafax.ro,0,0,1,1,0.0,0.0
Dian Popescu,www.mediafax.ro,0,1,2,3,-0.3333333333333333,0.3333333333333333
Stoica,www.mediafax.ro,0,1,1,2,-0.5,0.5
Theodor Stolojan,www.mediafax.ro,0,1,0,1,-1.0,1.0
Titi Holban,www.mediafax.ro,0,0,2,2,0.0,0.0
Tămâian,www.mediafax.ro,0,1,0,1,-1.0,1.0
Uioreanu,www.mediafax.ro,0,0,1,1,0.0,0.0
Valeriu Stoica,www.mediafax.ro,0,0,3,3,0.0,0.0
admirator,www.mediafax.ro,0,2,0,2,-1.0,1.0
contestatar,www.mediafax.ro,0,1,0,1,-1.0,1.0
corespondent,www.mediafax.ro,0,0,1,1,0.0,0.0
Alexandru Băișanu,www.mediafax.ro,0,0,1,1,0.0,0.0
dansator,www.mediafax.ro,0,3,0,3,-1.0,1.0
electorat,www.mediafax.ro,0,2,1,3,-0.6666666666666666,0.6666666666666666
hunedoare,www.mediafax.ro,0,1,0,1,-1.0,1.0
nemulțumit,www.mediafax.ro,0,1,0,1,-1.0,1.0
susține,www.mediafax.ro,0,1,0,1,-1.0,1.0
traseiști,www.mediafax.ro,0,2,0,2,-1.0,1.0
Ambii,adevarul.ro,0,0,1,1,0.0,0.0
Cristian Nistor,agerpres.ro,0,0,2,2,0.0,0.0
Eoghan Murphy,agerpres.ro,0,0,1,1,0.0,0.0
Lucie Potuckova,agerpres.ro,0,0,2,2,0.0,0.0
Potuckova,agerpres.ro,0,0,1,1,0.0,0.0
Budapesta,www.gandul.ro,0,0,1,1,0.0,0.0
ambasadoare,www.gandul.ro,0,0,3,3,0.0,0.0
Viktor Orban,www.gandul.ro,0,0,1,1,0.0,0.0
Augustin Lazăr,www.gandul.ro,0,0,1,1,0.0,0.0
Vasilescu,www.gandul.ro,0,0,1,1,0.0,0.0
Australia,www.antena3.ro,0,0,1,1,0.0,0.0
Japonia,www.antena3.ro,0,0,1,1,0.0,0.0
Kaja Kallas,www.antena3.ro,0,0,1,1,0.0,0.0
Marco Rubio,www.antena3.ro,0,0,1,1,0.0,0.0
Noua Zeelandă,www.antena3.ro,0,0,1,1,0.0,0.0
Coreea de Sud,www.antena3.ro,0,0,1,1,0.0,0.0
Secretar de stat,www.antena3.ro,0,0,2,2,0.0,0.0
Înaltul Reprezentant,www.antena3.ro,0,0,1,1,0.0,0.0
Înalt Reprezentant,www.antena3.ro,0,0,1,1,0.0,0.0
Florin Roman,recorder.ro,0,2,2,4,-0.5,0.5
Cosmin Nedelcu,www.euronews.ro,0,0,1,1,0.0,0.0
Lasconi,www.euronews.ro,1,0,5,6,0.16666666666666666,0.16666666666666666
Alexandru Muraru,primanews.ro,0,0,1,1,0.0,0.0
Iliescu,primanews.ro,0,0,2,2,0.0,0.0
Blair,pressone.ro,0,1,0,1,-1.0,1.0
Eugen Nicolicea,pressone.ro,0,2,4,6,-0.3333333333333333,0.3333333333333333
Gabriel Petrea,pressone.ro,0,0,1,1,0.0,0.0
Ghiță,pressone.ro,0,3,0,3,-1.0,1.0
Remus Borza,pressone.ro,0,0,2,2,0.0,0.0
Tony Blair,pressone.ro,0,0,2,2,0.0,0.0
aleș,pressone.ro,0,3,1,4,-0.75,0.75
Dumitru Pelican,pressone.ro,0,0,2,2,0.0,0.0
Bran,pressone.ro,0,1,0,1,-1.0,1.0
Cristian Dumitrescu,pressone.ro,0,1,2,3,-0.3333333333333333,0.3333333333333333
Dumitrescu,pressone.ro,0,2,0,2,-1.0,1.0
George Ivașcu,pressone.ro,0,0,2,2,0.0,0.0
Ivașcu,pressone.ro,0,0,1,1,0.0,0.0
Kelemen Hunor,pressone.ro,1,0,4,5,0.2,0.2
Meleșcanu,pressone.ro,0,0,1,1,0.0,0.0
Robert Turcescu,pressone.ro,0,1,1,2,-0.5,0.5
Turcescu,pressone.ro,0,1,1,2,-0.5,0.5
Valentin Popa,pressone.ro,0,4,2,6,-0.6666666666666666,0.6666666666666666
coleg parlamentar,pressone.ro,0,1,0,1,-1.0,1.0
întrerupe,pressone.ro,0,1,0,1,-1.0,1.0
Alexei Navalnîi,www.gandul.ro,1,0,0,1,1.0,1.0
rus,www.gandul.ro,0,0,1,1,0.0,0.0
diplomat,www.gandul.ro,0,0,6,6,0.0,0.0
austriac,www.gandul.ro,0,0,3,3,0.0,0.0
Gerhard Karner,www.gandul.ro,0,0,1,1,0.0,0.0
Karner,www.gandul.ro,0,0,1,1,0.0,0.0
migrant,www.gandul.ro,0,0,2,2,0.0,0.0
Apostolou Pavlou,pressone.ro,1,0,0,1,1.0,1.0
Atena,pressone.ro,1,0,1,2,0.5,0.5
Athenian,pressone.ro,0,1,0,1,-1.0,1.0
baba,pressone.ro,1,0,0,1,1.0,1.0
Charakas,pressone.ro,0,0,1,1,0.0,0.0
Christopher Columbus,pressone.ro,1,0,0,1,1.0,1.0
Elliniko,pressone.ro,0,0,1,1,0.0,0.0
Kalavryta,pressone.ro,1,0,0,1,1.0,1.0
Kerameikos,pressone.ro,1,0,0,1,1.0,1.0
Lefterit,pressone.ro,0,1,0,1,-1.0,1.0
Limanaki,pressone.ro,1,0,0,1,1.0,1.0
Monastiraki,pressone.ro,0,0,1,1,0.0,0.0
Petralona,pressone.ro,1,0,0,1,1.0,1.0
Pikpa,pressone.ro,1,0,0,1,1.0,1.0
Saronida,pressone.ro,1,0,0,1,1.0,1.0
Voula,pressone.ro,1,0,0,1,1.0,1.0
Vouliagmeni,pressone.ro,0,1,0,1,-1.0,1.0
You,pressone.ro,0,0,1,1,0.0,0.0
e,pressone.ro,0,1,0,1,-1.0,1.0
he,pressone.ro,0,1,0,1,-1.0,1.0
oameni,pressone.ro,0,0,2,2,0.0,0.0
they,pressone.ro,0,0,2,2,0.0,0.0
turistic,pressone.ro,0,1,0,1,-1.0,1.0
—,pressone.ro,0,1,0,1,-1.0,1.0
Harkov,www.mediafax.ro,0,1,0,1,-1.0,1.0
Kiev,www.mediafax.ro,0,1,1,2,-0.5,0.5
Odesa,www.mediafax.ro,0,0,1,1,0.0,0.0
,observatornews.ro,0,1,1,2,-0.5,0.5
Belgia,observatornews.ro,0,0,2,2,0.0,0.0
Brașov,observatornews.ro,0,0,2,2,0.0,0.0
Ekaterina Zaharieva,observatornews.ro,0,0,1,1,0.0,0.0
german,observatornews.ro,0,0,1,1,0.0,0.0
Iulian Popov,observatornews.ro,0,0,1,1,0.0,0.0
Letonia,observatornews.ro,0,0,1,1,0.0,0.0
Roxana Mînzatu,observatornews.ro,0,0,2,2,0.0,0.0
Ungaria,observatornews.ro,0,0,2,2,0.0,0.0
Ursula von der Leyen,observatornews.ro,0,2,7,9,-0.2222222222222222,0.2222222222222222
angajat,observatornews.ro,1,0,3,4,0.25,0.25
comisar,observatornews.ro,0,2,7,9,-0.2222222222222222,0.2222222222222222
Kaja Kallas,observatornews.ro,0,1,2,3,-0.3333333333333333,0.3333333333333333
subprefect,observatornews.ro,0,0,2,2,0.0,0.0
von der Leyen,observatornews.ro,0,0,1,1,0.0,0.0
Portocală,www.romaniatv.net,0,0,1,1,0.0,0.0
Ciprian Dobre,www.romaniatv.net,0,0,1,1,0.0,0.0
Daniel Șandru,www.romaniatv.net,0,0,1,1,0.0,0.0
Dobre,www.romaniatv.net,0,0,1,1,0.0,0.0
dictator,www.romaniatv.net,0,2,0,2,-1.0,1.0
Craig,a1.ro,0,0,1,1,0.0,0.0
Iulian Bohan,a1.ro,0,0,1,1,0.0,0.0
Jay Shetty,a1.ro,0,0,1,1,0.0,0.0
Michelle,a1.ro,1,0,0,1,1.0,1.0
Robinson,a1.ro,0,0,1,1,0.0,0.0
antrenor,a1.ro,0,0,1,1,0.0,0.0
coach,a1.ro,0,0,1,1,0.0,0.0
călugăr,a1.ro,0,0,1,1,0.0,0.0
fotograf,a1.ro,1,0,0,1,1.0,1.0
frate,a1.ro,0,0,2,2,0.0,0.0
partener,a1.ro,2,1,4,7,0.14285714285714285,0.14285714285714285
primă doamnă,a1.ro,0,0,1,1,0.0,0.0
suroră,a1.ro,0,0,1,1,0.0,0.0
Dragoș Sprînceană,agerpres.ro,0,0,1,1,0.0,0.0
James Edwin Trainor,agerpres.ro,0,0,1,1,0.0,0.0
Kathleen Kavalec,agerpres.ro,0,0,1,1,0.0,0.0
ambasadoare,agerpres.ro,0,0,1,1,0.0,0.0
oficial,agerpres.ro,1,0,0,1,1.0,1.0
vicepremier,agerpres.ro,0,0,2,2,0.0,0.0
Marian Neacșu,agerpres.ro,0,0,2,2,0.0,0.0
Florin Zamfirescu,www.realitatea.net,0,1,0,1,-1.0,1.0
prieten,primanews.ro,1,0,1,2,0.5,0.5
greblă,snoop.ro,0,4,0,4,-1.0,1.0
Toni Greblă,snoop.ro,0,6,3,9,-0.6666666666666666,0.6666666666666666
conducător,snoop.ro,0,1,0,1,-1.0,1.0
predecesor,snoop.ro,0,1,0,1,-1.0,1.0
reprezentantă,snoop.ro,0,1,1,2,-0.5,0.5
Sighiartău,recorder.ro,0,0,1,1,0.0,0.0
Varujan Vosganian,recorder.ro,0,1,0,1,-1.0,1.0
Mihai Tudose,adevarul.ro,0,1,5,6,-0.16666666666666666,0.16666666666666666
Nimenii,adevarul.ro,0,0,1,1,0.0,0.0
Marcel Romanescu,www.b1tv.ro,0,0,2,2,0.0,0.0
Romanescu,www.b1tv.ro,0,2,0,2,-1.0,1.0
Târgu Jiu,www.b1tv.ro,0,0,1,1,0.0,0.0
Alexandra Păcuraru,www.antena3.ro,0,0,1,1,0.0,0.0
Ana Birchall,www.antena3.ro,0,2,1,3,-0.6666666666666666,0.6666666666666666
Viorel Hrebenciuc,www.antena3.ro,0,0,1,1,0.0,0.0
oaspete,www.antena3.ro,0,0,1,1,0.0,0.0
Ceaușescu,www.g4media.ro,0,3,0,3,-1.0,1.0
guvernant,www.g4media.ro,0,1,0,1,-1.0,1.0
JD Vance,www.g4media.ro,0,1,0,1,-1.0,1.0
Moscova,www.g4media.ro,0,4,1,5,-0.8,0.8
München,www.g4media.ro,0,0,1,1,0.0,0.0
Polonia,www.g4media.ro,0,1,4,5,-0.2,0.2
român,www.g4media.ro,0,0,1,1,0.0,0.0
matematician,www.g4media.ro,0,0,1,1,0.0,0.0
Cristian Deliorga,stirileprotv.ro,0,0,1,1,0.0,0.0
Gheorghe Stan,stirileprotv.ro,0,0,1,1,0.0,0.0
Iordache,stirileprotv.ro,0,0,1,1,0.0,0.0
Kiseleff,stirileprotv.ro,0,1,0,1,-1.0,1.0
băiat,stirileprotv.ro,0,0,2,2,0.0,0.0
Stan,stirileprotv.ro,0,1,0,1,-1.0,1.0
Adrian Zăbavă,www.digi24.ro,0,0,2,2,0.0,0.0
Marcel,www.digi24.ro,0,0,1,1,0.0,0.0
Nicu,www.digi24.ro,0,1,0,1,-1.0,1.0
consultant,www.digi24.ro,0,1,1,2,-0.5,0.5
Dan Simion,www.euronews.ro,0,0,1,1,0.0,0.0
Suveranul Pontif,www.euronews.ro,0,0,2,2,0.0,0.0
Turcia,www.euronews.ro,0,0,4,4,0.0,0.0
Vatican,www.euronews.ro,0,0,1,1,0.0,0.0
antreprenor,www.euronews.ro,1,2,1,4,-0.25,0.25
doritor,www.euronews.ro,0,1,0,1,-1.0,1.0
papă,www.euronews.ro,0,0,2,2,0.0,0.0
Giorgia Meloni,www.mediafax.ro,0,0,1,1,0.0,0.0
Italia,www.mediafax.ro,0,0,3,3,0.0,0.0
migrant,www.mediafax.ro,0,1,1,2,-0.5,0.5
Iliescu,www.romaniatv.net,0,1,1,2,-0.5,0.5
fost,www.romaniatv.net,0,1,0,1,-1.0,1.0
Petroșani,www.realitatea.net,0,0,1,1,0.0,0.0
Andreea Alexandru,www.gandul.ro,0,0,3,3,0.0,0.0
Grindeanu,www.gandul.ro,0,1,3,4,-0.25,0.25
militar,www.news.ro,2,1,5,8,0.125,0.125
invitat,www.b1tv.ro,0,1,0,1,-1.0,1.0
Ioanei Constantin,www.b1tv.ro,0,0,1,1,0.0,0.0
Odesa,www.b1tv.ro,0,1,0,1,-1.0,1.0
politolog,www.b1tv.ro,0,0,2,2,0.0,0.0
Stelian Tănase,www.b1tv.ro,0,0,3,3,0.0,0.0
diplomat,www.b1tv.ro,1,0,2,3,0.3333333333333333,0.3333333333333333
Rădulescu,www.mediafax.ro,0,1,0,1,-1.0,1.0
dansă,www.mediafax.ro,0,1,0,1,-1.0,1.0
lume,www.mediafax.ro,0,1,0,1,-1.0,1.0
securist,www.mediafax.ro,0,1,0,1,-1.0,1.0
Petrescu,www.luju.ro,0,0,1,1,0.0,0.0
grefier,www.luju.ro,0,2,10,12,-0.16666666666666666,0.16666666666666666
Elena Dumbraveanu,www.luju.ro,0,0,1,1,0.0,0.0
Luminița Petrescu,www.luju.ro,0,0,1,1,0.0,0.0
Dana Safta,stirileprotv.ro,0,0,1,1,0.0,0.0
Mihaela Mihai,stirileprotv.ro,0,0,1,1,0.0,0.0
Mihai Covaliu,stirileprotv.ro,0,0,1,1,0.0,0.0
Ovidiu Lipan Tandarica,stirileprotv.ro,0,0,1,1,0.0,0.0
inițiator,stirileprotv.ro,0,2,7,9,-0.2222222222222222,0.2222222222222222
membru fondator,stirileprotv.ro,0,0,1,1,0.0,0.0
Aleș,primanews.ro,0,1,0,1,-1.0,1.0
Florin Cițu,primanews.ro,0,0,1,1,0.0,0.0
subrefect,primanews.ro,0,1,0,1,-1.0,1.0
Ceban,observatornews.ro,0,0,1,1,0.0,0.0
Dan,observatornews.ro,0,1,0,1,-1.0,1.0
Ion Ceban,observatornews.ro,0,0,1,1,0.0,0.0
Andrei Moroianu,www.comisarul.ro,0,0,1,1,0.0,0.0
Martin Andler,www.comisarul.ro,0,0,1,1,0.0,0.0
Andreea Vlanga,www.g4media.ro,0,0,1,1,0.0,0.0
Andrei Bușe,www.g4media.ro,0,0,1,1,0.0,0.0
Banu Muscel,www.g4media.ro,0,0,1,1,0.0,0.0
Cezar Bujeniță Batog,www.g4media.ro,0,0,1,1,0.0,0.0
Cristian Mihai,www.g4media.ro,0,0,1,1,0.0,0.0
Daniel Funeriu,www.g4media.ro,0,0,1,1,0.0,0.0
Doina Grosu,www.g4media.ro,0,0,1,1,0.0,0.0
Fadi Haifawi,www.g4media.ro,0,0,1,1,0.0,0.0
Gabriel Radu-Constantinescu,www.g4media.ro,0,0,1,1,0.0,0.0
Gabriel Scrieciu,www.g4media.ro,0,0,1,1,0.0,0.0
Georgian Pop,www.g4media.ro,0,0,1,1,0.0,0.0
Horațiu Iancu,www.g4media.ro,0,0,1,1,0.0,0.0
Ion John,www.g4media.ro,0,0,1,1,0.0,0.0
Iulian Iancu,www.g4media.ro,0,1,0,1,-1.0,1.0
Lavinia Șandru,www.g4media.ro,0,0,3,3,0.0,0.0
Mihai Doinița,www.g4media.ro,0,0,1,1,0.0,0.0
Mihai Ionuț Pop,www.g4media.ro,0,0,1,1,0.0,0.0
Antonel Mocanu,www.g4media.ro,0,0,1,1,0.0,0.0
Ploiești,www.g4media.ro,0,0,1,1,0.0,0.0
Scrieciu Gabriel,www.g4media.ro,0,0,1,1,0.0,0.0
Sebastian Popescu,www.g4media.ro,0,0,1,1,0.0,0.0
Silviu Predoiu,www.g4media.ro,0,0,1,1,0.0,0.0
donator,www.g4media.ro,0,0,2,2,0.0,0.0
magnat,www.g4media.ro,0,0,1,1,0.0,0.0
terț,www.g4media.ro,0,1,0,1,-1.0,1.0
voluntar,www.g4media.ro,1,1,1,3,0.0,0.0
Cristian Pîrvulescu,www.comisarul.ro,0,1,3,4,-0.25,0.25
fiț,www.comisarul.ro,0,1,0,1,-1.0,1.0
Stoiciu,www.comisarul.ro,0,0,2,2,0.0,0.0
Dungaciu,www.antena3.ro,0,1,2,3,-0.3333333333333333,0.3333333333333333
Republica Moldova,www.antena3.ro,3,1,3,7,0.2857142857142857,0.2857142857142857
comodatar,www.antena3.ro,0,0,1,1,0.0,0.0
geopolitolog,www.antena3.ro,0,1,0,1,-1.0,1.0
profesor universitar,www.antena3.ro,0,0,1,1,0.0,0.0
subsecretar,www.antena3.ro,0,0,1,1,0.0,0.0
suspect,www.antena3.ro,0,1,1,2,-0.5,0.5
Bianca Firezar,www.romaniatv.net,0,0,1,1,0.0,0.0
Firezar,www.romaniatv.net,0,0,1,1,0.0,0.0
Florin Lazăr Vlădică,www.romaniatv.net,0,0,1,1,0.0,0.0
consilier parlamentar,www.romaniatv.net,0,0,2,2,0.0,0.0
expert,www.romaniatv.net,0,3,3,6,-0.5,0.5
Dana Păcurar,www.romaniatv.net,0,1,0,1,-1.0,1.0
șofer,www.romaniatv.net,0,3,6,9,-0.3333333333333333,0.3333333333333333
a,www.euronews.ro,0,0,2,2,0.0,0.0
Doina Pană,pressone.ro,0,1,5,6,-0.16666666666666666,0.16666666666666666
Liviu Pop,pressone.ro,0,2,4,6,-0.3333333333333333,0.3333333333333333
Stănescu,pressone.ro,0,0,2,2,0.0,0.0
Poiana Brașov,www.euronews.ro,0,0,1,1,0.0,0.0
delegat,www.euronews.ro,0,0,1,1,0.0,0.0
Costel Alexe,www.digi24.ro,0,0,1,1,0.0,0.0
Ion,www.digi24.ro,1,0,2,3,0.3333333333333333,0.3333333333333333
Ion Creangă,www.digi24.ro,1,0,0,1,1.0,1.0
Țicău,www.digi24.ro,0,1,0,1,-1.0,1.0
Veștea,www.romaniatv.net,0,0,1,1,0.0,0.0
Claudiu Catană,www.gandul.ro,0,0,1,1,0.0,0.0
Daniel Olteanu,www.gandul.ro,0,0,1,1,0.0,0.0
Mircea Minea,www.gandul.ro,0,0,1,1,0.0,0.0
Mohammad Murad,www.gandul.ro,0,0,1,1,0.0,0.0
Varujan Vosganian,www.gandul.ro,0,1,1,2,-0.5,0.5
capitalist,www.gandul.ro,0,1,0,1,-1.0,1.0
Călin Popescu Tăriceanu,www.gandul.ro,1,1,0,2,0.0,0.0
locuitor,www.gandul.ro,1,1,2,4,0.0,0.0
Adina Vălean,pressone.ro,0,0,4,4,0.0,0.0
Matei Păun,pressone.ro,0,1,0,1,-1.0,1.0
Meloni,pressone.ro,1,0,1,2,0.5,0.5
Robert Fico,pressone.ro,0,1,0,1,-1.0,1.0
Slovac,pressone.ro,0,2,0,2,-1.0,1.0
altuia,pressone.ro,0,2,0,2,-1.0,1.0
Toni Grebla,adevarul.ro,0,0,1,1,0.0,0.0
Antal Szabolcs Barabási,www.g4media.ro,0,0,1,1,0.0,0.0
Arad,www.g4media.ro,0,0,5,5,0.0,0.0
Bistrița,www.g4media.ro,0,1,1,2,-0.5,0.5
Covasna,www.g4media.ro,0,0,5,5,0.0,0.0
Harghita,www.g4media.ro,0,0,4,4,0.0,0.0
Hunedoara,www.g4media.ro,0,0,1,1,0.0,0.0
István Ráduly,www.g4media.ro,0,0,1,1,0.0,0.0
Sándor Petres,www.g4media.ro,0,0,1,1,0.0,0.0
Sălaj,www.g4media.ro,0,0,3,3,0.0,0.0
Tamás Ferenc Altfatter,www.g4media.ro,0,0,1,1,0.0,0.0
comisar,www.g4media.ro,0,1,1,2,-0.5,0.5
secretar,www.g4media.ro,0,2,6,8,-0.25,0.25
subprefect,www.g4media.ro,0,0,3,3,0.0,0.0
votant,observatornews.ro,0,2,1,3,-0.6666666666666666,0.6666666666666666
Abrudean,observatornews.ro,0,0,2,2,0.0,0.0
Mircea Abrudean,observatornews.ro,0,0,5,5,0.0,0.0
comandant,observatornews.ro,0,0,1,1,0.0,0.0
Daniel Apostol,www.euronews.ro,0,0,1,1,0.0,0.0
Daniel Zamfir,www.euronews.ro,0,0,1,1,0.0,0.0
Elveția,www.euronews.ro,0,0,2,2,0.0,0.0
Insulele Cayman,www.euronews.ro,0,0,1,1,0.0,0.0
Nicu Marcu,www.euronews.ro,0,0,1,1,0.0,0.0
asigurător,www.euronews.ro,0,1,1,2,-0.5,0.5
consumator,www.euronews.ro,1,0,1,2,0.5,0.5
Mohammad Murad,www.cotidianul.ro,0,0,2,2,0.0,0.0
Alexe,www.comisarul.ro,0,0,1,1,0.0,0.0
Bode,www.comisarul.ro,0,1,0,1,-1.0,1.0
Kremlin,www.comisarul.ro,0,2,0,2,-1.0,1.0
Pungești,www.comisarul.ro,0,1,0,1,-1.0,1.0
Păun,www.comisarul.ro,0,0,2,2,0.0,0.0
Geoană,www.comisarul.ro,0,0,1,1,0.0,0.0
voi,www.comisarul.ro,0,0,1,1,0.0,0.0
Dorina Barcari,agerpres.ro,0,0,1,1,0.0,0.0
Kondor Agota,agerpres.ro,0,0,3,3,0.0,0.0
Izvor,www.comisarul.ro,0,1,0,1,-1.0,1.0
Said,www.comisarul.ro,0,1,0,1,-1.0,1.0
Urziceni,www.comisarul.ro,0,1,0,1,-1.0,1.0
clan,www.comisarul.ro,0,1,0,1,-1.0,1.0
mort,www.comisarul.ro,0,2,3,5,-0.4,0.4
rănit,www.comisarul.ro,0,2,0,2,-1.0,1.0
Chișinău,www.activenews.ro,0,1,2,3,-0.3333333333333333,0.3333333333333333
Denise Rifai,www.activenews.ro,0,0,1,1,0.0,0.0
Karl Marx,www.activenews.ro,0,1,0,1,-1.0,1.0
Marx,www.activenews.ro,0,1,0,1,-1.0,1.0
Negrescu,www.activenews.ro,0,2,0,2,-1.0,1.0
Soroșista,www.activenews.ro,0,1,0,1,-1.0,1.0
URSS,www.activenews.ro,0,0,1,1,0.0,0.0
Victor Negrescu,www.activenews.ro,0,3,2,5,-0.6,0.6
Victoria,www.activenews.ro,0,1,0,1,-1.0,1.0
Victoriei Stoiciu,www.activenews.ro,0,1,0,1,-1.0,1.0
colegă,www.activenews.ro,0,1,1,2,-0.5,0.5
promotor,www.activenews.ro,1,2,0,3,-0.3333333333333333,0.3333333333333333
propagandist,www.activenews.ro,0,3,0,3,-1.0,1.0
inițiator,www.gandul.ro,1,0,1,2,0.5,0.5
secretar,www.cotidianul.ro,0,1,2,3,-0.3333333333333333,0.3333333333333333
secretar de stat,www.cotidianul.ro,0,0,1,1,0.0,0.0
dezvoltator,agerpres.ro,0,1,0,1,-1.0,1.0
Sorin Grindeanu,www.news.ro,1,0,7,8,0.125,0.125
Adriean Videanu,www.cotidianul.ro,0,1,0,1,-1.0,1.0
Ceaușescu,www.cotidianul.ro,0,1,0,1,-1.0,1.0
Miky Șpagă,www.cotidianul.ro,0,1,0,1,-1.0,1.0
Moscova,www.cotidianul.ro,0,2,0,2,-1.0,1.0
Remus Pricopie,www.cotidianul.ro,0,2,0,2,-1.0,1.0
S. Burduja,www.cotidianul.ro,0,1,0,1,-1.0,1.0
acoperiș,www.cotidianul.ro,0,1,0,1,-1.0,1.0
congener,www.cotidianul.ro,0,1,0,1,-1.0,1.0
doamnă,www.cotidianul.ro,0,1,2,3,-0.3333333333333333,0.3333333333333333
dușman,www.cotidianul.ro,0,2,0,2,-1.0,1.0
gureș,www.cotidianul.ro,0,1,0,1,-1.0,1.0
găgăuță,www.cotidianul.ro,0,1,0,1,-1.0,1.0
informat,www.cotidianul.ro,0,1,0,1,-1.0,1.0
nevastă,www.cotidianul.ro,0,1,0,1,-1.0,1.0
patriot,www.cotidianul.ro,2,1,0,3,0.3333333333333333,0.3333333333333333
propagandist,www.cotidianul.ro,0,2,0,2,-1.0,1.0
rector,www.cotidianul.ro,0,2,0,2,-1.0,1.0
rezervist,www.cotidianul.ro,0,1,0,1,-1.0,1.0
sforar,www.cotidianul.ro,0,1,0,1,-1.0,1.0
victimă,www.cotidianul.ro,0,1,0,1,-1.0,1.0
Cluj,www.news.ro,0,0,1,1,0.0,0.0
favorit,www.news.ro,0,1,0,1,-1.0,1.0
Aleșd,www.comisarul.ro,0,0,1,1,0.0,0.0
Beiuș,www.comisarul.ro,0,0,1,1,0.0,0.0
Bihor,www.comisarul.ro,0,0,3,3,0.0,0.0
bihorean,www.comisarul.ro,0,0,1,1,0.0,0.0
Birtin,www.comisarul.ro,0,0,1,1,0.0,0.0
Borș,www.comisarul.ro,0,1,0,1,-1.0,1.0
Băile Felix,www.comisarul.ro,0,0,1,1,0.0,0.0
Cornel Popa,www.comisarul.ro,0,0,1,1,0.0,0.0
Crișan,www.comisarul.ro,0,1,0,1,-1.0,1.0
Florentina,www.comisarul.ro,0,1,0,1,-1.0,1.0
Florin Birta,www.comisarul.ro,0,0,1,1,0.0,0.0
George Bologan,www.comisarul.ro,0,0,1,1,0.0,0.0
Gheorghe Brătianu,www.comisarul.ro,0,0,1,1,0.0,0.0
Graz,www.comisarul.ro,0,0,1,1,0.0,0.0
Ioan,www.comisarul.ro,0,0,1,1,0.0,0.0
Ioana,www.comisarul.ro,0,0,1,1,0.0,0.0
Marghita,www.comisarul.ro,0,0,1,1,0.0,0.0
Michael Bloomberg,www.comisarul.ro,0,0,1,1,0.0,0.0
New York,www.comisarul.ro,0,0,1,1,0.0,0.0
Octav Ganea,www.comisarul.ro,0,0,1,1,0.0,0.0
ordine,www.comisarul.ro,0,1,0,1,-1.0,1.0
Paul Lelea,www.comisarul.ro,0,0,1,1,0.0,0.0
România Mare,www.comisarul.ro,1,0,0,1,1.0,1.0
Sergiu Cunescu,www.comisarul.ro,0,0,1,1,0.0,0.0
Szilágyi Lóránd,www.comisarul.ro,0,0,1,1,0.0,0.0
Sânmartin,www.comisarul.ro,0,0,1,1,0.0,0.0
Tăriceanu,www.comisarul.ro,0,2,2,4,-0.5,0.5
Vadu Crișului,www.comisarul.ro,0,0,1,1,0.0,0.0
Viorel Micula,www.comisarul.ro,0,0,1,1,0.0,0.0
arhitectă,www.comisarul.ro,0,0,1,1,0.0,0.0
bihorenilor,www.comisarul.ro,0,1,0,1,-1.0,1.0
contestatar,www.comisarul.ro,0,2,1,3,-0.6666666666666666,0.6666666666666666
orădenie,www.comisarul.ro,0,1,0,1,-1.0,1.0
Călin Popescu-Tăriceanu,www.comisarul.ro,0,0,2,2,0.0,0.0
promotor,www.comisarul.ro,0,0,1,1,0.0,0.0
psiholog,www.comisarul.ro,0,0,1,1,0.0,0.0
sponsor,www.comisarul.ro,0,0,1,1,0.0,0.0
taximetrist,www.comisarul.ro,0,1,0,1,-1.0,1.0
Mircea Mălan,www.comisarul.ro,0,1,0,1,-1.0,1.0
Ștei,www.comisarul.ro,0,0,1,1,0.0,0.0
George Ganțu,www.cotidianul.ro,0,0,1,1,0.0,0.0
mehedințean,www.cotidianul.ro,1,0,0,1,1.0,1.0
elev,www.realitatea.net,0,0,1,1,0.0,0.0
român,www.realitatea.net,0,1,0,1,-1.0,1.0
țara noastră,www.realitatea.net,0,0,1,1,0.0,0.0
Cătălin Preodoiu,www.antena3.ro,0,0,1,1,0.0,0.0
Varujan Pambuccian,www.antena3.ro,0,0,3,3,0.0,0.0
procuror general,www.antena3.ro,0,0,1,1,0.0,0.0
tehnician,www.antena3.ro,0,0,2,2,0.0,0.0
Australia,www.mediafax.ro,0,0,2,2,0.0,0.0
Canberra,www.mediafax.ro,0,0,1,1,0.0,0.0
magnat,www.mediafax.ro,0,1,0,1,-1.0,1.0
Palmer,www.mediafax.ro,0,0,1,1,0.0,0.0
Dorel Vișan,www.gandul.ro,0,0,2,2,0.0,0.0
Doru Vișan,www.gandul.ro,0,0,1,1,0.0,0.0
maestru,www.gandul.ro,0,1,0,1,-1.0,1.0
Cozmin Gușă,www.gandul.ro,0,0,2,2,0.0,0.0
Anglia,www.b1tv.ro,0,0,1,1,0.0,0.0
Cluj,www.b1tv.ro,1,1,0,2,0.0,0.0
Friedrich Merz,www.b1tv.ro,0,1,0,1,-1.0,1.0
Macron,www.b1tv.ro,0,1,0,1,-1.0,1.0
Marele,www.b1tv.ro,0,1,0,1,-1.0,1.0
Papahagi,www.b1tv.ro,0,1,0,1,-1.0,1.0
Adrian Papahagi,www.b1tv.ro,1,0,0,1,1.0,1.0
Rubio,www.b1tv.ro,0,0,1,1,0.0,0.0
Sumî,www.b1tv.ro,0,1,1,2,-0.5,0.5
Uniunea,www.b1tv.ro,0,1,0,1,-1.0,1.0
ai,www.b1tv.ro,0,1,0,1,-1.0,1.0
apărător,www.b1tv.ro,0,1,0,1,-1.0,1.0
civil,www.b1tv.ro,0,1,1,2,-0.5,0.5
homosexual,www.b1tv.ro,0,1,0,1,-1.0,1.0
Keir Starmer,www.b1tv.ro,0,1,0,1,-1.0,1.0
Ăștia,www.b1tv.ro,0,1,0,1,-1.0,1.0
Radu Buzăianu,www.cotidianul.ro,0,0,1,1,0.0,0.0
Răzvan Zamfir,www.cotidianul.ro,0,0,1,1,0.0,0.0
Adriana,pressone.ro,0,1,1,2,-0.5,0.5
Andreea Blejnar,pressone.ro,0,0,1,1,0.0,0.0
asociație,pressone.ro,0,1,3,4,-0.25,0.25
Azuga,pressone.ro,0,0,1,1,0.0,0.0
Bernard Tapie,pressone.ro,0,2,0,2,-1.0,1.0
Blejnar,pressone.ro,0,1,1,2,-0.5,0.5
Bodo,pressone.ro,0,0,1,1,0.0,0.0
Borza,pressone.ro,0,0,1,1,0.0,0.0
Constantin Samson,pressone.ro,0,0,1,1,0.0,0.0
Diana Nemeș,pressone.ro,0,0,1,1,0.0,0.0
Ioana Băsescu,pressone.ro,0,0,1,1,0.0,0.0
Ioana Toma,pressone.ro,0,1,1,2,-0.5,0.5
Manolache,pressone.ro,0,0,1,1,0.0,0.0
Mariana Negoiță,pressone.ro,0,0,1,1,0.0,0.0
Marsilia,pressone.ro,0,0,1,1,0.0,0.0
Mircea Băsescu,pressone.ro,0,1,0,1,-1.0,1.0
Moravița,pressone.ro,0,0,1,1,0.0,0.0
Nași,pressone.ro,0,0,1,1,0.0,0.0
Nicolae Șerban,pressone.ro,0,0,1,1,0.0,0.0
Raul Giuglea,pressone.ro,0,0,1,1,0.0,0.0
S Blejnar,pressone.ro,0,1,0,1,-1.0,1.0
Samson,pressone.ro,0,0,1,1,0.0,0.0
Sorin Blejnar,pressone.ro,0,0,1,1,0.0,0.0
Tatiana Manolache,pressone.ro,0,0,1,1,0.0,0.0
Tatianei Manolache,pressone.ro,0,0,1,1,0.0,0.0
Toma,pressone.ro,0,0,2,2,0.0,0.0
Radu Pricop,pressone.ro,0,0,1,1,0.0,0.0
colegă avocat,pressone.ro,1,0,0,1,1.0,1.0
comercialist,pressone.ro,0,1,0,1,-1.0,1.0
contestatar,pressone.ro,0,1,1,2,-0.5,0.5
creditor,pressone.ro,0,0,1,1,0.0,0.0
cuiva,pressone.ro,0,3,0,3,-1.0,1.0
debutant,pressone.ro,0,1,0,1,-1.0,1.0
lichidator,pressone.ro,0,3,0,3,-1.0,1.0
practician,pressone.ro,0,1,4,5,-0.2,0.2
practicant,pressone.ro,0,0,2,2,0.0,0.0
Iacob Baciu,adevarul.ro,0,0,1,1,0.0,0.0
trăsător politic,adevarul.ro,0,1,0,1,-1.0,1.0
Ana Păun,agerpres.ro,0,0,1,1,0.0,0.0
Marius Humelnicu,agerpres.ro,0,0,1,1,0.0,0.0
magistrat,agerpres.ro,0,0,3,3,0.0,0.0
acuzator,pressone.ro,0,1,0,1,-1.0,1.0
minor,pressone.ro,0,1,2,3,-0.3333333333333333,0.3333333333333333
terț,pressone.ro,0,2,0,2,-1.0,1.0
încătușat,pressone.ro,0,1,0,1,-1.0,1.0
A,www.luju.ro,0,0,1,1,0.0,0.0
Bobi,www.luju.ro,0,0,3,3,0.0,0.0
Ioana Andreea Comănescu,www.luju.ro,0,0,1,1,0.0,0.0
Dragoș Achitei,www.luju.ro,0,1,0,1,-1.0,1.0
George Nicolae,www.luju.ro,0,0,1,1,0.0,0.0
Nicolae,www.luju.ro,0,0,1,1,0.0,0.0
Ioana Prajescu,www.luju.ro,0,0,1,1,0.0,0.0
Anghelina Olteanu,www.luju.ro,0,0,1,1,0.0,0.0
Constantin Adela,www.luju.ro,0,0,1,1,0.0,0.0
Georgiu Ramona Alina,www.luju.ro,0,0,1,1,0.0,0.0
Mihai Roman,www.luju.ro,0,0,1,1,0.0,0.0
Bogdan Mateescu,www.luju.ro,0,1,4,5,-0.2,0.2
Miodrag Belodedici,www.mediafax.ro,0,0,1,1,0.0,0.0
Oprescu,www.mediafax.ro,0,0,2,2,0.0,0.0
Violeta Alexandru,www.news.ro,0,0,1,1,0.0,0.0
Violetei Alexandru,www.news.ro,0,0,1,1,0.0,0.0
Vlad Voiculescu,www.news.ro,0,0,2,2,0.0,0.0
Diana Șoșoacă,www.gandul.ro,0,2,4,6,-0.3333333333333333,0.3333333333333333
Roman,www.gandul.ro,0,0,1,1,0.0,0.0
Mugur Mihăescu,www.digi24.ro,0,0,2,2,0.0,0.0
Neamț,www.digi24.ro,0,0,1,1,0.0,0.0
Olt,www.digi24.ro,0,0,1,1,0.0,0.0
Titus Păunescu,www.digi24.ro,0,0,1,1,0.0,0.0
Ringo Dămureanu,www.digi24.ro,0,0,1,1,0.0,0.0
Belgrad,primanews.ro,0,1,2,3,-0.3333333333333333,0.3333333333333333
Lasconi,primanews.ro,2,1,4,7,0.14285714285714285,0.14285714285714285
primar general,primanews.ro,0,1,0,1,-1.0,1.0
Roșia,primanews.ro,0,1,0,1,-1.0,1.0
Radu Mihaiu,observatornews.ro,0,0,1,1,0.0,0.0
Controceni,primanews.ro,0,0,1,1,0.0,0.0
Alba Iulia,www.romaniatv.net,0,0,3,3,0.0,0.0
Camelia Donțu,www.romaniatv.net,0,0,2,2,0.0,0.0
Cernăuți,www.romaniatv.net,0,0,1,1,0.0,0.0
Georgia Meloni,www.romaniatv.net,0,0,1,1,0.0,0.0
Mircea Malița,www.romaniatv.net,1,0,0,1,1.0,1.0
Pechea,www.romaniatv.net,0,1,0,1,-1.0,1.0
Mihai Mălaimare,www.romaniatv.net,0,0,1,1,0.0,0.0
admirator,www.romaniatv.net,1,1,0,2,0.0,0.0
angajator,www.romaniatv.net,0,0,7,7,0.0,0.0
conducător,www.romaniatv.net,0,2,1,3,-0.6666666666666666,0.6666666666666666
critic,www.romaniatv.net,0,3,0,3,-1.0,1.0
disident,www.romaniatv.net,0,1,0,1,-1.0,1.0
jurnalistă,www.romaniatv.net,0,0,1,1,0.0,0.0
Virgil Popescu,www.romaniatv.net,0,1,0,1,-1.0,1.0
maestru,www.romaniatv.net,1,0,0,1,1.0,1.0
maeștră,www.romaniatv.net,1,0,0,1,1.0,1.0
mareșal,www.romaniatv.net,0,1,0,1,-1.0,1.0
mareșal Antonescu,www.romaniatv.net,0,0,1,1,0.0,0.0
medic,www.romaniatv.net,0,3,3,6,-0.5,0.5
militar,www.romaniatv.net,0,0,4,4,0.0,0.0
opozant,www.romaniatv.net,0,1,0,1,-1.0,1.0
profesor,www.romaniatv.net,0,0,3,3,0.0,0.0
Șoșoacă,www.news.ro,0,0,2,2,0.0,0.0
Blonda,www.romaniatv.net,0,0,1,1,0.0,0.0
Bulgaria,www.romaniatv.net,0,1,4,5,-0.2,0.2
Costa Rica,www.romaniatv.net,0,0,2,2,0.0,0.0
Elena Udrea,www.romaniatv.net,0,0,1,1,0.0,0.0
petentă,www.romaniatv.net,0,1,0,1,-1.0,1.0
Cehia,www.gandul.ro,0,0,2,2,0.0,0.0
Lloyd Austin,www.gandul.ro,0,0,1,1,0.0,0.0
Luminița Odobescu,www.gandul.ro,0,0,2,2,0.0,0.0
Rob Bauer,www.gandul.ro,0,0,1,1,0.0,0.0
amiral,www.gandul.ro,0,0,1,1,0.0,0.0
Petr Pavel,www.gandul.ro,0,0,1,1,0.0,0.0
Ilfov,observatornews.ro,0,0,1,1,0.0,0.0
Marius Budăi,observatornews.ro,0,2,1,3,-0.6666666666666666,0.6666666666666666
sector,observatornews.ro,0,0,1,1,0.0,0.0
voluntar,observatornews.ro,0,0,3,3,0.0,0.0
aceasta,observatornews.ro,0,0,1,1,0.0,0.0
decident,observatornews.ro,0,1,1,2,-0.5,0.5
ministrul,observatornews.ro,0,0,1,1,0.0,0.0
Calan,a1.ro,0,2,0,2,-1.0,1.0
Daniel Raducanu,a1.ro,0,0,2,2,0.0,0.0
Monica Macovei,a1.ro,0,1,0,1,-1.0,1.0
Raducanu,a1.ro,0,0,2,2,0.0,0.0
Ridzi,a1.ro,0,1,0,1,-1.0,1.0
Romi Carmazan,a1.ro,0,2,0,2,-1.0,1.0
comisar-șef,a1.ro,0,2,0,2,-1.0,1.0
amândoi,www.antena3.ro,0,0,3,3,0.0,0.0
bucureștean,www.antena3.ro,0,0,1,1,0.0,0.0
Tunari,www.luju.ro,0,0,5,5,0.0,0.0
concetățeni,www.luju.ro,1,0,0,1,1.0,1.0
mei,www.luju.ro,1,0,0,1,1.0,1.0
moderatoare,www.romaniatv.net,0,1,0,1,-1.0,1.0
producător,www.romaniatv.net,0,0,1,1,0.0,0.0
străin,www.romaniatv.net,0,1,0,1,-1.0,1.0
trădător,www.romaniatv.net,0,1,0,1,-1.0,1.0
Berevoianu,a1.ro,0,1,0,1,-1.0,1.0
Ciprian Berevoianu,a1.ro,0,2,0,2,-1.0,1.0
Ialomitianu,a1.ro,0,1,0,1,-1.0,1.0
prefect,a1.ro,0,2,2,4,-0.5,0.5
Rareș Petru Stan,www.comisarul.ro,0,1,0,1,-1.0,1.0
Fechet,adevarul.ro,0,0,1,1,0.0,0.0
Mircea Fechet,adevarul.ro,0,0,1,1,0.0,0.0
Florin Zamfirescu,adevarul.ro,0,0,2,2,0.0,0.0
Zamfirescu,adevarul.ro,0,0,1,1,0.0,0.0
publisher,www.g4media.ro,0,1,0,1,-1.0,1.0
Răzvan Ionescu,www.g4media.ro,0,0,1,1,0.0,0.0
vârstnic,www.g4media.ro,0,0,3,3,0.0,0.0
Horațiu Potra,www.digi24.ro,0,2,2,4,-0.5,0.5
Moscova,www.digi24.ro,0,3,1,4,-0.75,0.75
bodyguard,www.digi24.ro,0,1,1,2,-0.5,0.5
mercenar,www.digi24.ro,0,4,0,4,-1.0,1.0
Mark Rutte,www.comisarul.ro,0,0,1,1,0.0,0.0
Rutte,www.comisarul.ro,0,1,1,2,-0.5,0.5
Sir Grant,www.comisarul.ro,0,1,0,1,-1.0,1.0
Grant Shapps,www.comisarul.ro,0,0,1,1,0.0,0.0
Dragoș Pâslaru,www.euronews.ro,0,0,1,1,0.0,0.0
Dragoș Pîslaru,www.euronews.ro,0,0,3,3,0.0,0.0
Vitalie Cojocari,www.euronews.ro,0,0,1,1,0.0,0.0
Nicu Ștefănuță,www.euronews.ro,0,0,3,3,0.0,0.0
Roxana Mînzatu,www.euronews.ro,0,0,3,3,0.0,0.0
Tana Foarfă,www.euronews.ro,0,0,1,1,0.0,0.0
Violeta Alexandru,www.euronews.ro,0,0,3,3,0.0,0.0
director,www.euronews.ro,0,3,10,13,-0.23076923076923078,0.23076923076923078
absolvent,observatornews.ro,0,0,2,2,0.0,0.0
Bobota,observatornews.ro,0,0,1,1,0.0,0.0
Coposu,observatornews.ro,0,0,1,1,0.0,0.0
Corneliu Copos,observatornews.ro,0,0,1,1,0.0,0.0
Corneliu Coposu,observatornews.ro,0,0,1,1,0.0,0.0
Ionuț Gherasim,observatornews.ro,0,0,1,1,0.0,0.0
Iuliu Maniu,observatornews.ro,0,0,1,1,0.0,0.0
senior,observatornews.ro,0,0,1,1,0.0,0.0
Sălaj,observatornews.ro,0,0,1,1,0.0,0.0
ziarist,observatornews.ro,0,0,1,1,0.0,0.0
Micutzu,www.euronews.ro,0,1,2,3,-0.3333333333333333,0.3333333333333333
bucureștean,www.euronews.ro,2,0,1,3,0.6666666666666666,0.6666666666666666
comediant,www.euronews.ro,0,0,1,1,0.0,0.0
Andrei Roman,adevarul.ro,0,0,1,1,0.0,0.0
dvs,www.news.ro,0,0,1,1,0.0,0.0
Cristi Danițeț,adevarul.ro,0,0,1,1,0.0,0.0
,www.b1tv.ro,0,3,2,5,-0.6,0.6
Daniel Funeriu,www.b1tv.ro,0,0,3,3,0.0,0.0
Lavinia Șandru,www.b1tv.ro,0,0,1,1,0.0,0.0
Eduard Vînătoru,recorder.ro,0,0,1,1,0.0,0.0
Traian Băsescu,primanews.ro,0,1,1,2,-0.5,0.5
nimănui,www.antena3.ro,0,1,0,1,-1.0,1.0
Benjamin Franklin,www.gandul.ro,0,0,1,1,0.0,0.0
Bodog,www.gandul.ro,0,1,0,1,-1.0,1.0
Carmen Dan,www.gandul.ro,0,1,1,2,-0.5,0.5
Daea,www.gandul.ro,0,0,1,1,0.0,0.0
Florian Bodog,www.gandul.ro,0,1,0,1,-1.0,1.0
Jean-Claude Juncker,www.gandul.ro,0,0,1,1,0.0,0.0
Petre Daea,www.gandul.ro,0,0,2,2,0.0,0.0
Pop,www.gandul.ro,0,1,0,1,-1.0,1.0
Târgoviște,www.gandul.ro,1,0,0,1,1.0,1.0
Vosganian,www.gandul.ro,0,1,0,1,-1.0,1.0
militant,www.mediafax.ro,0,1,1,2,-0.5,0.5
Cambogia,recorder.ro,0,0,1,1,0.0,0.0
China,recorder.ro,0,5,3,8,-0.625,0.625
Crin Antonescu,recorder.ro,1,3,10,14,-0.14285714285714285,0.14285714285714285
Dragoș Sprânceană,recorder.ro,0,0,2,2,0.0,0.0
Georgia Meloni,recorder.ro,0,0,1,1,0.0,0.0
Vietnam,recorder.ro,0,0,1,1,0.0,0.0
sponsor,recorder.ro,0,1,0,1,-1.0,1.0
Bangladesh,recorder.ro,0,0,1,1,0.0,0.0
Cristina Dumitrescu,recorder.ro,0,0,1,1,0.0,0.0
Pakistan,recorder.ro,0,0,1,1,0.0,0.0
Rector,recorder.ro,0,1,0,1,-1.0,1.0
Silvestru Șoșoacă,recorder.ro,0,2,0,2,-1.0,1.0
Vali Mitruș,recorder.ro,0,1,0,1,-1.0,1.0
Rareș Stan,recorder.ro,0,1,0,1,-1.0,1.0
Florin Negruțiu,www.digi24.ro,0,0,4,4,0.0,0.0
Adrian Cozma,www.cotidianul.ro,0,1,4,5,-0.2,0.2
Cozma,www.cotidianul.ro,0,2,1,3,-0.6666666666666666,0.6666666666666666
domn,www.cotidianul.ro,0,2,1,3,-0.6666666666666666,0.6666666666666666
Grindeanu,www.cotidianul.ro,0,2,2,4,-0.5,0.5
Sorin Grindeanu,www.cotidianul.ro,0,0,2,2,0.0,0.0
Vicepreședintele,www.cotidianul.ro,0,1,0,1,-1.0,1.0
broker,www.cotidianul.ro,0,1,0,1,-1.0,1.0
predecesor,www.cotidianul.ro,0,0,1,1,0.0,0.0
Budapesta,www.romaniatv.net,0,0,1,1,0.0,0.0
Dortmund,www.romaniatv.net,0,1,1,2,-0.5,0.5
Gelu Duminică,www.romaniatv.net,0,0,1,1,0.0,0.0
Gigel Stirbu,www.aktual24.ro,0,0,2,2,0.0,0.0
greblă,www.aktual24.ro,0,0,1,1,0.0,0.0
Olt,www.aktual24.ro,0,0,1,1,0.0,0.0
Scornicesti,www.aktual24.ro,0,0,1,1,0.0,0.0
Stirbu,www.aktual24.ro,0,1,0,1,-1.0,1.0
Toni Grebla,www.aktual24.ro,0,0,1,1,0.0,0.0
liberal,www.aktual24.ro,0,2,2,4,-0.5,0.5
contracandidat,www.mediafax.ro,0,3,1,4,-0.75,0.75
frate,www.mediafax.ro,0,1,0,1,-1.0,1.0
paparazzi,www.mediafax.ro,0,1,0,1,-1.0,1.0
Iran,primanews.ro,0,1,0,1,-1.0,1.0
Israel Katz,primanews.ro,0,0,1,1,0.0,0.0
Teheran,primanews.ro,0,1,0,1,-1.0,1.0
Tel Aviv,primanews.ro,0,1,0,1,-1.0,1.0
Yemen,primanews.ro,0,1,0,1,-1.0,1.0
Diana Sosoaca,www.luju.ro,0,3,2,5,-0.6,0.6
Sosoaca,www.luju.ro,0,3,2,5,-0.6,0.6
Corneliu Tudor,recorder.ro,0,1,0,1,-1.0,1.0
Mihai,recorder.ro,1,0,1,2,0.5,0.5
gospodină,recorder.ro,0,1,0,1,-1.0,1.0
mulțime,recorder.ro,0,2,0,2,-1.0,1.0
strigoi,recorder.ro,0,1,0,1,-1.0,1.0
urmaș,recorder.ro,0,1,0,1,-1.0,1.0
bătrân,www.antena3.ro,0,1,0,1,-1.0,1.0
Mircea Toader,stirileprotv.ro,0,0,1,1,0.0,0.0
Nicolaescu,stirileprotv.ro,0,1,1,2,-0.5,0.5
rege,stirileprotv.ro,0,0,2,2,0.0,0.0
regele,stirileprotv.ro,0,0,1,1,0.0,0.0
Regele Mihai,stirileprotv.ro,0,0,1,1,0.0,0.0
Regele,stirileprotv.ro,0,0,1,1,0.0,0.0
Mihai,stirileprotv.ro,0,0,1,1,0.0,0.0
Toader,stirileprotv.ro,0,0,2,2,0.0,0.0
vice-lider,stirileprotv.ro,0,1,0,1,-1.0,1.0
asistent,stirileprotv.ro,0,0,2,2,0.0,0.0
dușman,stirileprotv.ro,0,1,0,1,-1.0,1.0
Baluta,www.aktual24.ro,0,0,4,4,0.0,0.0
Daniel Baluta,www.aktual24.ro,0,0,9,9,0.0,0.0
Florin Jianu,www.aktual24.ro,0,0,2,2,0.0,0.0
Gheorghe Soldan,www.aktual24.ro,0,0,3,3,0.0,0.0
Rares Hopinca,www.aktual24.ro,0,0,2,2,0.0,0.0
Alexander Dughin,www.romaniatv.net,0,0,1,1,0.0,0.0
Dan Tanasă,www.romaniatv.net,0,0,1,1,0.0,0.0
Tanasă,www.romaniatv.net,0,0,1,1,0.0,0.0
fan,www.romaniatv.net,0,0,1,1,0.0,0.0
Pricopie,observatornews.ro,0,0,1,1,0.0,0.0
Remus Pricopie,observatornews.ro,0,0,2,2,0.0,0.0
rector,observatornews.ro,0,0,2,2,0.0,0.0
Ionaș,adevarul.ro,0,0,2,2,0.0,0.0
Ionas Vladimir,adevarul.ro,0,0,1,1,0.0,0.0
Lui Georgescu,www.g4media.ro,0,0,1,1,0.0,0.0
aliat,www.g4media.ro,1,2,1,4,-0.25,0.25
rival,www.g4media.ro,0,1,0,1,-1.0,1.0
Alina Gorghiu,www.luju.ro,0,2,4,6,-0.3333333333333333,0.3333333333333333
Andreei Uzlau,www.luju.ro,0,0,1,1,0.0,0.0
Cristina Irimia,www.luju.ro,0,1,2,3,-0.3333333333333333,0.3333333333333333
Irimia,www.luju.ro,0,2,1,3,-0.6666666666666666,0.6666666666666666
Liana Arsenie,www.luju.ro,0,0,1,1,0.0,0.0
Mara,www.luju.ro,0,0,1,1,0.0,0.0
Toader,www.luju.ro,0,0,1,1,0.0,0.0
Tudorel,www.luju.ro,0,1,0,1,-1.0,1.0
Uzlau,www.luju.ro,0,2,0,2,-1.0,1.0
Uzlau - Irimia,www.luju.ro,0,0,1,1,0.0,0.0
Lia Savonea,www.luju.ro,0,0,2,2,0.0,0.0
Dan Lupascu,www.luju.ro,0,0,2,2,0.0,0.0
ministrul Justiției,www.luju.ro,0,1,0,1,-1.0,1.0
procuroare,www.luju.ro,0,2,1,3,-0.6666666666666666,0.6666666666666666
regină,www.luju.ro,1,1,0,2,0.0,0.0
Armand Călinescu,adevarul.ro,0,0,1,1,0.0,0.0
Corneliu Zelea Codreanu,adevarul.ro,0,1,0,1,-1.0,1.0
Nicolae Iorga,adevarul.ro,1,0,1,2,0.5,0.5
erou,adevarul.ro,2,1,0,3,0.3333333333333333,0.3333333333333333
Ion Antonescu,adevarul.ro,0,1,0,1,-1.0,1.0
premiu,adevarul.ro,0,0,2,2,0.0,0.0
Aleksandar Miladinovic,www.euronews.ro,0,0,1,1,0.0,0.0
corespondent,www.euronews.ro,0,0,1,1,0.0,0.0
analișt,www.euronews.ro,0,2,0,2,-1.0,1.0
copil,www.euronews.ro,1,5,3,9,-0.4444444444444444,0.4444444444444444
nepot,www.euronews.ro,0,0,1,1,0.0,0.0
popor,www.euronews.ro,3,1,1,5,0.4,0.4
prieten,www.euronews.ro,1,0,0,1,1.0,1.0
vecin,www.euronews.ro,2,0,0,2,1.0,1.0
cofondator,www.digi24.ro,0,1,0,1,-1.0,1.0
Carmen Hărău,pressone.ro,0,0,1,1,0.0,0.0
Cătălin Cherecheș,pressone.ro,0,0,2,2,0.0,0.0
Damian Florea,pressone.ro,0,0,1,1,0.0,0.0
dator,pressone.ro,0,1,0,1,-1.0,1.0
Mihai Botez,pressone.ro,0,2,0,2,-1.0,1.0
Eforie,pressone.ro,0,0,1,1,0.0,0.0
Heiuș,pressone.ro,0,0,1,1,0.0,0.0
Lucian Heiuș,pressone.ro,0,0,1,1,0.0,0.0
Orăștie,pressone.ro,0,0,1,1,0.0,0.0
Ovidiu Brăiloiu,pressone.ro,0,0,1,1,0.0,0.0
Siminica Mirea,pressone.ro,0,0,2,2,0.0,0.0
Viorica Cherecheș,pressone.ro,0,0,2,2,0.0,0.0
Andreea Marin,www.b1tv.ro,0,0,1,1,0.0,0.0
mamă,www.b1tv.ro,0,1,0,1,-1.0,1.0
vedet,www.b1tv.ro,0,0,2,2,0.0,0.0
Stelian Ion,www.mediafax.ro,0,0,1,1,0.0,0.0
Craiova,www.antena3.ro,0,0,2,2,0.0,0.0
cadavru,www.realitatea.net,0,1,0,1,-1.0,1.0
ființă,www.realitatea.net,1,0,0,1,1.0,1.0
Gigel Știrbu,www.mediafax.ro,0,0,1,1,0.0,0.0
Cernea,a1.ro,0,0,1,1,0.0,0.0
Daniela Popa,a1.ro,0,0,1,1,0.0,0.0
Dumitru Sechelariu,a1.ro,0,1,0,1,-1.0,1.0
Iulian Ivan,a1.ro,0,0,1,1,0.0,0.0
Ivan,a1.ro,0,0,1,1,0.0,0.0
Liliana Minca,a1.ro,0,0,1,1,0.0,0.0
Rutte,www.gandul.ro,0,1,0,1,-1.0,1.0
Valentin Stan,www.gandul.ro,0,0,1,1,0.0,0.0
Coșa,pressone.ro,0,0,1,1,0.0,0.0
Eduard Popică,pressone.ro,0,0,1,1,0.0,0.0
Maricica Coșa,pressone.ro,1,0,0,1,1.0,1.0
Mihai Mohaci,pressone.ro,0,0,1,1,0.0,0.0
Mirela Adomnicăi,pressone.ro,0,0,1,1,0.0,0.0
Mohaci,pressone.ro,0,0,1,1,0.0,0.0
Nicușor Halici,pressone.ro,0,0,1,1,0.0,0.0
Ovidiu Sitterli,pressone.ro,0,0,1,1,0.0,0.0
Rodica Paraschiv,pressone.ro,0,0,1,1,0.0,0.0
Toma Petcu,pressone.ro,0,0,1,1,0.0,0.0
Tudorița Lungu,pressone.ro,0,0,1,1,0.0,0.0
Vasile Ilea,pressone.ro,0,0,1,1,0.0,0.0
ocupant,pressone.ro,0,1,0,1,-1.0,1.0
Corina Crețu,stirileprotv.ro,0,0,1,1,0.0,0.0
eurodeputat,stirileprotv.ro,0,1,1,2,-0.5,0.5
handicap,stirileprotv.ro,0,0,1,1,0.0,0.0
martor,stirileprotv.ro,0,1,1,2,-0.5,0.5
vârstnic,stirileprotv.ro,0,1,0,1,-1.0,1.0
Cristian Terheș,www.aktual24.ro,1,0,1,2,0.5,0.5
Daniel Funeriu,www.aktual24.ro,0,0,4,4,0.0,0.0
John Ion Banu,www.aktual24.ro,0,0,1,1,0.0,0.0
Sebastian Popescu,www.aktual24.ro,0,0,1,1,0.0,0.0
Silviu Predoiu,www.aktual24.ro,0,0,1,1,0.0,0.0
băiat,www.realitatea.net,0,2,2,4,-0.5,0.5
Viorel Hrebenciuc,www.romaniatv.net,0,0,1,1,0.0,0.0
Crin,www.b1tv.ro,0,0,1,1,0.0,0.0
Dominic Fritz,www.b1tv.ro,0,1,6,7,-0.14285714285714285,0.14285714285714285
altuia,www.b1tv.ro,0,1,0,1,-1.0,1.0
dansă,www.b1tv.ro,0,1,0,1,-1.0,1.0
terț,www.b1tv.ro,0,0,1,1,0.0,0.0
Remus Ștefureac,www.g4media.ro,0,0,1,1,0.0,0.0
Jack Posobiec,www.g4media.ro,0,0,1,1,0.0,0.0
Ștefureac,www.g4media.ro,0,0,1,1,0.0,0.0
Iulian Iancu,pressone.ro,0,0,3,3,0.0,0.0
Ovidiu Iane,pressone.ro,0,0,1,1,0.0,0.0
Iancu,pressone.ro,0,1,2,3,-0.3333333333333333,0.3333333333333333
Laura Ștefan,pressone.ro,0,0,1,1,0.0,0.0
penal,pressone.ro,0,1,0,1,-1.0,1.0
Alin Popoviciu,pressone.ro,0,0,1,1,0.0,0.0
Angel Tîlvăr,pressone.ro,0,0,1,1,0.0,0.0
Bogdan Stan,pressone.ro,0,1,0,1,-1.0,1.0
Cezar Preda,pressone.ro,0,0,1,1,0.0,0.0
Ciobanu,pressone.ro,0,1,0,1,-1.0,1.0
Claudia Boghicevici,pressone.ro,0,0,1,1,0.0,0.0
Daniel Barbu,pressone.ro,0,0,2,2,0.0,0.0
Eugen Orlando Teodorovici,pressone.ro,0,1,0,1,-1.0,1.0
George Maior,pressone.ro,1,1,2,4,0.0,0.0
Georgian Pop,pressone.ro,0,0,7,7,0.0,0.0
Ioan Bălan,pressone.ro,0,0,1,1,0.0,0.0
Ionuț Stroe,pressone.ro,0,0,2,2,0.0,0.0
Iulian Fota,pressone.ro,0,0,2,2,0.0,0.0
Ninel Peia,pressone.ro,0,2,3,5,-0.4,0.4
Octavian Marius Popa,pressone.ro,0,0,1,1,0.0,0.0
Ramona Mănescu,pressone.ro,0,0,4,4,0.0,0.0
Sergiu Nicolae Ciobanu,pressone.ro,0,1,0,1,-1.0,1.0
Sorin Câmpeanu,pressone.ro,0,0,1,1,0.0,0.0
Teodorovici,pressone.ro,0,2,0,2,-1.0,1.0
Victor,pressone.ro,0,0,1,1,0.0,0.0
Victor Matei,pressone.ro,0,0,1,1,0.0,0.0
ambasador,pressone.ro,1,1,6,8,0.0,0.0
cadru,pressone.ro,0,4,2,6,-0.6666666666666666,0.6666666666666666
doctorand,pressone.ro,1,4,10,15,-0.2,0.2
Orlando Teodorovici,pressone.ro,0,0,1,1,0.0,0.0
lăcătuș mecanic,pressone.ro,0,0,1,1,0.0,0.0
tehnician,pressone.ro,1,0,1,2,0.5,0.5
Adjud,recorder.ro,0,1,0,1,-1.0,1.0
Andreiașu de Jos,recorder.ro,0,0,1,1,0.0,0.0
Ashlee Vance,recorder.ro,0,0,1,1,0.0,0.0
Carolyn Gregoire,recorder.ro,0,0,1,1,0.0,0.0
Elena Stoica,recorder.ro,0,0,1,1,0.0,0.0
Ion Ștefan,recorder.ro,0,0,2,2,0.0,0.0
Ionel Dancă,recorder.ro,0,0,1,1,0.0,0.0
Lepșa,recorder.ro,0,0,1,1,0.0,0.0
Livezile,recorder.ro,0,0,1,1,0.0,0.0
Liviu Mălureanu,recorder.ro,0,0,1,1,0.0,0.0
Liviu Rebreanu,recorder.ro,0,0,1,1,0.0,0.0
Mircea Nausica,recorder.ro,0,0,1,1,0.0,0.0
Nausica Mircea,recorder.ro,0,0,1,1,0.0,0.0
Petre Andrei,recorder.ro,0,0,4,4,0.0,0.0
Păulești,recorder.ro,0,0,1,1,0.0,0.0
Raluca Ioan,recorder.ro,0,0,1,1,0.0,0.0
Scott Barry Kaufman,recorder.ro,0,0,1,1,0.0,0.0
Angel Tîlvăr,recorder.ro,0,0,1,1,0.0,0.0
Soveja,recorder.ro,0,0,1,1,0.0,0.0
Svetlana Aleksievici,recorder.ro,0,0,2,2,0.0,0.0
Tulnici,recorder.ro,0,0,1,1,0.0,0.0
Vintileasca,recorder.ro,0,0,1,1,0.0,0.0
Vizantea,recorder.ro,0,0,1,1,0.0,0.0
Vrancei,recorder.ro,1,0,0,1,1.0,1.0
vânător,recorder.ro,0,0,1,1,0.0,0.0
creatoare,recorder.ro,0,0,1,1,0.0,0.0
handicap,recorder.ro,1,0,0,1,1.0,1.0
mamelă,recorder.ro,1,0,1,2,0.5,0.5
Raluca Gabriela Ioan,recorder.ro,0,0,1,1,0.0,0.0
salariat,recorder.ro,1,1,3,5,0.0,0.0
semen,recorder.ro,1,0,0,1,1.0,1.0
vrâncen,recorder.ro,1,0,0,1,1.0,1.0
Budapestei,www.activenews.ro,1,0,0,1,1.0,1.0
Crimeea,www.activenews.ro,0,0,1,1,0.0,0.0
Dmitro Kuleba,www.activenews.ro,0,0,2,2,0.0,0.0
Federația Rusă,www.activenews.ro,0,0,1,1,0.0,0.0
Hanna Novosad,www.activenews.ro,0,0,1,1,0.0,0.0
Tiberiu Tudor,www.activenews.ro,0,1,1,2,-0.5,0.5
Viktor Ianukovici,www.activenews.ro,0,1,0,1,-1.0,1.0
Volodimir Zelenski,www.activenews.ro,0,1,0,1,-1.0,1.0
alț,www.activenews.ro,0,0,1,1,0.0,0.0
Petro Poroșenko,www.activenews.ro,0,1,1,2,-0.5,0.5
refugiat,www.activenews.ro,0,1,0,1,-1.0,1.0
Gigel Paraschiv,www.activenews.ro,0,1,1,2,-0.5,0.5
Jens Stoltenberg,www.activenews.ro,0,0,1,1,0.0,0.0
Kiev,www.activenews.ro,0,3,0,3,-1.0,1.0
Lugoj,www.activenews.ro,0,0,1,1,0.0,0.0
Sighetu Marmației,www.activenews.ro,0,0,1,1,0.0,0.0
Suceava,www.activenews.ro,0,0,1,1,0.0,0.0
Ucraina de Vest,www.activenews.ro,0,1,0,1,-1.0,1.0
Ungaria,www.activenews.ro,0,3,0,3,-1.0,1.0
Ungarie,www.activenews.ro,0,1,1,2,-0.5,0.5
uniune,www.activenews.ro,0,1,0,1,-1.0,1.0
Viorel Patrichi,www.activenews.ro,2,0,0,2,1.0,1.0
dansator,www.activenews.ro,0,0,1,1,0.0,0.0
ucrainean,www.activenews.ro,0,1,0,1,-1.0,1.0
Angelica Fădor,pressone.ro,0,0,1,1,0.0,0.0
Chițac,pressone.ro,0,0,1,1,0.0,0.0
fădor,pressone.ro,0,0,1,1,0.0,0.0
grangur,pressone.ro,0,1,0,1,-1.0,1.0
Făgăraș,a1.ro,1,0,1,2,0.5,0.5
Primar General,a1.ro,0,0,2,2,0.0,0.0
Bacău,www.antena3.ro,0,0,4,4,0.0,0.0
Negrescu,stirileprotv.ro,0,0,1,1,0.0,0.0
Bulgaria,www.digi24.ro,0,1,3,4,-0.25,0.25
Andrei Filip Ciolacu,a1.ro,0,0,5,5,0.0,0.0
Oana Lasconi,a1.ro,0,0,6,6,0.0,0.0
votant,a1.ro,0,1,2,3,-0.3333333333333333,0.3333333333333333
însoțitor,a1.ro,0,0,3,3,0.0,0.0
Ștefan,a1.ro,0,0,2,2,0.0,0.0
Ștefăniță Ciucă,a1.ro,0,0,5,5,0.0,0.0
Boros Orsolya Eva,www.aktual24.ro,0,0,1,1,0.0,0.0
Daniela Barsan,www.aktual24.ro,0,0,2,2,0.0,0.0
Georgica Severin,www.aktual24.ro,0,0,1,1,0.0,0.0
Lucian Dindirica,www.aktual24.ro,0,0,1,1,0.0,0.0
Narcisa Manciu,www.aktual24.ro,0,0,1,1,0.0,0.0
Monica Gubernat,www.aktual24.ro,0,0,1,1,0.0,0.0
Oana Dinca,www.aktual24.ro,0,0,1,1,0.0,0.0
Oana Dinca Simona,www.aktual24.ro,0,0,1,1,0.0,0.0
Mateescu,www.luju.ro,0,0,2,2,0.0,0.0
creditor,www.antena3.ro,0,1,0,1,-1.0,1.0
Australia,www.comisarul.ro,0,0,3,3,0.0,0.0
Columbia,www.comisarul.ro,0,0,1,1,0.0,0.0
Irlanda,www.comisarul.ro,0,0,2,2,0.0,0.0
Islanda,www.comisarul.ro,0,0,1,1,0.0,0.0
Japonia,www.comisarul.ro,0,0,2,2,0.0,0.0
Norvegia,www.comisarul.ro,0,0,2,2,0.0,0.0
Noua Zeelandă,www.comisarul.ro,0,0,2,2,0.0,0.0
Peru,www.comisarul.ro,0,0,1,1,0.0,0.0
Stănescu,adevarul.ro,0,0,1,1,0.0,0.0
Ardud,recorder.ro,0,0,1,1,0.0,0.0
Mihai Găman,recorder.ro,0,0,1,1,0.0,0.0
Carei,recorder.ro,0,0,1,1,0.0,0.0
Dorolț,recorder.ro,0,0,1,1,0.0,0.0
Felician Pop,recorder.ro,0,0,1,1,0.0,0.0
Letonia,recorder.ro,0,1,1,2,-0.5,0.5
mare,recorder.ro,0,0,1,1,0.0,0.0
Margaret Mitchell,recorder.ro,0,0,1,1,0.0,0.0
Nagy Szabolcs,recorder.ro,0,0,1,1,0.0,0.0
Noam Chomsky,recorder.ro,0,0,1,1,0.0,0.0
Octavian Petric,recorder.ro,0,0,1,1,0.0,0.0
Ovidiu Marius Duma,recorder.ro,0,0,1,1,0.0,0.0
Radu Mihai Cristescu,recorder.ro,0,1,0,1,-1.0,1.0
Sfântu Gheorghe,recorder.ro,0,0,4,4,0.0,0.0
Turos Lorand,recorder.ro,0,0,1,1,0.0,0.0
băieți,recorder.ro,0,0,1,1,0.0,0.0
homosexual,recorder.ro,0,2,0,2,-1.0,1.0
individ,recorder.ro,0,5,0,5,-1.0,1.0
Țara Oașului,recorder.ro,1,0,0,1,1.0,1.0
Cristian Citre,recorder.ro,0,0,1,1,0.0,0.0
Cristina-Ionela Tarteata,www.aktual24.ro,0,2,0,2,-1.0,1.0
Cristina Tarteata,www.aktual24.ro,0,3,2,5,-0.6,0.6
Dahwa Youssef,www.aktual24.ro,0,0,2,2,0.0,0.0
Irak,www.aktual24.ro,0,2,0,2,-1.0,1.0
Partenera,www.aktual24.ro,0,2,0,2,-1.0,1.0
Said Samer Ahmed,www.aktual24.ro,0,2,0,2,-1.0,1.0
Tarteata,www.aktual24.ro,0,2,0,2,-1.0,1.0
Teodor Melescanu,www.aktual24.ro,0,0,2,2,0.0,0.0
Timișoara,www.aktual24.ro,0,0,2,2,0.0,0.0
Yasser Shehan,www.aktual24.ro,0,2,0,2,-1.0,1.0
administrator,www.aktual24.ro,0,0,3,3,0.0,0.0
altcineva,www.romaniatv.net,0,0,1,1,0.0,0.0
pilot,www.comisarul.ro,0,1,2,3,-0.3333333333333333,0.3333333333333333
șmecher,www.comisarul.ro,0,1,0,1,-1.0,1.0
Daniel Fenchiu,www.digi24.ro,0,0,1,1,0.0,0.0
Daniel Fenechiu,www.digi24.ro,0,0,6,6,0.0,0.0
Fenechiu,www.digi24.ro,0,1,1,2,-0.5,0.5
Haralambie Voichițoiu,www.digi24.ro,0,0,1,1,0.0,0.0
aleș,www.digi24.ro,0,2,3,5,-0.4,0.4
Anamaria Gavrila,www.antena3.ro,0,0,1,1,0.0,0.0
Constantin Titian Filip,www.antena3.ro,0,0,1,1,0.0,0.0
Constantin Vieriu,www.antena3.ro,0,0,1,1,0.0,0.0
Daniel Funeriu,www.antena3.ro,0,0,2,2,0.0,0.0
Gelu Drăgan,www.antena3.ro,0,0,1,1,0.0,0.0
Ion Popa,www.antena3.ro,0,0,1,1,0.0,0.0
Maria Marcu,www.antena3.ro,0,0,1,1,0.0,0.0
Matei Vanea,www.antena3.ro,0,0,1,1,0.0,0.0
Oana Crețu,www.antena3.ro,0,0,1,1,0.0,0.0
Paul Ispas,www.antena3.ro,0,0,1,1,0.0,0.0
Petru Mîndru,www.antena3.ro,0,0,1,1,0.0,0.0
Remus Pricopie,www.antena3.ro,0,1,2,3,-0.3333333333333333,0.3333333333333333
bodyguard,www.antena3.ro,0,1,0,1,-1.0,1.0
Florian Neagu,a1.ro,0,0,1,1,0.0,0.0
Mugur Isărescu,a1.ro,0,1,2,3,-0.3333333333333333,0.3333333333333333
roman,a1.ro,0,0,1,1,0.0,0.0
Cristian Preda,pressone.ro,0,1,1,2,-0.5,0.5
Maria,pressone.ro,0,0,1,1,0.0,0.0
Mariei Grapini,pressone.ro,0,0,2,2,0.0,0.0
Monica Macovei,pressone.ro,0,2,0,2,-1.0,1.0
Siegfried Mureșan,pressone.ro,0,1,4,5,-0.2,0.2
Strasbourg,pressone.ro,0,0,5,5,0.0,0.0
Grupini,pressone.ro,1,0,0,1,1.0,1.0
domnuHai,pressone.ro,0,1,0,1,-1.0,1.0
domnul Cioloș,pressone.ro,0,1,0,1,-1.0,1.0
impostoare,pressone.ro,0,1,0,1,-1.0,1.0
Ștefănescu,pressone.ro,0,0,2,2,0.0,0.0
Kelemen,www.news.ro,0,0,3,3,0.0,0.0
Eduard Novak,www.news.ro,1,0,0,1,1.0,1.0
campion,www.news.ro,1,1,0,2,0.0,0.0
băieț,pressone.ro,0,1,1,2,-0.5,0.5
S,pressone.ro,0,1,0,1,-1.0,1.0
pieton,pressone.ro,0,1,1,2,-0.5,0.5
factor de decizie,www.antena3.ro,0,0,1,1,0.0,0.0
influențator,www.antena3.ro,0,1,0,1,-1.0,1.0
Cătălin Blebea,pressone.ro,0,1,0,1,-1.0,1.0
Doina Gradea,pressone.ro,0,0,1,1,0.0,0.0
Doinei Gradea,pressone.ro,0,0,1,1,0.0,0.0
Domnul Blebea,pressone.ro,0,1,0,1,-1.0,1.0
Raico Cornea,pressone.ro,0,0,2,2,0.0,0.0
Dragoș Pătraru,pressone.ro,0,0,2,2,0.0,0.0
Gabi Gherghescu,pressone.ro,0,0,1,1,0.0,0.0
Petrișor Obae,pressone.ro,0,1,0,1,-1.0,1.0
Pătraru,pressone.ro,0,0,1,1,0.0,0.0
Gradea,pressone.ro,0,1,0,1,-1.0,1.0
Blebea,pressone.ro,0,1,0,1,-1.0,1.0
Cornea,pressone.ro,0,2,0,2,-1.0,1.0
Adrian Sanda,recorder.ro,0,1,0,1,-1.0,1.0
Athena Piceava,recorder.ro,0,0,1,1,0.0,0.0
Ceaușescu,recorder.ro,0,2,2,4,-0.5,0.5
Coca,recorder.ro,0,0,1,1,0.0,0.0
Herculane,recorder.ro,0,0,1,1,0.0,0.0
Ion Vasile,recorder.ro,0,0,1,1,0.0,0.0
Irina Leulescu,recorder.ro,0,0,1,1,0.0,0.0
Laurențiu Coca,recorder.ro,0,0,1,1,0.0,0.0
Lionel Zosmer,recorder.ro,0,0,1,1,0.0,0.0
Radu Aurelian,recorder.ro,0,0,2,2,0.0,0.0
Rocker,recorder.ro,0,0,1,1,0.0,0.0
Sorin Vintilă Meșter,recorder.ro,0,1,0,1,-1.0,1.0
Săpoca,recorder.ro,0,0,1,1,0.0,0.0
component,recorder.ro,0,0,1,1,0.0,0.0
dictator,recorder.ro,0,1,0,1,-1.0,1.0
disident,recorder.ro,0,1,0,1,-1.0,1.0
Gabriel Andreescu,recorder.ro,0,0,1,1,0.0,0.0
electronist,recorder.ro,0,0,1,1,0.0,0.0
luptător,recorder.ro,0,2,0,2,-1.0,1.0
martor,recorder.ro,0,0,2,2,0.0,0.0
predecesor,recorder.ro,0,3,0,3,-1.0,1.0
reținut,recorder.ro,0,1,0,1,-1.0,1.0
rival,www.digi24.ro,0,1,0,1,-1.0,1.0
Nadia Cerva,www.digi24.ro,0,1,0,1,-1.0,1.0
Robert Cazanciuc,www.digi24.ro,0,0,1,1,0.0,0.0
Simona Spătaru,www.digi24.ro,0,0,1,1,0.0,0.0
Vlad Zaha,www.digi24.ro,0,0,2,2,0.0,0.0
Vlad Zaharia,www.digi24.ro,0,0,1,1,0.0,0.0
șofer,www.digi24.ro,0,3,1,4,-0.75,0.75
Alexandru Dumitriu,www.aktual24.ro,0,0,1,1,0.0,0.0
Andrei Nenisca,www.aktual24.ro,0,0,1,1,0.0,0.0
Bogdan Dăscălescu,www.aktual24.ro,0,0,1,1,0.0,0.0
Botosani,www.aktual24.ro,0,0,2,2,0.0,0.0
Eduard Mititelu,www.aktual24.ro,0,0,1,1,0.0,0.0
Gabriel Timofte,www.aktual24.ro,0,0,1,1,0.0,0.0
Gelu Graur,www.aktual24.ro,0,0,1,1,0.0,0.0
Ioana Rusu,www.aktual24.ro,0,0,1,1,0.0,0.0
Luciana Buliga,www.aktual24.ro,0,0,1,1,0.0,0.0
Ionela Aiftinca,www.aktual24.ro,0,0,1,1,0.0,0.0
Marian Bidasca,www.aktual24.ro,0,0,1,1,0.0,0.0
Ovidiu Jitaru,www.aktual24.ro,0,0,1,1,0.0,0.0
Bogdan Suruciuc,www.aktual24.ro,0,0,1,1,0.0,0.0
Cristian Chirteș,www.mediafax.ro,0,0,1,1,0.0,0.0
Doru Oprișcan,www.mediafax.ro,0,0,1,1,0.0,0.0
Dănuț Aelenei,adevarul.ro,0,0,1,1,0.0,0.0
Iliescu,adevarul.ro,0,9,2,11,-0.8181818181818182,0.8181818181818182
Vadim,adevarul.ro,0,2,0,2,-1.0,1.0
copreședinte,adevarul.ro,0,0,4,4,0.0,0.0
Andreea Alexandru,recorder.ro,0,0,1,1,0.0,0.0
Ferentari,recorder.ro,0,1,0,1,-1.0,1.0
Valeriu Nicolae,recorder.ro,0,0,1,1,0.0,0.0
simpatizant,recorder.ro,0,3,4,7,-0.42857142857142855,0.42857142857142855
Domnic Fritz,www.g4media.ro,0,0,1,1,0.0,0.0
Remus Ștefureac,www.gandul.ro,0,1,1,2,-0.5,0.5
prezidențiabil,www.gandul.ro,0,1,0,1,-1.0,1.0
pucist,www.gandul.ro,0,1,0,1,-1.0,1.0
puciște,www.gandul.ro,0,1,0,1,-1.0,1.0
succesor,www.gandul.ro,0,0,1,1,0.0,0.0
Ștefureac,www.gandul.ro,0,1,0,1,-1.0,1.0
Gian Marco Chiarini,adevarul.ro,0,0,1,1,0.0,0.0
Luigi Scollo,adevarul.ro,0,0,2,2,0.0,0.0
Nassiryaa,adevarul.ro,0,1,0,1,-1.0,1.0
polițist militar,adevarul.ro,0,0,1,1,0.0,0.0
Roberto Cremene,adevarul.ro,0,0,1,1,0.0,0.0
jurist,www.romaniatv.net,0,0,1,1,0.0,0.0
Gaza,www.aktual24.ro,0,1,2,3,-0.3333333333333333,0.3333333333333333
Ismail Haniyeh,www.aktual24.ro,0,1,0,1,-1.0,1.0
Israel Katz,www.aktual24.ro,0,0,1,1,0.0,0.0
Khan Yunis,www.aktual24.ro,0,0,1,1,0.0,0.0
Mohammad Sinwar,www.aktual24.ro,0,0,1,1,0.0,0.0
Sinwar,www.aktual24.ro,0,0,1,1,0.0,0.0
Teheran,www.aktual24.ro,0,0,1,1,0.0,0.0
Yahya Sinwar,www.aktual24.ro,0,1,0,1,-1.0,1.0
predecesor,www.aktual24.ro,0,2,0,2,-1.0,1.0
Aspen,a1.ro,0,0,1,1,0.0,0.0
Colo,a1.ro,0,0,1,1,0.0,0.0
Donald Trump Jr,a1.ro,0,0,2,2,0.0,0.0
Eric,a1.ro,0,0,2,2,0.0,0.0
Ivaka,a1.ro,0,0,1,1,0.0,0.0
Ivana,a1.ro,0,0,1,1,0.0,0.0
Ivana Trump,a1.ro,0,0,1,1,0.0,0.0
Ivanei,a1.ro,0,0,1,1,0.0,0.0
Maples,a1.ro,0,0,1,1,0.0,0.0
Omarosa Manigault Newman,a1.ro,0,0,1,1,0.0,0.0
Prima Doamnă,a1.ro,0,1,1,2,-0.5,0.5
Tiffany,a1.ro,0,0,3,3,0.0,0.0
Alexandru Muraru,observatornews.ro,0,0,1,1,0.0,0.0
Radu Oprea,observatornews.ro,0,0,2,2,0.0,0.0
Rareș Bogdan,observatornews.ro,0,0,5,5,0.0,0.0
baron,observatornews.ro,0,1,0,1,-1.0,1.0
Ciucu,www.euronews.ro,0,0,1,1,0.0,0.0
Paul Richard Gallagher,primanews.ro,0,0,1,1,0.0,0.0
Papei,primanews.ro,0,0,1,1,0.0,0.0
Suveranul Pontif,primanews.ro,0,0,1,1,0.0,0.0
Vance,primanews.ro,0,1,0,1,-1.0,1.0
enoriaș,primanews.ro,0,0,1,1,0.0,0.0
responsabil politic,primanews.ro,0,0,1,1,0.0,0.0
secretar de stat,primanews.ro,0,0,3,3,0.0,0.0
Votanțiu,adevarul.ro,0,0,2,2,0.0,0.0
Bianca Samson,agerpres.ro,0,0,1,1,0.0,0.0
Chișinău,agerpres.ro,0,0,1,1,0.0,0.0
Daniel,agerpres.ro,0,1,0,1,-1.0,1.0
federație,agerpres.ro,0,1,0,1,-1.0,1.0
Georgia,agerpres.ro,0,0,1,1,0.0,0.0
Găgăuzia,agerpres.ro,0,0,1,1,0.0,0.0
Haga,agerpres.ro,0,0,1,1,0.0,0.0
Irena Kucina,agerpres.ro,0,0,1,1,0.0,0.0
Iulian Groza,agerpres.ro,0,0,1,1,0.0,0.0
Lauma Paeglkalna,agerpres.ro,0,0,1,1,0.0,0.0
Letonia,agerpres.ro,0,0,2,2,0.0,0.0
Luxemburg,agerpres.ro,0,0,2,2,0.0,0.0
Republica Moldova,agerpres.ro,1,0,4,5,0.2,0.2
Riga,agerpres.ro,0,0,1,1,0.0,0.0
Sara,agerpres.ro,0,0,1,1,0.0,0.0
Titus Corlățean,agerpres.ro,0,0,2,2,0.0,0.0
Strasbourg,agerpres.ro,0,0,2,2,0.0,0.0
Suedia,agerpres.ro,0,2,0,2,-1.0,1.0
Theodoros Rousopoulos,agerpres.ro,0,0,1,1,0.0,0.0
Tiana,agerpres.ro,0,0,1,1,0.0,0.0
fată,agerpres.ro,0,0,1,1,0.0,0.0
parte,agerpres.ro,0,0,1,1,0.0,0.0
raportor,agerpres.ro,0,1,0,1,-1.0,1.0
Corlățean,agerpres.ro,0,0,1,1,0.0,0.0
Dan Dungaciu,www.realitatea.net,0,0,1,1,0.0,0.0
Dungaciu,www.realitatea.net,0,1,1,2,-0.5,0.5
Auckland,adevarul.ro,0,0,3,3,0.0,0.0
Perth,adevarul.ro,0,0,2,2,0.0,0.0
Cristian Pistol,www.gandul.ro,0,0,4,4,0.0,0.0
Constantin Brâncuși,agerpres.ro,1,0,0,1,1.0,1.0
sculptor,agerpres.ro,1,0,0,1,1.0,1.0
Bogdan Stanoevici,www.luju.ro,0,0,1,1,0.0,0.0
Augustin Lazăr,www.luju.ro,0,1,0,1,-1.0,1.0
Lucian Netejoru,www.luju.ro,0,0,1,1,0.0,0.0
ministresă,www.luju.ro,0,3,0,3,-1.0,1.0
Raluca Pruna,www.luju.ro,0,2,1,3,-0.6666666666666666,0.6666666666666666
Teodor Maries,www.luju.ro,0,0,1,1,0.0,0.0
femeie,www.luju.ro,0,0,1,1,0.0,0.0
inspector,www.luju.ro,0,2,2,4,-0.5,0.5
unit,www.luju.ro,0,1,0,1,-1.0,1.0
sinistraț,www.gandul.ro,0,1,0,1,-1.0,1.0
Nova,a1.ro,0,0,1,1,0.0,0.0
Novak Đoković,a1.ro,1,0,2,3,0.3333333333333333,0.3333333333333333
câștigător,a1.ro,0,0,3,3,0.0,0.0
Florin Iordache,www.mediafax.ro,0,1,0,1,-1.0,1.0
Iordache,www.mediafax.ro,0,1,0,1,-1.0,1.0
Juncker,www.mediafax.ro,0,0,1,1,0.0,0.0
Ursula von der Leyen,www.mediafax.ro,0,0,1,1,0.0,0.0
justițiabil,www.mediafax.ro,1,0,1,2,0.5,0.5
vicepremier,www.mediafax.ro,0,0,1,1,0.0,0.0
Claudiu Manda,www.comisarul.ro,0,2,5,7,-0.2857142857142857,0.2857142857142857
Ivan,www.comisarul.ro,0,0,3,3,0.0,0.0
Lia Olguța Vasilescu,www.comisarul.ro,0,1,4,5,-0.2,0.2
Radu Moldovan,www.comisarul.ro,0,0,2,2,0.0,0.0
Vasile Dîncu,www.comisarul.ro,0,0,2,2,0.0,0.0
Alin Galatescu,observatornews.ro,0,0,1,1,0.0,0.0
femeie politician,observatornews.ro,0,1,0,1,-1.0,1.0
personal,primanews.ro,0,1,2,3,-0.3333333333333333,0.3333333333333333
Horia Sima,adevarul.ro,0,0,1,1,0.0,0.0
Adrian Cozma,agerpres.ro,0,0,1,1,0.0,0.0
Cozma,agerpres.ro,0,0,1,1,0.0,0.0
Radu Miruță,agerpres.ro,0,0,1,1,0.0,0.0
Bolojan,agerpres.ro,1,1,4,6,0.0,0.0
domnul Ponta,agerpres.ro,0,1,0,1,-1.0,1.0
dansator,agerpres.ro,0,0,1,1,0.0,0.0
Mircea Fechet,www.romaniatv.net,0,1,0,1,-1.0,1.0
Alina Gheorghiu,www.luju.ro,0,1,0,1,-1.0,1.0
Coldea,www.luju.ro,0,5,0,5,-1.0,1.0
Dinu Patriciu,www.luju.ro,0,1,0,1,-1.0,1.0
Elena Udrea,www.luju.ro,0,1,0,1,-1.0,1.0
Elene Udrea,www.luju.ro,0,1,0,1,-1.0,1.0
Macovei,www.luju.ro,0,1,0,1,-1.0,1.0
Maia Sandu,www.luju.ro,0,4,0,4,-1.0,1.0
Soros,www.luju.ro,0,3,0,3,-1.0,1.0
Tariceanu,www.luju.ro,0,1,0,1,-1.0,1.0
Udrea,www.luju.ro,0,1,0,1,-1.0,1.0
adversar,www.luju.ro,0,2,0,2,-1.0,1.0
liberal,www.luju.ro,0,1,0,1,-1.0,1.0
slugă,www.luju.ro,0,1,0,1,-1.0,1.0
Bardella,www.mediafax.ro,0,0,1,1,0.0,0.0
François Paradol,www.mediafax.ro,0,0,1,1,0.0,0.0
Jordan Bardella,www.mediafax.ro,0,1,0,1,-1.0,1.0
Paradol,www.mediafax.ro,0,0,2,2,0.0,0.0
asistent,www.mediafax.ro,0,0,1,1,0.0,0.0
asistent parlamentar,www.mediafax.ro,0,0,1,1,0.0,0.0
mentor,www.mediafax.ro,0,1,0,1,-1.0,1.0
Igor Dodon,adevarul.ro,0,2,1,3,-0.6666666666666666,0.6666666666666666
turișt,www.digi24.ro,1,0,0,1,1.0,1.0
Beniamin Cotan,www.aktual24.ro,0,0,2,2,0.0,0.0
Emil Stoica Maris,www.aktual24.ro,0,0,1,1,0.0,0.0
Laurentiu Nistor,www.aktual24.ro,0,0,1,1,0.0,0.0
Natalia Intotero,www.aktual24.ro,0,0,4,4,0.0,0.0
Pavel Cristian Nitulescu,www.aktual24.ro,0,0,1,1,0.0,0.0
Petru Lobont,www.aktual24.ro,0,0,1,1,0.0,0.0
Sorina Cobori,www.aktual24.ro,0,0,1,1,0.0,0.0
Valeria Filimon,www.aktual24.ro,0,0,1,1,0.0,0.0
Ilie Toma,www.aktual24.ro,0,0,1,1,0.0,0.0
Viorel Salan,www.aktual24.ro,0,0,1,1,0.0,0.0
Luminița Hurgoiu,www.aktual24.ro,0,0,1,1,0.0,0.0
Maria Stefanie,www.aktual24.ro,0,0,1,1,0.0,0.0
Cristian Resmerita,www.aktual24.ro,0,0,1,1,0.0,0.0
Cosmin Marinescu,www.digi24.ro,0,0,1,1,0.0,0.0
Alin Brendea,agerpres.ro,0,0,1,1,0.0,0.0
broker,agerpres.ro,0,0,1,1,0.0,0.0
Gheorghe Șimon,adevarul.ro,0,0,1,1,0.0,0.0
Nicole Ciucă,adevarul.ro,0,1,0,1,-1.0,1.0
Tudose,adevarul.ro,0,1,0,1,-1.0,1.0
fermier,adevarul.ro,1,0,1,2,0.5,0.5
transportator,adevarul.ro,0,0,1,1,0.0,0.0
Cristian Bușoi,www.mediafax.ro,0,0,1,1,0.0,0.0
Dăncilă,www.mediafax.ro,0,0,2,2,0.0,0.0
CTP,www.euronews.ro,0,2,0,2,-1.0,1.0
Cristian Tudor Popescu,www.euronews.ro,0,1,2,3,-0.3333333333333333,0.3333333333333333
gazetar,www.euronews.ro,0,1,2,3,-0.3333333333333333,0.3333333333333333
Cotroceni,pressone.ro,0,1,3,4,-0.25,0.25
comandant,pressone.ro,0,1,3,4,-0.25,0.25
suveranist,pressone.ro,0,3,0,3,-1.0,1.0
Ionescu Dorin Laurențiu,adevarul.ro,0,0,1,1,0.0,0.0
Ionuț Lutu,adevarul.ro,0,0,2,2,0.0,0.0
asociat,adevarul.ro,0,1,1,2,-0.5,0.5
fotbalist,adevarul.ro,0,0,1,1,0.0,0.0
Emmanuel Macron,www.news.ro,0,1,1,2,-0.5,0.5
Dragoș Sprînceană,www.news.ro,0,0,2,2,0.0,0.0
Petrov,www.news.ro,0,2,0,2,-1.0,1.0
Unite,www.news.ro,0,1,0,1,-1.0,1.0
căpitan,www.news.ro,1,0,0,1,1.0,1.0
familie,www.news.ro,3,1,3,7,0.2857142857142857,0.2857142857142857
frate,www.news.ro,0,3,1,4,-0.75,0.75
locuitor,www.g4media.ro,1,0,2,3,0.3333333333333333,0.3333333333333333
Ionuț Pacuraru,www.aktual24.ro,0,0,1,1,0.0,0.0
Maricel Pacuraru,www.aktual24.ro,0,1,0,1,-1.0,1.0
Marius Lulea,www.aktual24.ro,0,0,2,2,0.0,0.0
Claudiu Târziu,www.mediafax.ro,0,0,3,3,0.0,0.0
etic,www.mediafax.ro,0,0,1,1,0.0,0.0
Boris Pistorius,primanews.ro,0,0,1,1,0.0,0.0
Johann Wadephul,primanews.ro,0,0,1,1,0.0,0.0
Karin Prien,primanews.ro,0,0,1,1,0.0,0.0
Katherina Reiche,primanews.ro,0,0,1,1,0.0,0.0
Lars Klingbeil,primanews.ro,0,0,1,1,0.0,0.0
Karsten Wildberger,primanews.ro,0,0,1,1,0.0,0.0
Nina Warken,primanews.ro,0,0,1,1,0.0,0.0
vicecancelar,primanews.ro,0,0,1,1,0.0,0.0
Emirate,www.gandul.ro,0,0,1,1,0.0,0.0
Mircea Diaconu,pressone.ro,0,1,0,1,-1.0,1.0
Viorică,pressone.ro,0,0,1,1,0.0,0.0
iștilor,pressone.ro,0,1,0,1,-1.0,1.0
Fenechiu,www.aktual24.ro,0,1,2,3,-0.3333333333333333,0.3333333333333333
semnatar,www.aktual24.ro,0,1,0,1,-1.0,1.0
Simona Bucura-Oprescu,www.aktual24.ro,0,0,1,1,0.0,0.0
Bivolaru,recorder.ro,0,1,0,1,-1.0,1.0
Gheorghe Funar,recorder.ro,0,3,0,3,-1.0,1.0
Gregorian Bivolaru,recorder.ro,0,1,0,1,-1.0,1.0
Manuel Barroso,recorder.ro,0,0,1,1,0.0,0.0
Zalău,recorder.ro,0,0,2,2,0.0,0.0
subsecretar de stat,recorder.ro,0,2,2,4,-0.5,0.5
și,recorder.ro,0,0,1,1,0.0,0.0
băcan,adevarul.ro,0,0,1,1,0.0,0.0
Boroly,adevarul.ro,0,0,1,1,0.0,0.0
Crin,adevarul.ro,0,0,1,1,0.0,0.0
Gigel Știrbu,adevarul.ro,0,0,1,1,0.0,0.0
Hasotti,adevarul.ro,0,0,1,1,0.0,0.0
Ioan Oltean,adevarul.ro,0,2,2,4,-0.5,0.5
Marian Petrache,adevarul.ro,0,0,1,1,0.0,0.0
Romeo Stavarache,adevarul.ro,0,1,1,2,-0.5,0.5
bătrân,observatornews.ro,0,1,1,2,-0.5,0.5
Craiova,www.g4media.ro,0,0,1,1,0.0,0.0
Vasilescu,www.g4media.ro,0,0,1,1,0.0,0.0
Vicepreședintele,www.g4media.ro,0,0,3,3,0.0,0.0
Ștefan Stoica,www.g4media.ro,0,0,2,2,0.0,0.0
Dan Motreanu,www.comisarul.ro,0,0,2,2,0.0,0.0
Valeriu Iftime,www.comisarul.ro,0,0,2,2,0.0,0.0
fetiță,www.romaniatv.net,0,0,3,3,0.0,0.0
locuitor,www.romaniatv.net,1,0,0,1,1.0,1.0
moldovean,www.antena3.ro,1,0,0,1,1.0,1.0
ambasadoare,www.euronews.ro,0,0,1,1,0.0,0.0
investitor,www.euronews.ro,1,3,0,4,-0.5,0.5
Alexandru Dumitru,snoop.ro,0,0,1,1,0.0,0.0
Andrei George Tănase,snoop.ro,0,0,1,1,0.0,0.0
Costache Răzvan Valentin,snoop.ro,0,1,0,1,-1.0,1.0
Cornel Dinu,snoop.ro,0,0,2,2,0.0,0.0
Dan Șucu,snoop.ro,0,0,1,1,0.0,0.0
Daniel Florea,snoop.ro,0,0,1,1,0.0,0.0
Dinu,snoop.ro,0,0,1,1,0.0,0.0
Egipt,snoop.ro,0,0,1,1,0.0,0.0
Florea,snoop.ro,0,0,3,3,0.0,0.0
Gruia Docan,snoop.ro,0,0,1,1,0.0,0.0
Ion Bălint,snoop.ro,0,0,1,1,0.0,0.0
Ionel,snoop.ro,0,1,0,1,-1.0,1.0
Ion Tucmuruz,snoop.ro,0,1,0,1,-1.0,1.0
Luminița Tucmuruz,snoop.ro,0,0,1,1,0.0,0.0
Marcela Tucmuruz,snoop.ro,0,0,2,2,0.0,0.0
Marcel,snoop.ro,0,0,1,1,0.0,0.0
Marcel Tucmuruz,snoop.ro,0,0,1,1,0.0,0.0
Marian Preda,snoop.ro,0,0,1,1,0.0,0.0
Mădălina Topoloagă,snoop.ro,0,0,1,1,0.0,0.0
Mădălina Tucmuruz,snoop.ro,0,0,1,1,0.0,0.0
Nicomar,snoop.ro,0,0,1,1,0.0,0.0
Nuțu Cămătaru,snoop.ro,0,0,1,1,0.0,0.0
Andrei Popescu,snoop.ro,0,2,0,2,-1.0,1.0
Popescu Piedone,snoop.ro,0,1,0,1,-1.0,1.0
Preda,snoop.ro,0,0,1,1,0.0,0.0
Săcele,snoop.ro,0,0,1,1,0.0,0.0
Tucmuruz Ionel,snoop.ro,0,2,0,2,-1.0,1.0
Tanța Luminița Tucmuruz,snoop.ro,0,0,1,1,0.0,0.0
Tucmuruz,snoop.ro,0,1,1,2,-0.5,0.5
Vali Vijelie,snoop.ro,0,0,2,2,0.0,0.0
Vijelie,snoop.ro,0,0,1,1,0.0,0.0
adjunct,snoop.ro,0,1,0,1,-1.0,1.0
colonel,snoop.ro,0,0,2,2,0.0,0.0
cumnat,snoop.ro,0,1,3,4,-0.25,0.25
domnul Florea,snoop.ro,0,0,1,1,0.0,0.0
dansator,snoop.ro,2,0,4,6,0.3333333333333333,0.3333333333333333
familia Tucmuruz,snoop.ro,0,1,1,2,-0.5,0.5
Răzvan Valentin Costache,snoop.ro,0,1,0,1,-1.0,1.0
jurist,snoop.ro,0,0,1,1,0.0,0.0
soră,snoop.ro,0,0,4,4,0.0,0.0
Mirel Palada,www.realitatea.net,0,0,1,1,0.0,0.0
Dianei,adevarul.ro,0,0,1,1,0.0,0.0
Aleș,observatornews.ro,0,0,2,2,0.0,0.0
Huvern,observatornews.ro,0,0,1,1,0.0,0.0
tehnocrat,observatornews.ro,0,0,1,1,0.0,0.0
Alexandru Lăpușneanu,pressone.ro,0,0,1,1,0.0,0.0
Alexandru cel Bun,pressone.ro,0,0,1,1,0.0,0.0
Bănicioiu,pressone.ro,0,1,1,2,-0.5,0.5
Cervantes,pressone.ro,1,0,0,1,1.0,1.0
Chirică,pressone.ro,0,0,1,1,0.0,0.0
Constantin Niță,pressone.ro,0,0,2,2,0.0,0.0
Dolineaschi,pressone.ro,0,0,1,1,0.0,0.0
Gheorghe Nichita,pressone.ro,0,0,1,1,0.0,0.0
Gheorghe Șimon,pressone.ro,0,0,1,1,0.0,0.0
Ionuț Vulpescu,pressone.ro,0,0,3,3,0.0,0.0
Mihai Chirică,pressone.ro,0,0,1,1,0.0,0.0
Mihai Sturzu,pressone.ro,0,1,3,4,-0.25,0.25
Ovidiu Wlassopol,pressone.ro,0,0,1,1,0.0,0.0
Pană,pressone.ro,0,0,1,1,0.0,0.0
Petrăchioaia,pressone.ro,0,0,1,1,0.0,0.0
Republica Cehă,pressone.ro,0,0,2,2,0.0,0.0
Republica Elenă,pressone.ro,0,0,1,1,0.0,0.0
Serghei Stanișev,pressone.ro,0,0,1,1,0.0,0.0
Sturzu,pressone.ro,0,2,0,2,-1.0,1.0
Victor Negrescu,pressone.ro,1,0,1,2,0.5,0.5
Vișeu de Sus,pressone.ro,0,0,1,1,0.0,0.0
Vlase,pressone.ro,0,1,0,1,-1.0,1.0
Vâlcea,pressone.ro,0,0,2,2,0.0,0.0
Vălenii de Munte,pressone.ro,0,0,1,1,0.0,0.0
Dani Mocanu,www.romaniatv.net,0,0,1,1,0.0,0.0
Mircea Cărtărescu,www.romaniatv.net,0,0,1,1,0.0,0.0
sociolog,www.romaniatv.net,0,0,3,3,0.0,0.0
Vladimir,primanews.ro,0,0,1,1,0.0,0.0
negator,primanews.ro,0,1,0,1,-1.0,1.0
Elena Lasoni,adevarul.ro,0,0,1,1,0.0,0.0
Agamita,www.aktual24.ro,0,1,0,1,-1.0,1.0
Goe,www.aktual24.ro,0,1,0,1,-1.0,1.0
Palada,www.aktual24.ro,0,0,1,1,0.0,0.0
Gheorghe,www.aktual24.ro,0,1,1,2,-0.5,0.5
Mita,www.aktual24.ro,0,1,0,1,-1.0,1.0
tânăr,www.realitatea.net,2,2,1,5,0.0,0.0
Florin,pressone.ro,0,1,0,1,-1.0,1.0
Gheorghe Flutur,pressone.ro,1,0,1,2,0.5,0.5
pierzător,pressone.ro,0,3,0,3,-1.0,1.0
animator,pressone.ro,0,1,0,1,-1.0,1.0
Andrei,recorder.ro,0,0,1,1,0.0,0.0
Mihai Gâdea,recorder.ro,0,1,0,1,-1.0,1.0
Simionovici,recorder.ro,0,1,0,1,-1.0,1.0
familia Vicol-Ciorbă,recorder.ro,0,1,0,1,-1.0,1.0
gazdele,recorder.ro,0,1,0,1,-1.0,1.0
Ioan Chirteș,recorder.ro,0,1,0,1,-1.0,1.0
suroră,recorder.ro,0,0,1,1,0.0,0.0
Cristinel Grosu,www.activenews.ro,0,4,0,4,-1.0,1.0
Marian Enache,www.activenews.ro,0,3,0,3,-1.0,1.0
Vanghelie,www.activenews.ro,0,1,0,1,-1.0,1.0
bisexual,www.activenews.ro,0,0,1,1,0.0,0.0
cunoscător,www.activenews.ro,0,1,0,1,-1.0,1.0
pedofil,www.activenews.ro,0,2,0,2,-1.0,1.0
Vale Marian,www.activenews.ro,0,1,0,1,-1.0,1.0
Constantin Alexa,www.b1tv.ro,0,0,1,1,0.0,0.0
Dolj,www.b1tv.ro,0,0,2,2,0.0,0.0
India,www.b1tv.ro,0,0,1,1,0.0,0.0
Oliviu German,www.b1tv.ro,0,0,1,1,0.0,0.0
Oliviu Gherman,www.b1tv.ro,0,0,1,1,0.0,0.0
Paris,www.b1tv.ro,1,0,1,2,0.5,0.5
politică,www.b1tv.ro,0,0,1,1,0.0,0.0
Regatul Unit al Marii Britanii,www.b1tv.ro,0,0,1,1,0.0,0.0
Africa de Sud,www.b1tv.ro,0,0,1,1,0.0,0.0
Republica Costa de Fildeș,www.b1tv.ro,0,0,1,1,0.0,0.0
Israel,www.b1tv.ro,0,0,1,1,0.0,0.0
Sânmihaiu,www.b1tv.ro,0,0,1,1,0.0,0.0
Sânmihaiu de Sus,www.b1tv.ro,0,0,1,1,0.0,0.0
ambasador,www.b1tv.ro,0,1,1,2,-0.5,0.5
profesor universitar,www.b1tv.ro,0,0,1,1,0.0,0.0
Anda Badea,www.g4media.ro,0,0,1,1,0.0,0.0
Andrei Ohaci,www.g4media.ro,0,0,1,1,0.0,0.0
Bogdan,www.g4media.ro,0,1,0,1,-1.0,1.0
Dorin Cocoș,www.g4media.ro,0,1,0,1,-1.0,1.0
Dragoș Bogdan,www.g4media.ro,0,1,0,1,-1.0,1.0
Mihaiu,www.g4media.ro,0,1,0,1,-1.0,1.0
Radu Mihaiu,www.g4media.ro,0,1,0,1,-1.0,1.0
consilieră,www.g4media.ro,0,0,1,1,0.0,0.0
personaj,www.g4media.ro,0,2,2,4,-0.5,0.5
Stelea,agerpres.ro,0,0,1,1,0.0,0.0
doamna Dragu,stirileprotv.ro,0,0,1,1,0.0,0.0
guvernatoare,stirileprotv.ro,0,1,0,1,-1.0,1.0
Becali,www.gandul.ro,0,1,1,2,-0.5,0.5
George,www.gandul.ro,0,0,1,1,0.0,0.0
Gigi Becali,www.gandul.ro,0,2,5,7,-0.2857142857142857,0.2857142857142857
latifundiar,www.gandul.ro,0,3,0,3,-1.0,1.0
mamă,www.gandul.ro,0,1,2,3,-0.3333333333333333,0.3333333333333333
Pipera,www.gandul.ro,0,0,2,2,0.0,0.0
Parascheva,www.gandul.ro,0,0,1,1,0.0,0.0
mascaț,www.gandul.ro,0,1,0,1,-1.0,1.0
milion,www.gandul.ro,0,1,0,1,-1.0,1.0
K,www.digi24.ro,0,1,0,1,-1.0,1.0
V. Dăncilă,www.digi24.ro,0,0,1,1,0.0,0.0
Alin Borcan,pressone.ro,0,1,0,1,-1.0,1.0
Anamaria Gavrilă,pressone.ro,0,2,0,2,-1.0,1.0
Bamba,pressone.ro,0,0,1,1,0.0,0.0
Barcelona,pressone.ro,0,0,1,1,0.0,0.0
Codrin Unici,pressone.ro,0,2,0,2,-1.0,1.0
Congo,pressone.ro,0,1,0,1,-1.0,1.0
Elon Musk,pressone.ro,0,1,1,2,-0.5,0.5
Eugen Sechila,pressone.ro,0,1,0,1,-1.0,1.0
George Pian,pressone.ro,0,0,1,1,0.0,0.0
Horațiu Potra,pressone.ro,0,1,0,1,-1.0,1.0
Iulia Marin,pressone.ro,0,0,1,1,0.0,0.0
Machiavelli,pressone.ro,0,1,0,1,-1.0,1.0
Mircea Nebunu,pressone.ro,0,0,1,1,0.0,0.0
Steve Bannon,pressone.ro,0,1,0,1,-1.0,1.0
apostol,pressone.ro,0,1,0,1,-1.0,1.0
bodyguard,pressone.ro,0,1,0,1,-1.0,1.0
bucureștean,pressone.ro,0,1,5,6,-0.16666666666666666,0.16666666666666666
clovn,pressone.ro,0,1,0,1,-1.0,1.0
cunoscut,pressone.ro,0,0,1,1,0.0,0.0
filfizon,pressone.ro,0,1,0,1,-1.0,1.0
Tate,pressone.ro,0,1,0,1,-1.0,1.0
gropar,pressone.ro,0,1,0,1,-1.0,1.0
Victor Ilie,pressone.ro,0,0,1,1,0.0,0.0
preferat,pressone.ro,0,1,0,1,-1.0,1.0
semen,pressone.ro,1,0,0,1,1.0,1.0
soldat,pressone.ro,0,3,2,5,-0.6,0.6
ultraș,pressone.ro,0,4,0,4,-1.0,1.0
șmecher,pressone.ro,0,1,0,1,-1.0,1.0
Anamaria Gavrila,www.news.ro,0,0,2,2,0.0,0.0
suveran,www.news.ro,0,1,0,1,-1.0,1.0
Arad,adevarul.ro,0,0,3,3,0.0,0.0
Mîndru Petru,adevarul.ro,0,0,2,2,0.0,0.0
Terțiu Violeta Valentina,adevarul.ro,0,0,2,2,0.0,0.0
Ioan Todiroae,adevarul.ro,0,0,2,2,0.0,0.0
Călin Popescu Tăriceanu,www.g4media.ro,0,0,1,1,0.0,0.0
Lulea,www.g4media.ro,0,1,2,3,-0.3333333333333333,0.3333333333333333
Bezdead,observatornews.ro,0,0,1,1,0.0,0.0
Constantin Crețu,observatornews.ro,0,0,1,1,0.0,0.0
Dacia,observatornews.ro,0,0,1,1,0.0,0.0
Dracula,observatornews.ro,0,0,1,1,0.0,0.0
Gheorghe Copil,observatornews.ro,0,0,1,1,0.0,0.0
nostalgic,observatornews.ro,0,1,0,1,-1.0,1.0
Carol I,adevarul.ro,0,0,2,2,0.0,0.0
Casele Regale,adevarul.ro,0,0,1,1,0.0,0.0
Curtea de Argeș,adevarul.ro,0,0,1,1,0.0,0.0
Duda,adevarul.ro,0,1,0,1,-1.0,1.0
Ferdinand I,adevarul.ro,0,0,1,1,0.0,0.0
Ion Ilescu,adevarul.ro,0,1,0,1,-1.0,1.0
Nicolae Văcăroiu,adevarul.ro,0,1,0,1,-1.0,1.0
principe,adevarul.ro,0,0,1,1,0.0,0.0
Radu Duda,adevarul.ro,0,3,0,3,-1.0,1.0
principesă,adevarul.ro,0,0,1,1,0.0,0.0
Margareta,adevarul.ro,0,0,3,3,0.0,0.0
rege,adevarul.ro,0,1,0,1,-1.0,1.0
regele,adevarul.ro,0,1,0,1,-1.0,1.0
Regele Mihai,adevarul.ro,0,1,0,1,-1.0,1.0
René Duda,adevarul.ro,0,0,2,2,0.0,0.0
republică,adevarul.ro,0,0,1,1,0.0,0.0
Stelian Tănase,adevarul.ro,0,0,2,2,0.0,0.0
monarh,adevarul.ro,1,0,0,1,1.0,1.0
prinț Nicolae,adevarul.ro,0,0,1,1,0.0,0.0
regelui,adevarul.ro,0,0,1,1,0.0,0.0
Ana,adevarul.ro,0,0,1,1,0.0,0.0
revoluționar,adevarul.ro,0,2,2,4,-0.5,0.5
suită,adevarul.ro,0,1,0,1,-1.0,1.0
înaintaș,adevarul.ro,0,0,1,1,0.0,0.0
Andrei Marga,www.gandul.ro,0,0,2,2,0.0,0.0
Beijing,www.gandul.ro,0,0,1,1,0.0,0.0
Marga,www.gandul.ro,0,0,3,3,0.0,0.0
Cristian Matei,www.luju.ro,0,0,1,1,0.0,0.0
Florin Postoaca,www.luju.ro,0,0,1,1,0.0,0.0
Gabriela Vasile,www.luju.ro,0,0,1,1,0.0,0.0
Gheorghe Postoaca,www.luju.ro,0,0,1,1,0.0,0.0
Ioana Băsescu,www.luju.ro,0,0,1,1,0.0,0.0
notarită,www.luju.ro,0,0,1,1,0.0,0.0
patron,www.luju.ro,0,3,0,3,-1.0,1.0
colegiu,observatornews.ro,2,0,0,2,1.0,1.0
Cristian Lulea,www.comisarul.ro,0,1,0,1,-1.0,1.0
Marian Cucșa,www.comisarul.ro,0,2,0,2,-1.0,1.0
Reuven Azar,www.comisarul.ro,0,0,2,2,0.0,0.0
Barna,www.g4media.ro,0,0,1,1,0.0,0.0
Ceaușescu,www.antena3.ro,0,2,1,3,-0.6666666666666666,0.6666666666666666
Emil Constantinescu,www.antena3.ro,1,0,2,3,0.3333333333333333,0.3333333333333333
Gheorghe Gheorghiu-Dej,www.antena3.ro,0,0,1,1,0.0,0.0
Ion Iliescu,www.antena3.ro,0,0,3,3,0.0,0.0
Nicolae Ceaușescu,www.antena3.ro,0,0,1,1,0.0,0.0
Traian Băsesci,www.antena3.ro,0,0,1,1,0.0,0.0
Bogdan Zaharia,www.cotidianul.ro,0,0,1,1,0.0,0.0
Cosmin Man,www.cotidianul.ro,0,0,1,1,0.0,0.0
Cristian Pop,www.cotidianul.ro,0,0,1,1,0.0,0.0
Dana Crișan,www.cotidianul.ro,0,0,1,1,0.0,0.0
Flaviu Ciortea,www.cotidianul.ro,0,0,1,1,0.0,0.0
Monica Băgărean,www.cotidianul.ro,0,0,1,1,0.0,0.0
Paul Barbur,www.cotidianul.ro,0,0,1,1,0.0,0.0
Sălaj,www.cotidianul.ro,0,0,1,1,0.0,0.0
Viorel Mihiș,www.cotidianul.ro,0,0,1,1,0.0,0.0
absolvent,www.cotidianul.ro,0,0,1,1,0.0,0.0
antreprenor,www.cotidianul.ro,0,0,1,1,0.0,0.0
inginer,www.cotidianul.ro,0,0,1,1,0.0,0.0
Dan Cherecheș,www.cotidianul.ro,0,0,1,1,0.0,0.0
Șimleu Silvaniei,www.cotidianul.ro,0,0,1,1,0.0,0.0
Alex Velea,www.digi24.ro,0,0,1,1,0.0,0.0
Aurel Tămaș,www.digi24.ro,0,0,1,1,0.0,0.0
Peștera,www.digi24.ro,0,0,1,1,0.0,0.0
Valentin Vrabie,www.digi24.ro,0,1,1,2,-0.5,0.5
copreședinte,www.romaniatv.net,0,0,3,3,0.0,0.0
Toader,www.digi24.ro,0,0,1,1,0.0,0.0
Tudorel Toader,www.digi24.ro,0,0,1,1,0.0,0.0
invitat,adevarul.ro,0,0,8,8,0.0,0.0
avocat,www.g4media.ro,1,0,6,7,0.14285714285714285,0.14285714285714285
Isaccea,www.g4media.ro,0,0,1,1,0.0,0.0
Poporul,www.g4media.ro,1,0,0,1,1.0,1.0
antreprenor,www.g4media.ro,1,1,2,4,0.0,0.0
dv,www.g4media.ro,0,1,0,1,-1.0,1.0
personal,www.g4media.ro,0,3,6,9,-0.3333333333333333,0.3333333333333333
Marian Munteanu,www.activenews.ro,0,1,1,2,-0.5,0.5
Donald Tusk,www.euronews.ro,0,0,3,3,0.0,0.0
Maia Sandu,www.euronews.ro,0,0,4,4,0.0,0.0
Mark Rutte,www.euronews.ro,0,0,2,2,0.0,0.0
Roberta Metsola,www.euronews.ro,0,0,2,2,0.0,0.0
Rutte,www.euronews.ro,1,0,1,2,0.5,0.5
Cristian Seidler,www.cotidianul.ro,0,0,1,1,0.0,0.0
Luminița Odobescu,www.cotidianul.ro,0,1,0,1,-1.0,1.0
Marea Britanie,www.cotidianul.ro,0,1,2,3,-0.3333333333333333,0.3333333333333333
Președintele,www.cotidianul.ro,0,1,2,3,-0.3333333333333333,0.3333333333333333
Watford,www.cotidianul.ro,0,0,1,1,0.0,0.0
coordonator,www.cotidianul.ro,0,0,1,1,0.0,0.0
Liliana,a1.ro,0,0,3,3,0.0,0.0
Mama,a1.ro,1,0,0,1,1.0,1.0
Mihai Gâdea,a1.ro,0,0,1,1,0.0,0.0
Mirabelei Grădinaru,a1.ro,0,0,1,1,0.0,0.0
nepot,a1.ro,0,0,2,2,0.0,0.0
Eugen Tomac,www.gandul.ro,0,0,1,1,0.0,0.0
localnic,www.gandul.ro,0,1,0,1,-1.0,1.0
Anca Nițulescu,pressone.ro,0,2,0,2,-1.0,1.0
Ancăi Nițulescu,pressone.ro,0,0,1,1,0.0,0.0
arhitect,pressone.ro,0,0,2,2,0.0,0.0
Bill Gates,pressone.ro,0,1,0,1,-1.0,1.0
Cristian Tabără,pressone.ro,0,0,1,1,0.0,0.0
Damian Baciu,pressone.ro,0,0,1,1,0.0,0.0
doctoriță,pressone.ro,0,0,1,1,0.0,0.0
Gheorghe Borcea,pressone.ro,0,0,1,1,0.0,0.0
Hristos,pressone.ro,1,1,0,2,0.0,0.0
Leon Zăgrean,pressone.ro,2,0,3,5,0.4,0.4
Lui,pressone.ro,0,0,1,1,0.0,0.0
Mihaela Secară,pressone.ro,0,1,1,2,-0.5,0.5
pediatru,pressone.ro,1,0,0,1,1.0,1.0
Zăgrean,pressone.ro,0,0,1,1,0.0,0.0
Sorin Muncaciu,pressone.ro,0,0,1,1,0.0,0.0
Gheorghe Borcean,pressone.ro,0,0,1,1,0.0,0.0
legist,pressone.ro,0,1,0,1,-1.0,1.0
opozant,pressone.ro,0,2,1,3,-0.6666666666666666,0.6666666666666666
George Maior,www.mediafax.ro,1,0,1,2,0.5,0.5
Radu Timofte,www.mediafax.ro,1,0,0,1,1.0,1.0
ofițer,www.mediafax.ro,1,0,0,1,1.0,1.0
Berlin,stirileprotv.ro,0,0,2,2,0.0,0.0
Portugalia,stirileprotv.ro,0,0,1,1,0.0,0.0
Spania,stirileprotv.ro,0,0,1,1,0.0,0.0
Van Rompuy,stirileprotv.ro,0,0,1,1,0.0,0.0
agricultor,stirileprotv.ro,0,1,0,1,-1.0,1.0
dumneavoastră,stirileprotv.ro,1,0,1,2,0.5,0.5
reprezentantilor,stirileprotv.ro,0,0,1,1,0.0,0.0
afacerist admirator,www.comisarul.ro,0,1,0,1,-1.0,1.0
concurent,www.comisarul.ro,0,0,1,1,0.0,0.0
bărbat,www.euronews.ro,0,3,6,9,-0.3333333333333333,0.3333333333333333
Alex Jones,www.activenews.ro,0,1,0,1,-1.0,1.0
Kathleen Kavalec,www.activenews.ro,0,0,1,1,0.0,0.0
amiral,www.activenews.ro,0,0,2,2,0.0,0.0
Antony Blinken,www.activenews.ro,0,1,0,1,-1.0,1.0
Augustin Zegrean,www.activenews.ro,1,0,0,1,1.0,1.0
Bauer,www.activenews.ro,0,0,1,1,0.0,0.0
Belgia,www.activenews.ro,0,0,1,1,0.0,0.0
Luxemburg,www.activenews.ro,0,0,1,1,0.0,0.0
Macedonia de Nord,www.activenews.ro,0,0,1,1,0.0,0.0
Mario Nawfal,www.activenews.ro,0,0,1,1,0.0,0.0
Polonia,www.activenews.ro,1,0,3,4,0.25,0.25
Portugalia,www.activenews.ro,0,0,1,1,0.0,0.0
Rob Bauer,www.activenews.ro,0,0,1,1,0.0,0.0
Snoop,www.activenews.ro,0,0,2,2,0.0,0.0
Statele Unite,www.activenews.ro,0,2,4,6,-0.3333333333333333,0.3333333333333333
Victor Gaetan,www.activenews.ro,0,0,1,1,0.0,0.0
abonat,www.activenews.ro,0,0,1,1,0.0,0.0
Ion Țiriac,www.activenews.ro,0,0,1,1,0.0,0.0
reporter,www.activenews.ro,0,1,2,3,-0.3333333333333333,0.3333333333333333
secretar de stat,www.activenews.ro,0,1,1,2,-0.5,0.5
soldat,www.activenews.ro,0,0,1,1,0.0,0.0
telespectator,www.activenews.ro,0,0,2,2,0.0,0.0
pemiu,www.news.ro,0,0,1,1,0.0,0.0
Andrei Caramitru,www.romaniatv.net,0,0,1,1,0.0,0.0
susținătoare,adevarul.ro,1,0,1,2,0.5,0.5
Cătălin Cîrstoiu,www.b1tv.ro,0,0,1,1,0.0,0.0
Daniel Fenechiu,www.b1tv.ro,0,0,3,3,0.0,0.0
Fenechiu,www.b1tv.ro,0,0,1,1,0.0,0.0
Mihai Tudose,www.b1tv.ro,0,0,1,1,0.0,0.0
moderator,www.b1tv.ro,0,0,2,2,0.0,0.0
șefă,www.b1tv.ro,0,0,2,2,0.0,0.0
Elena Dumitru,www.luju.ro,0,1,1,2,-0.5,0.5
Alina Gorghiu,www.cotidianul.ro,0,0,3,3,0.0,0.0
Dan Nica,www.cotidianul.ro,0,0,1,1,0.0,0.0
Gorghiu,www.cotidianul.ro,0,2,1,3,-0.6666666666666666,0.6666666666666666
Costa Rica,stirileprotv.ro,0,0,1,1,0.0,0.0
Florian Coldea,stirileprotv.ro,0,1,0,1,-1.0,1.0
Veronel Rădulescu,stirileprotv.ro,0,0,1,1,0.0,0.0
victimă,stirileprotv.ro,0,1,0,1,-1.0,1.0
elev,agerpres.ro,0,0,1,1,0.0,0.0
secretar executiv,agerpres.ro,0,0,1,1,0.0,0.0
Mureș,www.comisarul.ro,0,0,2,2,0.0,0.0
Ținut Secuiesc,www.comisarul.ro,0,0,1,1,0.0,0.0
Codrin Ștefănescu,stirileprotv.ro,0,1,1,2,-0.5,0.5
vinovat,stirileprotv.ro,0,1,0,1,-1.0,1.0
Ioan Popa,observatornews.ro,0,0,1,1,0.0,0.0
Ioan Rus,observatornews.ro,0,0,1,1,0.0,0.0
Teleac,observatornews.ro,0,0,1,1,0.0,0.0
Vasile Dâncu,observatornews.ro,0,0,1,1,0.0,0.0
Virgil Ardelean,observatornews.ro,0,0,1,1,0.0,0.0
Liviu Chirica,recorder.ro,0,0,1,1,0.0,0.0
câștigător,recorder.ro,2,1,1,4,0.25,0.25
Cristian Preda,recorder.ro,0,0,4,4,0.0,0.0
Ionaș Vladimir,adevarul.ro,0,1,2,3,-0.3333333333333333,0.3333333333333333
Moșteanu,www.euronews.ro,0,0,1,1,0.0,0.0
Ghita,www.comisarul.ro,0,1,0,1,-1.0,1.0
Hrebenciuc,www.comisarul.ro,0,1,0,1,-1.0,1.0
Alin Teodorescu,www.comisarul.ro,0,0,3,3,0.0,0.0
Teodorescu,www.comisarul.ro,0,0,1,1,0.0,0.0
pesedist,www.comisarul.ro,0,1,0,1,-1.0,1.0
prietene,www.comisarul.ro,0,0,1,1,0.0,0.0
Kelemen Hunor,agerpres.ro,0,0,3,3,0.0,0.0
Orban,agerpres.ro,0,0,1,1,0.0,0.0
Viktor Orbán,agerpres.ro,0,0,1,1,0.0,0.0
Viktor Orban,agerpres.ro,0,0,1,1,0.0,0.0
Alexandru Muraru,www.news.ro,0,0,3,3,0.0,0.0
Muraru,www.news.ro,0,1,0,1,-1.0,1.0
liberal,www.news.ro,0,5,1,6,-0.8333333333333334,0.8333333333333334
cititor,www.b1tv.ro,0,0,1,1,0.0,0.0
Avram Iancu,www.comisarul.ro,0,0,1,1,0.0,0.0
Bela,www.comisarul.ro,0,1,0,1,-1.0,1.0
Bela Kohn,www.comisarul.ro,0,1,0,1,-1.0,1.0
Băile Tușnad,www.comisarul.ro,0,0,1,1,0.0,0.0
Mihai Târnoveanu,www.comisarul.ro,0,0,1,1,0.0,0.0
Gabriel Andreescu,www.comisarul.ro,0,0,1,1,0.0,0.0
Miklós Horthy,www.comisarul.ro,0,1,0,1,-1.0,1.0
Imperiul Austriac,www.comisarul.ro,0,0,1,1,0.0,0.0
Kossuth,www.comisarul.ro,0,0,1,1,0.0,0.0
Laszlo Tokes,www.comisarul.ro,0,0,1,1,0.0,0.0
Markel,www.comisarul.ro,0,0,1,1,0.0,0.0
Mihai Sora,www.comisarul.ro,0,0,1,1,0.0,0.0
Smarandei Enache,www.comisarul.ro,0,0,1,1,0.0,0.0
Stalin,www.comisarul.ro,0,1,1,2,-0.5,0.5
Ursula,www.comisarul.ro,0,1,0,1,-1.0,1.0
imperialist,www.comisarul.ro,0,1,0,1,-1.0,1.0
revoluționar,www.comisarul.ro,0,0,1,1,0.0,0.0
tovarăș,www.comisarul.ro,0,2,0,2,-1.0,1.0
Calimanești,a1.ro,0,0,1,1,0.0,0.0
Sandu,a1.ro,0,1,0,1,-1.0,1.0
Belgorod,primanews.ro,0,0,2,2,0.0,0.0
Vyacheslav Gladkov,primanews.ro,0,0,1,1,0.0,0.0
paramedic,primanews.ro,0,0,1,1,0.0,0.0
rănit,primanews.ro,0,0,1,1,0.0,0.0
Cristian Terheș,www.realitatea.net,0,0,4,4,0.0,0.0
Daniel Funeriu,www.realitatea.net,0,0,2,2,0.0,0.0
Lavinia Șandru,www.realitatea.net,0,0,2,2,0.0,0.0
actorii,www.realitatea.net,0,0,1,1,0.0,0.0
prezidențiabil,www.realitatea.net,0,0,1,1,0.0,0.0
Halep,stirileprotv.ro,0,1,0,1,-1.0,1.0
Harabagiu,stirileprotv.ro,0,1,0,1,-1.0,1.0
Liviu,stirileprotv.ro,0,1,0,1,-1.0,1.0
pesedist,stirileprotv.ro,0,1,0,1,-1.0,1.0
universitar,stirileprotv.ro,0,0,1,1,0.0,0.0
Carmen Dan,snoop.ro,0,0,1,1,0.0,0.0
Dragnea,snoop.ro,0,1,1,2,-0.5,0.5
Liviu Dragnea,snoop.ro,0,1,1,2,-0.5,0.5
Septimius Pârvu,snoop.ro,0,0,1,1,0.0,0.0
Viorica Dăncilă,snoop.ro,0,0,3,3,0.0,0.0
Alexandru Mironov,adevarul.ro,0,0,1,1,0.0,0.0
Gelu Voican Voiculescu,adevarul.ro,0,2,0,2,-1.0,1.0
Mironov,adevarul.ro,0,0,1,1,0.0,0.0
Tineret,adevarul.ro,0,0,1,1,0.0,0.0
Ioan Savu,adevarul.ro,0,0,1,1,0.0,0.0
scriitor,adevarul.ro,0,2,2,4,-0.5,0.5
Cazanciuc,www.gandul.ro,0,0,3,3,0.0,0.0
Daniel Suciu,www.gandul.ro,0,0,4,4,0.0,0.0
Robert Cazanciuc,www.gandul.ro,0,0,5,5,0.0,0.0
consumator,www.mediafax.ro,0,0,2,2,0.0,0.0
Marius Lulea,www.realitatea.net,0,0,1,1,0.0,0.0
Ana Mohr,pressone.ro,0,0,2,2,0.0,0.0
Cristian Băcanu,pressone.ro,0,0,2,2,0.0,0.0
parcagiu,pressone.ro,0,6,1,7,-0.8571428571428571,0.8571428571428571
Răzvan Popa,pressone.ro,0,0,1,1,0.0,0.0
Uniunea,pressone.ro,0,4,1,5,-0.8,0.8
avocatul Băcanu,pressone.ro,0,0,1,1,0.0,0.0
cerșetor,pressone.ro,0,2,0,2,-1.0,1.0
exploatator,pressone.ro,0,1,0,1,-1.0,1.0
făptaș,pressone.ro,0,1,0,1,-1.0,1.0
făptuitor,pressone.ro,0,2,0,2,-1.0,1.0
nenorocit,pressone.ro,0,1,0,1,-1.0,1.0
Mircea Kivu,pressone.ro,0,0,1,1,0.0,0.0
Alexandru Rafila,www.digi24.ro,0,0,2,2,0.0,0.0
Cătălin Drulă,www.digi24.ro,0,0,4,4,0.0,0.0
Drulă,www.digi24.ro,0,0,1,1,0.0,0.0
Rafila,www.digi24.ro,0,0,1,1,0.0,0.0
Președintele României,adevarul.ro,0,0,2,2,0.0,0.0
Lulea,www.romaniatv.net,0,0,1,1,0.0,0.0
strămoș,www.romaniatv.net,1,0,0,1,1.0,1.0
Ciuperceni,www.euronews.ro,0,0,1,1,0.0,0.0
Claudiu Dragotă,www.euronews.ro,0,0,1,1,0.0,0.0
Harris,www.euronews.ro,0,0,1,1,0.0,0.0
Ion Iordache,www.euronews.ro,0,0,1,1,0.0,0.0
Iulian Popescu,www.euronews.ro,0,0,1,1,0.0,0.0
protagonist,www.euronews.ro,0,0,1,1,0.0,0.0
călător,www.euronews.ro,0,0,1,1,0.0,0.0
elită,www.mediafax.ro,0,1,0,1,-1.0,1.0
amator,www.activenews.ro,0,1,0,1,-1.0,1.0
Mirel Curea,www.activenews.ro,0,0,1,1,0.0,0.0
liberal,www.activenews.ro,0,1,1,2,-0.5,0.5
manelist,www.activenews.ro,0,1,0,1,-1.0,1.0
Dumitru Coarnă,www.realitatea.net,0,1,0,1,-1.0,1.0
Gheorghe Piperea,www.comisarul.ro,0,0,2,2,0.0,0.0
Corneliu Tudor,stirileprotv.ro,0,0,1,1,0.0,0.0
beneficiar,stirileprotv.ro,0,0,2,2,0.0,0.0
premiu,stirileprotv.ro,0,0,1,1,0.0,0.0
Andrei Pleșu,adevarul.ro,0,0,1,1,0.0,0.0
eseist,adevarul.ro,0,1,0,1,-1.0,1.0
Pleșu,adevarul.ro,0,0,1,1,0.0,0.0
critic,adevarul.ro,0,2,0,2,-1.0,1.0
Ben-Oni Ardelean,www.activenews.ro,1,0,0,1,1.0,1.0
Ben Oni Ardelean,www.activenews.ro,0,0,1,1,0.0,0.0
Csaba Astalosz,www.activenews.ro,0,0,1,1,0.0,0.0
Ilfov,www.activenews.ro,0,0,2,2,0.0,0.0
Adrian Nastase,adevarul.ro,0,1,3,4,-0.25,0.25
observator,www.g4media.ro,0,0,1,1,0.0,0.0
secretar executiv,www.g4media.ro,0,0,1,1,0.0,0.0
Bronislaw Komorowski,a1.ro,0,0,1,1,0.0,0.0
Capi,a1.ro,0,1,0,1,-1.0,1.0
Dan Diaconescu,a1.ro,0,0,2,2,0.0,0.0
Magda Ciumac,a1.ro,0,1,0,1,-1.0,1.0
Oana Zăvoranu,a1.ro,0,0,1,1,0.0,0.0
Tolea,a1.ro,0,1,0,1,-1.0,1.0
manelist,a1.ro,0,1,0,1,-1.0,1.0
seful,a1.ro,0,2,0,2,-1.0,1.0
Eugen Tomac,www.b1tv.ro,0,1,1,2,-0.5,0.5
Sinaia,www.b1tv.ro,0,0,1,1,0.0,0.0
Tomac,www.b1tv.ro,0,0,2,2,0.0,0.0
Craiovei,www.comisarul.ro,0,0,4,4,0.0,0.0
Adriana Botorogeanu,recorder.ro,0,1,0,1,-1.0,1.0
Botorogeanu,recorder.ro,0,1,0,1,-1.0,1.0
Cristinel Dăncilă,recorder.ro,0,0,1,1,0.0,0.0
Kiseleff,recorder.ro,0,0,1,1,0.0,0.0
Petre Pitiș,recorder.ro,0,1,0,1,-1.0,1.0
Sevil Shhaideh,recorder.ro,0,0,1,1,0.0,0.0
Videle,recorder.ro,0,0,1,1,0.0,0.0
Frans Timmermans,recorder.ro,0,1,0,1,-1.0,1.0
Giurgiu,www.antena3.ro,0,0,2,2,0.0,0.0
Marian Mina,www.antena3.ro,0,0,2,2,0.0,0.0
Mina,www.antena3.ro,0,0,1,1,0.0,0.0
Toma Petcu,www.antena3.ro,0,0,1,1,0.0,0.0
Asla,adevarul.ro,0,1,0,1,-1.0,1.0
Dunprea,adevarul.ro,0,0,1,1,0.0,0.0
Mircea Dinescu,adevarul.ro,0,4,1,5,-0.8,0.8
meșter,adevarul.ro,0,1,0,1,-1.0,1.0
poet,adevarul.ro,0,1,0,1,-1.0,1.0
prostănac,adevarul.ro,0,1,0,1,-1.0,1.0
strămoș,adevarul.ro,0,0,1,1,0.0,0.0
turișt,adevarul.ro,0,0,1,1,0.0,0.0
Darabani,recorder.ro,0,1,0,1,-1.0,1.0
Moș Crăciun,recorder.ro,0,0,1,1,0.0,0.0
Pecica,recorder.ro,0,0,1,1,0.0,0.0
Valeriu Argăseală,recorder.ro,1,0,0,1,1.0,1.0
cavaler,recorder.ro,0,1,1,2,-0.5,0.5
compatriot,recorder.ro,1,1,0,2,0.0,0.0
concurent,recorder.ro,0,1,0,1,-1.0,1.0
Vali,recorder.ro,0,1,0,1,-1.0,1.0
Vali Argăseală,recorder.ro,0,1,0,1,-1.0,1.0
olimpic,recorder.ro,0,0,1,1,0.0,0.0
reprezentanți,recorder.ro,0,0,1,1,0.0,0.0
taximetrist,recorder.ro,0,1,0,1,-1.0,1.0
Traian Băsescu,www.aktual24.ro,0,5,10,15,-0.3333333333333333,0.3333333333333333
Ariniș,adevarul.ro,0,1,0,1,-1.0,1.0
Asuaju de Sus,adevarul.ro,0,1,0,1,-1.0,1.0
Botiza,adevarul.ro,0,1,0,1,-1.0,1.0
Ieud,adevarul.ro,0,1,0,1,-1.0,1.0
Movilă Banului,adevarul.ro,0,0,1,1,0.0,0.0
Poienile Izei,adevarul.ro,0,1,0,1,-1.0,1.0
Râmnicu Sărat,adevarul.ro,0,0,1,1,0.0,0.0
Sarasău,adevarul.ro,0,1,0,1,-1.0,1.0
Scorțoasa,adevarul.ro,0,0,1,1,0.0,0.0
Ulmeni,adevarul.ro,0,1,1,2,-0.5,0.5
Vernești,adevarul.ro,0,0,1,1,0.0,0.0
Vișeu de Sus,adevarul.ro,0,1,0,1,-1.0,1.0
Șomcuta Mare,adevarul.ro,0,1,0,1,-1.0,1.0
cumpărător,www.aktual24.ro,0,3,0,3,-1.0,1.0
cavaler,primanews.ro,0,0,1,1,0.0,0.0
Cristina Neagu,primanews.ro,1,0,0,1,1.0,1.0
handbalistă,primanews.ro,1,0,0,1,1.0,1.0
jucătoare,primanews.ro,1,0,0,1,1.0,1.0
marcator,primanews.ro,1,0,0,1,1.0,1.0
Mesia,www.digi24.ro,1,0,0,1,1.0,1.0
beneficiar,www.digi24.ro,0,2,1,3,-0.6666666666666666,0.6666666666666666
guvern,www.cotidianul.ro,0,1,0,1,-1.0,1.0
antreprenor,www.mediafax.ro,1,0,0,1,1.0,1.0
SOCANT,www.luju.ro,0,1,0,1,-1.0,1.0
cofondator,recorder.ro,0,0,1,1,0.0,0.0
organizator,recorder.ro,0,1,1,2,-0.5,0.5
Marco Rubio,stirileprotv.ro,0,0,1,1,0.0,0.0
Rubio,stirileprotv.ro,0,0,1,1,0.0,0.0
colegă,www.gandul.ro,0,0,1,1,0.0,0.0
Spania,www.digi24.ro,1,0,1,2,0.5,0.5
bugetar,www.digi24.ro,0,2,0,2,-1.0,1.0
Biden,www.aktual24.ro,0,0,1,1,0.0,0.0
Dinescu,adevarul.ro,0,2,1,3,-0.6666666666666666,0.6666666666666666
Claudiu Târziu,www.news.ro,0,0,4,4,0.0,0.0
Claudiu Tîrziu,www.news.ro,0,0,1,1,0.0,0.0
Slănic Moldova,www.news.ro,0,0,1,1,0.0,0.0
Târziu,www.news.ro,0,1,0,1,-1.0,1.0
Alexandru Rafila,www.euronews.ro,0,0,2,2,0.0,0.0
Attila Cseke,www.euronews.ro,0,0,4,4,0.0,0.0
Daniel David,www.euronews.ro,1,0,6,7,0.14285714285714285,0.14285714285714285
Emil Hurezeanu,www.euronews.ro,0,1,1,2,-0.5,0.5
Florin Barbu,www.euronews.ro,0,0,2,2,0.0,0.0
Marcel Boloș,www.euronews.ro,0,0,2,2,0.0,0.0
Marian Neacșu,www.euronews.ro,0,0,1,1,0.0,0.0
Mircea Fechet,www.euronews.ro,0,0,2,2,0.0,0.0
Natalia Intotero,www.euronews.ro,0,0,3,3,0.0,0.0
Radu Marinescu,www.euronews.ro,0,0,3,3,0.0,0.0
Radu Oprea,www.euronews.ro,0,0,2,2,0.0,0.0
Dorobanți,a1.ro,0,0,1,1,0.0,0.0
cunoscător,a1.ro,0,0,1,1,0.0,0.0
internat,a1.ro,0,4,2,6,-0.6666666666666666,0.6666666666666666
stilist,a1.ro,1,0,0,1,1.0,1.0
utilizator,a1.ro,0,0,2,2,0.0,0.0
Cristian Hagi,www.comisarul.ro,0,0,1,1,0.0,0.0
filosof,www.comisarul.ro,0,0,1,1,0.0,0.0
Petre Țuțea,www.comisarul.ro,0,0,1,1,0.0,0.0
Traian Caius Dragomir,adevarul.ro,0,0,1,1,0.0,0.0
Constantin Mugurel Isărescu,adevarul.ro,0,0,1,1,0.0,0.0
Gheorghe Funar,adevarul.ro,0,0,1,1,0.0,0.0
György Frunda,adevarul.ro,0,0,1,1,0.0,0.0
Ilie,adevarul.ro,0,0,1,1,0.0,0.0
Ion Rațiu,adevarul.ro,0,0,1,1,0.0,0.0
Marko Bela,adevarul.ro,0,0,1,1,0.0,0.0
PLR,adevarul.ro,0,0,1,1,0.0,0.0
Popescu,adevarul.ro,0,3,3,6,-0.5,0.5
Radu Câmpeanu,adevarul.ro,0,0,1,1,0.0,0.0
Santa,adevarul.ro,0,0,1,1,0.0,0.0
Theodor Stolojan,adevarul.ro,0,0,3,3,0.0,0.0
Vasile,adevarul.ro,0,0,1,1,0.0,0.0
Werner,adevarul.ro,0,0,1,1,0.0,0.0
Robert Santa,adevarul.ro,0,0,4,4,0.0,0.0
Cristian Pîrvulescu,www.gandul.ro,0,0,3,3,0.0,0.0
Doritor,www.gandul.ro,0,0,1,1,0.0,0.0
Raluca Turcan,www.gandul.ro,1,1,1,3,0.0,0.0
Sinaia,www.gandul.ro,0,0,1,1,0.0,0.0
aleș,stirileprotv.ro,0,1,1,2,-0.5,0.5
Bucureștean,stirileprotv.ro,0,0,1,1,0.0,0.0
Alexandru Florian,www.g4media.ro,0,0,1,1,0.0,0.0
Constantin,www.g4media.ro,0,1,0,1,-1.0,1.0
Cristian Darie,www.g4media.ro,0,0,1,1,0.0,0.0
Cristinel Dragomir,www.g4media.ro,0,0,1,1,0.0,0.0
Cupșa,www.g4media.ro,0,0,1,1,0.0,0.0
Felix Stroe,www.g4media.ro,0,1,1,2,-0.5,0.5
Ionuț Galani,www.g4media.ro,0,0,1,1,0.0,0.0
Mohammad Murad,www.g4media.ro,0,0,2,2,0.0,0.0
Murad,www.g4media.ro,0,0,2,2,0.0,0.0
Nicolae Matei,www.g4media.ro,0,1,0,1,-1.0,1.0
Nicolae Voiculeț,www.g4media.ro,0,1,0,1,-1.0,1.0
Nicușor Constantinescu,www.g4media.ro,0,1,0,1,-1.0,1.0
Năvodariu,www.g4media.ro,0,0,1,1,0.0,0.0
organizator,www.g4media.ro,0,0,5,5,0.0,0.0
Ovidiu Cupșa,www.g4media.ro,0,1,1,2,-0.5,0.5
Pindu,www.g4media.ro,0,0,1,1,0.0,0.0
Radu Mazăre,www.g4media.ro,0,1,0,1,-1.0,1.0
Ramona Ioana Bruynseels,www.g4media.ro,0,1,0,1,-1.0,1.0
Silviu Vexler,www.g4media.ro,0,1,0,1,-1.0,1.0
Sorin Lucian Ionescu,www.g4media.ro,0,1,0,1,-1.0,1.0
Sorin Strutinsky,www.g4media.ro,0,1,0,1,-1.0,1.0
Vergil Chițac,www.g4media.ro,0,1,0,1,-1.0,1.0
Voiculeț,www.g4media.ro,0,1,0,1,-1.0,1.0
adjunct,www.g4media.ro,0,1,0,1,-1.0,1.0
artist,www.g4media.ro,0,0,4,4,0.0,0.0
ca,www.g4media.ro,0,1,0,1,-1.0,1.0
colaborator,www.g4media.ro,0,1,1,2,-0.5,0.5
gazdele,www.g4media.ro,0,1,0,1,-1.0,1.0
invitat,www.g4media.ro,0,0,2,2,0.0,0.0
jandarm,www.g4media.ro,0,0,1,1,0.0,0.0
marinar,www.g4media.ro,0,0,1,1,0.0,0.0
moderatoare,www.g4media.ro,0,1,0,1,-1.0,1.0
Teodosie,www.g4media.ro,0,2,2,4,-0.5,0.5
Galați,www.g4media.ro,0,1,2,3,-0.3333333333333333,0.3333333333333333
Coroiești,adevarul.ro,0,0,1,1,0.0,0.0
Covasna,adevarul.ro,0,1,1,2,-0.5,0.5
Călărași,adevarul.ro,0,0,1,1,0.0,0.0
Ialomița,adevarul.ro,0,0,1,1,0.0,0.0
Scornicești,adevarul.ro,0,0,1,1,0.0,0.0
Slatina,adevarul.ro,0,1,1,2,-0.5,0.5
Suceava,adevarul.ro,0,0,3,3,0.0,0.0
Antony Blinken,www.news.ro,0,0,1,1,0.0,0.0
Augustin Zegrean,www.news.ro,0,0,2,2,0.0,0.0
deținător,www.news.ro,1,0,1,2,0.5,0.5
Georgia,www.news.ro,0,0,1,1,0.0,0.0
Malta,www.news.ro,0,0,1,1,0.0,0.0
Matthew Miller,www.news.ro,0,0,1,1,0.0,0.0
Moldova,www.news.ro,1,1,2,4,0.0,0.0
Sergei Lavrov,www.news.ro,0,1,0,1,-1.0,1.0
Terheș,www.news.ro,0,0,1,1,0.0,0.0
Toni Grebă,www.news.ro,0,0,1,1,0.0,0.0
Tudorel Toader,www.news.ro,0,0,2,2,0.0,0.0
Victor Orbán,www.news.ro,0,1,0,1,-1.0,1.0
fată,www.news.ro,0,1,0,1,-1.0,1.0
programator,www.news.ro,0,0,1,1,0.0,0.0
ul,www.news.ro,0,1,0,1,-1.0,1.0
utilizator,www.news.ro,0,0,3,3,0.0,0.0
Barna,www.gandul.ro,0,0,1,1,0.0,0.0
cioloș,www.gandul.ro,0,0,1,1,0.0,0.0
Dacian Cioloș,www.gandul.ro,0,1,4,5,-0.2,0.2
repondenților,www.antena3.ro,0,0,1,1,0.0,0.0
Brătianu,pressone.ro,0,1,0,1,-1.0,1.0
Marian Petrache,pressone.ro,0,1,1,2,-0.5,0.5
Mickey Mouse,pressone.ro,0,0,1,1,0.0,0.0
blond,pressone.ro,0,0,1,1,0.0,0.0
căpetenie,pressone.ro,0,1,0,1,-1.0,1.0
luptător,pressone.ro,2,1,1,4,0.25,0.25
manifestant,pressone.ro,0,2,0,2,-1.0,1.0
staroste,pressone.ro,0,1,0,1,-1.0,1.0
Alin Tișe,primanews.ro,0,0,1,1,0.0,0.0
Ciprian Aron,primanews.ro,0,0,3,3,0.0,0.0
Tișe,primanews.ro,0,0,1,1,0.0,0.0
Antonie Solomon,a1.ro,0,1,1,2,-0.5,0.5
Chiliman,a1.ro,0,0,1,1,0.0,0.0
Cornel Penescu,a1.ro,0,0,2,2,0.0,0.0
Craiovei,a1.ro,0,0,2,2,0.0,0.0
Solomon,a1.ro,0,1,1,2,-0.5,0.5
finanțator,a1.ro,0,0,1,1,0.0,0.0
jucător,a1.ro,0,0,4,4,0.0,0.0
liberal,a1.ro,0,0,3,3,0.0,0.0
Diana Ivanovici Șoșoacă,a1.ro,0,5,0,5,-1.0,1.0
Focșani,a1.ro,0,0,1,1,0.0,0.0
ștefăniță,a1.ro,0,0,1,1,0.0,0.0
Udrea,www.digi24.ro,1,0,0,1,1.0,1.0
comandant,www.digi24.ro,0,1,0,1,-1.0,1.0
Alina Manolescu,www.euronews.ro,0,0,1,1,0.0,0.0
Adrian Lazar,www.luju.ro,0,0,1,1,0.0,0.0
Beatrice Mirea,www.luju.ro,0,0,1,1,0.0,0.0
Bogdan Curteanu,www.luju.ro,0,0,1,1,0.0,0.0
Corina Panzaru,www.luju.ro,0,0,1,1,0.0,0.0
Doru Petrescu,www.luju.ro,0,0,2,2,0.0,0.0
Ion Duvac,www.luju.ro,0,0,1,1,0.0,0.0
Razvan Ziemba,www.luju.ro,0,0,1,1,0.0,0.0
Silviu Ispas,www.luju.ro,0,0,1,1,0.0,0.0
cadru militar,www.luju.ro,1,0,0,1,1.0,1.0
ofiter,www.luju.ro,0,5,4,9,-0.5555555555555556,0.5555555555555556
senior,www.luju.ro,0,0,1,1,0.0,0.0
fermier,agerpres.ro,2,0,2,4,0.5,0.5
Mihaela Dicu,agerpres.ro,0,0,2,2,0.0,0.0
David Simona,stirileprotv.ro,0,0,1,1,0.0,0.0
Dolj,stirileprotv.ro,0,0,1,1,0.0,0.0
Dumitrescu,stirileprotv.ro,0,1,0,1,-1.0,1.0
Florin Iordache,stirileprotv.ro,0,2,1,3,-0.6666666666666666,0.6666666666666666
Mihail Fâcă,stirileprotv.ro,0,0,1,1,0.0,0.0
Galați,stirileprotv.ro,0,0,2,2,0.0,0.0
George Lazăr,stirileprotv.ro,0,0,1,1,0.0,0.0
Ionuț Stroe,stirileprotv.ro,0,0,4,4,0.0,0.0
Iulian Dumitrescu,stirileprotv.ro,0,1,0,1,-1.0,1.0
Laurențiu Leoreanu,stirileprotv.ro,0,0,1,1,0.0,0.0
Mircea Roșca,stirileprotv.ro,0,2,0,2,-1.0,1.0
Mureș,stirileprotv.ro,0,0,3,3,0.0,0.0
Neamț,stirileprotv.ro,0,0,2,2,0.0,0.0
Prahova,stirileprotv.ro,0,0,2,2,0.0,0.0
Roșca,stirileprotv.ro,0,1,0,1,-1.0,1.0
Semcu Adrian Emanuil,stirileprotv.ro,0,0,1,1,0.0,0.0
Stroe,stirileprotv.ro,0,0,2,2,0.0,0.0
Adrian Strâmbeanu,stirileprotv.ro,0,0,1,1,0.0,0.0
fief,stirileprotv.ro,0,0,1,1,0.0,0.0
inculpat,stirileprotv.ro,0,1,1,2,-0.5,0.5
inculpatul Rotilă Adrian,stirileprotv.ro,0,1,0,1,-1.0,1.0
succesor,stirileprotv.ro,0,0,1,1,0.0,0.0
văr,stirileprotv.ro,0,1,0,1,-1.0,1.0
Kiss,www.digi24.ro,0,0,1,1,0.0,0.0
Rotaru,www.digi24.ro,0,0,1,1,0.0,0.0
salvator,www.euronews.ro,1,1,1,3,0.0,0.0
Giorgia Meloni,www.aktual24.ro,0,1,1,2,-0.5,0.5
Lindsey Graham,www.aktual24.ro,0,0,2,2,0.0,0.0
Merz,www.aktual24.ro,0,0,3,3,0.0,0.0
Libia,www.euronews.ro,0,0,2,2,0.0,0.0
observator,www.euronews.ro,1,0,2,3,0.3333333333333333,0.3333333333333333
Sara Aagesen,www.euronews.ro,0,0,1,1,0.0,0.0
Vladimir,www.euronews.ro,0,0,1,1,0.0,0.0
Alfred Simonis,www.romaniatv.net,0,1,1,2,-0.5,0.5
Pakistan,www.romaniatv.net,0,1,0,1,-1.0,1.0
acolit,www.romaniatv.net,0,1,0,1,-1.0,1.0
dușman,www.romaniatv.net,0,3,0,3,-1.0,1.0
guvernator,www.romaniatv.net,0,2,1,3,-0.6666666666666666,0.6666666666666666
inculpat,www.romaniatv.net,0,1,0,1,-1.0,1.0
inițiator,www.romaniatv.net,0,0,2,2,0.0,0.0
salariat,www.romaniatv.net,0,1,1,2,-0.5,0.5
salariaț,www.romaniatv.net,0,1,4,5,-0.2,0.2
semnatar,www.romaniatv.net,0,2,0,2,-1.0,1.0
senior,www.romaniatv.net,0,2,2,4,-0.5,0.5
însoțitor,www.romaniatv.net,0,1,0,1,-1.0,1.0
manifestant,www.cotidianul.ro,0,2,1,3,-0.6666666666666666,0.6666666666666666
participanți,www.cotidianul.ro,0,0,1,1,0.0,0.0
manifestanț,www.cotidianul.ro,0,0,1,1,0.0,0.0
participant,www.cotidianul.ro,0,2,1,3,-0.6666666666666666,0.6666666666666666
Eminescu,a1.ro,0,0,2,2,0.0,0.0
protestatar,a1.ro,0,1,1,2,-0.5,0.5
Cătălin Cârstoiu,primanews.ro,0,0,1,1,0.0,0.0
doctor,primanews.ro,1,0,1,2,0.5,0.5
Calarasi,a1.ro,0,0,1,1,0.0,0.0
Giroc,www.activenews.ro,0,0,1,1,0.0,0.0
Ionel Iosif Toma,www.activenews.ro,0,0,1,1,0.0,0.0
Ionel Toma,www.activenews.ro,0,1,0,1,-1.0,1.0
Marius Postelnicescu,www.activenews.ro,0,0,1,1,0.0,0.0
Timiș,www.activenews.ro,0,0,1,1,0.0,0.0
edil,www.activenews.ro,0,2,2,4,-0.5,0.5
Dan Virtosu,www.activenews.ro,0,0,1,1,0.0,0.0
Ion Diaconescu,stirileprotv.ro,0,1,0,1,-1.0,1.0
Victor Ciorbea,stirileprotv.ro,0,0,1,1,0.0,0.0
Israel,adevarul.ro,1,0,3,4,0.25,0.25
cadru medical,adevarul.ro,0,1,1,2,-0.5,0.5
cercetător,adevarul.ro,2,0,9,11,0.18181818181818182,0.18181818181818182
elev,adevarul.ro,2,0,3,5,0.4,0.4
pacient,adevarul.ro,1,1,0,2,0.0,0.0
profesionist,adevarul.ro,1,2,0,3,-0.3333333333333333,0.3333333333333333
senior,adevarul.ro,2,1,1,4,0.25,0.25
semnător,www.news.ro,0,0,1,1,0.0,0.0
Nawrocki,www.romaniatv.net,0,0,1,1,0.0,0.0
Rafal Trzaskowski,www.romaniatv.net,0,0,1,1,0.0,0.0
Sławomir Mentzen,www.romaniatv.net,0,0,1,1,0.0,0.0
Iancu de Hunedoara,www.b1tv.ro,0,0,1,1,0.0,0.0
Mahomed,www.b1tv.ro,0,0,1,1,0.0,0.0
Teleorman,www.b1tv.ro,0,0,1,1,0.0,0.0
Vedea,www.b1tv.ro,0,0,1,1,0.0,0.0
Alexandru Nechez,www.comisarul.ro,0,0,2,2,0.0,0.0
George Călin,www.comisarul.ro,0,0,3,3,0.0,0.0
George Nicușor Dan,www.comisarul.ro,0,0,2,2,0.0,0.0
Sustinatori,www.comisarul.ro,2,0,0,2,1.0,1.0
Botoșani,www.news.ro,0,0,1,1,0.0,0.0
patriot,agerpres.ro,0,1,0,1,-1.0,1.0
pilot,agerpres.ro,0,1,1,2,-0.5,0.5
câștigător,agerpres.ro,2,1,0,3,0.3333333333333333,0.3333333333333333
dansator,observatornews.ro,0,2,0,2,-1.0,1.0
Madam,www.cotidianul.ro,0,1,0,1,-1.0,1.0
Neptun,www.cotidianul.ro,0,1,0,1,-1.0,1.0
Riga,www.cotidianul.ro,0,0,1,1,0.0,0.0
dramaturg,www.cotidianul.ro,1,0,0,1,1.0,1.0
portar,www.cotidianul.ro,0,1,0,1,-1.0,1.0
înalt reprezentant,www.cotidianul.ro,0,1,0,1,-1.0,1.0
Bacău,www.aktual24.ro,0,0,1,1,0.0,0.0
șeful statului,www.aktual24.ro,0,0,3,3,0.0,0.0
predecesor,www.digi24.ro,0,1,0,1,-1.0,1.0
activist,observatornews.ro,0,1,0,1,-1.0,1.0
prieten,observatornews.ro,0,0,3,3,0.0,0.0
Bulai,recorder.ro,0,1,0,1,-1.0,1.0
doctoriță,recorder.ro,0,0,2,2,0.0,0.0
Ioana Mihăilă,recorder.ro,0,0,2,2,0.0,0.0
Maria Miron,recorder.ro,0,1,0,1,-1.0,1.0
Mirela Păiuș,recorder.ro,0,1,0,1,-1.0,1.0
combinator,recorder.ro,0,1,0,1,-1.0,1.0
"ministru, Alexandru Rafila",recorder.ro,0,0,1,1,0.0,0.0
rănit,recorder.ro,0,1,0,1,-1.0,1.0
Clotide Armand,www.realitatea.net,1,0,0,1,1.0,1.0
Clotilde Armand,www.realitatea.net,0,0,1,1,0.0,0.0
soț,www.realitatea.net,1,0,1,2,0.5,0.5
Berlin,www.euronews.ro,0,0,2,2,0.0,0.0
Friedrich Merz,www.euronews.ro,0,0,5,5,0.0,0.0
Merz,www.euronews.ro,0,0,2,2,0.0,0.0
Olaf Scholz,www.euronews.ro,0,0,4,4,0.0,0.0
funcționar,www.euronews.ro,0,3,3,6,-0.5,0.5
migrant,www.euronews.ro,0,3,0,3,-1.0,1.0
predecesor,www.euronews.ro,0,0,1,1,0.0,0.0
refugiat,www.euronews.ro,0,3,0,3,-1.0,1.0
Dragnea,www.euronews.ro,0,2,0,2,-1.0,1.0
Dăncilă,www.euronews.ro,0,1,1,2,-0.5,0.5
Occident,www.euronews.ro,0,1,2,3,-0.3333333333333333,0.3333333333333333
Peskov,www.euronews.ro,0,1,0,1,-1.0,1.0
Viena,www.euronews.ro,0,1,0,1,-1.0,1.0
adormit,www.euronews.ro,0,1,0,1,-1.0,1.0
derbedeu,www.euronews.ro,0,1,0,1,-1.0,1.0
doamna Lasconi,www.euronews.ro,0,0,2,2,0.0,0.0
spion,www.euronews.ro,0,1,0,1,-1.0,1.0
Statele Unite ale Americii,www.aktual24.ro,1,0,0,1,1.0,1.0
Belarus,www.antena3.ro,0,1,0,1,-1.0,1.0
Cotroceni,www.antena3.ro,1,0,2,3,0.3333333333333333,0.3333333333333333
Matei Păun,www.antena3.ro,0,3,2,5,-0.6,0.6
cei,www.antena3.ro,0,1,0,1,-1.0,1.0
Gâdea,www.antena3.ro,0,1,0,1,-1.0,1.0
Ploiești,www.digi24.ro,0,0,2,2,0.0,0.0
Șandru,www.g4media.ro,0,0,1,1,0.0,0.0
Cîțu,www.digi24.ro,0,0,2,2,0.0,0.0
Daniel,www.romaniatv.net,0,1,2,3,-0.3333333333333333,0.3333333333333333
Daniel Zamfir,www.romaniatv.net,0,1,0,1,-1.0,1.0
Dîncu,www.romaniatv.net,0,1,0,1,-1.0,1.0
Vasile Dîncu,www.romaniatv.net,0,1,0,1,-1.0,1.0
Zamfir,www.romaniatv.net,0,1,0,1,-1.0,1.0
criminal,www.romaniatv.net,0,2,0,2,-1.0,1.0
Cataramă,www.digi24.ro,0,0,1,1,0.0,0.0
Catarmă,www.digi24.ro,0,0,1,1,0.0,0.0
Lucian Bode,www.digi24.ro,0,0,2,2,0.0,0.0
Viorel Cataramă,www.digi24.ro,0,0,1,1,0.0,0.0
Dan Motreanu,www.digi24.ro,0,0,1,1,0.0,0.0
informator,www.digi24.ro,0,1,0,1,-1.0,1.0
Oprea,www.cotidianul.ro,0,0,1,1,0.0,0.0
juriști,www.antena3.ro,0,2,0,2,-1.0,1.0
Aheea,www.g4media.ro,0,1,0,1,-1.0,1.0
Bjola,www.g4media.ro,0,0,1,1,0.0,0.0
Fota,www.g4media.ro,0,0,1,1,0.0,0.0
Mirabela,www.g4media.ro,0,0,1,1,0.0,0.0
Radu Buzăianu,www.g4media.ro,0,0,1,1,0.0,0.0
Răzvan Zamfir,www.g4media.ro,0,0,1,1,0.0,0.0
cântăreț,www.g4media.ro,1,0,1,2,0.5,0.5
Metsola,www.g4media.ro,0,0,1,1,0.0,0.0
David,www.g4media.ro,2,0,2,4,0.5,0.5
Emmanuel Macron,www.g4media.ro,0,0,2,2,0.0,0.0
Naumescu,www.g4media.ro,0,0,1,1,0.0,0.0
Rutte,www.g4media.ro,0,0,1,1,0.0,0.0
fotbalist,www.g4media.ro,0,0,2,2,0.0,0.0
independent,www.g4media.ro,0,1,0,1,-1.0,1.0
om de cultură,www.g4media.ro,1,0,0,1,1.0,1.0
Râmnicu Sărat,www.euronews.ro,0,0,1,1,0.0,0.0
bugetar,www.euronews.ro,0,1,2,3,-0.3333333333333333,0.3333333333333333
cumpărător,www.comisarul.ro,0,1,1,2,-0.5,0.5
pedagog,primanews.ro,0,1,0,1,-1.0,1.0
Tanczos Barna,www.aktual24.ro,0,0,2,2,0.0,0.0
Mamaia,www.antena3.ro,0,0,1,1,0.0,0.0
Durov,www.comisarul.ro,0,0,1,1,0.0,0.0
Lerner,www.comisarul.ro,0,0,1,1,0.0,0.0
Musk,www.comisarul.ro,0,1,0,1,-1.0,1.0
Nicolas Lerner,www.comisarul.ro,0,1,0,1,-1.0,1.0
Pavel Durov,www.comisarul.ro,1,2,0,3,-0.3333333333333333,0.3333333333333333
X,www.comisarul.ro,0,2,1,3,-0.6666666666666666,0.6666666666666666
actorii,www.comisarul.ro,0,0,2,2,0.0,0.0
elită,www.comisarul.ro,0,1,0,1,-1.0,1.0
miliardar,www.comisarul.ro,0,0,2,2,0.0,0.0
rival,www.comisarul.ro,0,2,0,2,-1.0,1.0
negociator,www.romaniatv.net,0,0,1,1,0.0,0.0
Firea,www.news.ro,0,0,1,1,0.0,0.0
Valeriu Nicolae,www.digi24.ro,0,0,1,1,0.0,0.0
Modrogan,stirileprotv.ro,0,0,1,1,0.0,0.0
general,www.digi24.ro,0,4,2,6,-0.6666666666666666,0.6666666666666666
Adriana Mironescu,a1.ro,0,0,1,1,0.0,0.0
Adrianei Mironescu,a1.ro,0,0,1,1,0.0,0.0
Laurentiu Mironescu,a1.ro,0,0,1,1,0.0,0.0
Cuza,adevarul.ro,0,0,1,1,0.0,0.0
Finlanda,adevarul.ro,2,0,5,7,0.2857142857142857,0.2857142857142857
Avramescu,adevarul.ro,0,1,0,1,-1.0,1.0
Carol,adevarul.ro,0,0,1,1,0.0,0.0
profet,adevarul.ro,0,1,0,1,-1.0,1.0
birocrat,stirileprotv.ro,0,1,0,1,-1.0,1.0
decident,stirileprotv.ro,0,0,2,2,0.0,0.0
Drula,www.aktual24.ro,0,0,2,2,0.0,0.0
Islanda,www.aktual24.ro,0,0,1,1,0.0,0.0
Liechtenstein,www.aktual24.ro,0,0,1,1,0.0,0.0
Norvegia,www.aktual24.ro,0,0,1,1,0.0,0.0
Marinescu,www.luju.ro,0,1,1,2,-0.5,0.5
Tudose,www.luju.ro,0,0,1,1,0.0,0.0
Adrian Tudose,www.luju.ro,0,0,1,1,0.0,0.0
Radu Marinescu,www.luju.ro,0,0,5,5,0.0,0.0
Cristina Georgescu,www.luju.ro,0,0,1,1,0.0,0.0
Ioana Tripon,www.luju.ro,0,0,1,1,0.0,0.0
Ion Reghina,www.luju.ro,0,0,1,1,0.0,0.0
anchetator,observatornews.ro,0,5,2,7,-0.7142857142857143,0.7142857142857143
Burcea,observatornews.ro,0,0,1,1,0.0,0.0
Cristela Georgescu,observatornews.ro,0,0,1,1,0.0,0.0
Dorina Mihai,observatornews.ro,0,0,1,1,0.0,0.0
Elon Musk,observatornews.ro,0,0,1,1,0.0,0.0
Eugen Sechila,observatornews.ro,0,0,1,1,0.0,0.0
Frank Timiș,observatornews.ro,0,0,1,1,0.0,0.0
George Mocanu,observatornews.ro,0,0,1,1,0.0,0.0
Marian Motocu,observatornews.ro,0,0,1,1,0.0,0.0
Motoc,observatornews.ro,0,0,1,1,0.0,0.0
Mureș,observatornews.ro,0,0,2,2,0.0,0.0
Potra,observatornews.ro,0,1,0,1,-1.0,1.0
Tudorel Toader,observatornews.ro,0,1,1,2,-0.5,0.5
admiratoare,observatornews.ro,0,1,0,1,-1.0,1.0
jandarm,observatornews.ro,0,1,1,2,-0.5,0.5
luptător,observatornews.ro,0,1,1,2,-0.5,0.5
mască,observatornews.ro,0,1,0,1,-1.0,1.0
personalitate,observatornews.ro,0,2,0,2,-1.0,1.0
Călin Gerogescu,a1.ro,0,0,1,1,0.0,0.0
Paris,observatornews.ro,0,0,2,2,0.0,0.0
însărcinat,observatornews.ro,0,0,1,1,0.0,0.0
Toader,adevarul.ro,0,0,1,1,0.0,0.0
Tudorel Toader,adevarul.ro,0,0,2,2,0.0,0.0
Franța,www.news.ro,0,0,3,3,0.0,0.0
orator,www.news.ro,0,1,0,1,-1.0,1.0
Andrew Tate,www.digi24.ro,0,1,0,1,-1.0,1.0
Richard Grenell,www.digi24.ro,0,0,1,1,0.0,0.0
amator,www.digi24.ro,0,1,0,1,-1.0,1.0
Radu Sârbu,www.mediafax.ro,0,0,1,1,0.0,0.0
Adrian Solomon,www.luju.ro,0,0,1,1,0.0,0.0
Solomon,www.luju.ro,0,0,1,1,0.0,0.0
militar,www.luju.ro,0,1,3,4,-0.25,0.25
Elena,www.activenews.ro,0,1,1,2,-0.5,0.5
George,www.activenews.ro,0,0,1,1,0.0,0.0
Iliescu,www.activenews.ro,0,1,0,1,-1.0,1.0
Marcel,www.activenews.ro,0,0,1,1,0.0,0.0
Sfântul Ștefan,www.activenews.ro,1,0,0,1,1.0,1.0
căutător,www.activenews.ro,1,0,0,1,1.0,1.0
filosof,www.activenews.ro,1,0,0,1,1.0,1.0
gânditor,www.activenews.ro,1,0,0,1,1.0,1.0
neam,www.activenews.ro,1,1,0,2,0.0,0.0
purtător,www.activenews.ro,0,2,0,2,-1.0,1.0
semințe,www.activenews.ro,1,0,0,1,1.0,1.0
Basel,adevarul.ro,0,0,1,1,0.0,0.0
Elveția,adevarul.ro,0,0,7,7,0.0,0.0
Geneva,adevarul.ro,1,0,1,2,0.5,0.5
Sorin Ioniță,adevarul.ro,0,1,3,4,-0.25,0.25
Ticino,adevarul.ro,0,0,1,1,0.0,0.0
Bogdan Trif,www.g4media.ro,0,0,1,1,0.0,0.0
Claudiu Mureșan,www.g4media.ro,0,0,1,1,0.0,0.0
Dumitru Beschiu,www.g4media.ro,0,0,1,1,0.0,0.0
Laura Barac,www.g4media.ro,0,0,1,1,0.0,0.0
Ionela Mihai,www.g4media.ro,0,0,1,1,0.0,0.0
Andrew,www.romaniatv.net,0,1,0,1,-1.0,1.0
Bannon,www.romaniatv.net,0,1,0,1,-1.0,1.0
Dragnea,www.romaniatv.net,0,2,0,2,-1.0,1.0
Mircea Dinescu,www.romaniatv.net,0,1,0,1,-1.0,1.0
Steve Bannon,www.romaniatv.net,0,0,2,2,0.0,0.0
Tristan Tate,www.romaniatv.net,0,1,0,1,-1.0,1.0
frate,www.romaniatv.net,2,1,0,3,0.3333333333333333,0.3333333333333333
promotor,www.romaniatv.net,0,1,0,1,-1.0,1.0
Elene Udrea,www.digi24.ro,0,0,1,1,0.0,0.0
Teodor Stolojan,www.digi24.ro,0,0,1,1,0.0,0.0
Varujan Pambuccian,www.mediafax.ro,0,0,1,1,0.0,0.0
respondent,recorder.ro,0,1,0,1,-1.0,1.0
Diana Șoșoacă,www.realitatea.net,0,3,5,8,-0.375,0.375
Ludovic Orban,www.realitatea.net,0,0,3,3,0.0,0.0
subiect,www.realitatea.net,0,0,2,2,0.0,0.0
Kosovo,www.aktual24.ro,0,1,0,1,-1.0,1.0
Marta Kos,www.aktual24.ro,0,0,1,1,0.0,0.0
Vucic,www.aktual24.ro,0,0,1,1,0.0,0.0
Vulin,www.aktual24.ro,0,1,0,1,-1.0,1.0
Andreea Cosma,pressone.ro,0,2,1,3,-0.6666666666666666,0.6666666666666666
Bădălău,pressone.ro,0,1,0,1,-1.0,1.0
Mihai Goțiu,pressone.ro,0,3,4,7,-0.42857142857142855,0.42857142857142855
Mircea Cosma,pressone.ro,0,1,1,2,-0.5,0.5
Nicolae Moga,pressone.ro,0,1,2,3,-0.3333333333333333,0.3333333333333333
Ancăi Alexandrescu,www.realitatea.net,0,0,1,1,0.0,0.0
individ,www.realitatea.net,0,3,1,4,-0.75,0.75
realizator,www.realitatea.net,0,0,1,1,0.0,0.0
fiu,www.realitatea.net,1,0,3,4,0.25,0.25
impostor,www.realitatea.net,0,1,0,1,-1.0,1.0
jurnalistă,www.realitatea.net,0,1,0,1,-1.0,1.0
Diaconescu,www.mediafax.ro,0,1,0,1,-1.0,1.0
Cerv,agerpres.ro,0,0,2,2,0.0,0.0
Cosmina Cerva,agerpres.ro,0,0,1,1,0.0,0.0
Daniel Zamfir,agerpres.ro,0,0,1,1,0.0,0.0
Horga,agerpres.ro,0,0,1,1,0.0,0.0
Maria Horga,agerpres.ro,0,0,1,1,0.0,0.0
Zamfir,agerpres.ro,0,0,1,1,0.0,0.0
guru,agerpres.ro,0,0,1,1,0.0,0.0
ordonator,agerpres.ro,0,0,1,1,0.0,0.0
Hunor Kelemen,a1.ro,0,0,2,2,0.0,0.0
Bogdan Loghin,www.aktual24.ro,0,1,2,3,-0.3333333333333333,0.3333333333333333
Loghin,www.aktual24.ro,0,1,0,1,-1.0,1.0
Radauti,www.aktual24.ro,0,0,1,1,0.0,0.0
Soldan,www.aktual24.ro,0,0,1,1,0.0,0.0
Statele,www.aktual24.ro,0,0,1,1,0.0,0.0
Suceava,www.aktual24.ro,0,0,4,4,0.0,0.0
Cătălin Striblea,adevarul.ro,0,0,2,2,0.0,0.0
Stejarii,adevarul.ro,0,0,1,1,0.0,0.0
Striblea,adevarul.ro,0,0,1,1,0.0,0.0
Cristian Stan,agerpres.ro,0,0,2,2,0.0,0.0
Târgoviștean,agerpres.ro,0,0,1,1,0.0,0.0
Corneliu Ștefan,www.comisarul.ro,0,0,4,4,0.0,0.0
Marius Oprea,www.mediafax.ro,0,0,1,1,0.0,0.0
anchetator,www.mediafax.ro,0,2,0,2,-1.0,1.0
lucrător,www.mediafax.ro,0,1,0,1,-1.0,1.0
soră,www.mediafax.ro,0,0,1,1,0.0,0.0
Danileț,pressone.ro,0,0,2,2,0.0,0.0
Eugen Tomac,pressone.ro,0,0,1,1,0.0,0.0
cei,pressone.ro,0,0,3,3,0.0,0.0
Cristi Danileț,pressone.ro,0,0,3,3,0.0,0.0
Csoma Botond,pressone.ro,0,1,0,1,-1.0,1.0
David,pressone.ro,0,1,1,2,-0.5,0.5
Goliat,pressone.ro,0,1,0,1,-1.0,1.0
Găgăuzia,pressone.ro,0,0,1,1,0.0,0.0
Ilan Șor,pressone.ro,0,1,0,1,-1.0,1.0
Michaloliakos,pressone.ro,0,1,0,1,-1.0,1.0
Sabin Cârstoveanu,pressone.ro,0,1,0,1,-1.0,1.0
bașcan,pressone.ro,0,0,1,1,0.0,0.0
persona non grata,pressone.ro,0,1,0,1,-1.0,1.0
șor,pressone.ro,0,1,0,1,-1.0,1.0
Codrin Ștefanescu,www.comisarul.ro,0,1,0,1,-1.0,1.0
Razvan Savaliuc,www.comisarul.ro,0,0,1,1,0.0,0.0
Stefanescu,www.comisarul.ro,0,1,0,1,-1.0,1.0
acestia,www.comisarul.ro,0,0,1,1,0.0,0.0
Serbia,www.cotidianul.ro,0,0,1,1,0.0,0.0
Singapore,www.cotidianul.ro,0,0,1,1,0.0,0.0
Ungaria,www.cotidianul.ro,1,1,3,5,0.0,0.0
Ungarie,www.cotidianul.ro,0,1,2,3,-0.3333333333333333,0.3333333333333333
Victor Dima,www.cotidianul.ro,0,0,2,2,0.0,0.0
Abu Dhabi,stirileprotv.ro,0,0,1,1,0.0,0.0
Sebastian Ghita,stirileprotv.ro,0,0,1,1,0.0,0.0
Crin Laurențiu Antonescu,www.digi24.ro,0,0,1,1,0.0,0.0
Irina,www.digi24.ro,1,0,0,1,1.0,1.0
artizan,www.digi24.ro,0,0,1,1,0.0,0.0
Antonio Costa,www.g4media.ro,0,0,1,1,0.0,0.0
Chega,www.g4media.ro,0,0,1,1,0.0,0.0
Luis Montenegro,www.g4media.ro,0,1,1,2,-0.5,0.5
Montenegro,www.g4media.ro,0,0,1,1,0.0,0.0
Pedro Nuno Santos,www.g4media.ro,0,0,1,1,0.0,0.0
comentator,www.g4media.ro,0,1,1,2,-0.5,0.5
elită,www.g4media.ro,0,1,0,1,-1.0,1.0
funcționar,www.g4media.ro,0,0,4,4,0.0,0.0
imigrant,www.g4media.ro,0,3,0,3,-1.0,1.0
jurist,www.g4media.ro,0,0,3,3,0.0,0.0
lucrător,www.g4media.ro,0,1,1,2,-0.5,0.5
medic,www.g4media.ro,0,0,3,3,0.0,0.0
Marina Costa Lobo,www.g4media.ro,0,0,1,1,0.0,0.0
străin,www.g4media.ro,0,3,1,4,-0.75,0.75
antrenor,recorder.ro,1,1,1,3,0.0,0.0
Durov,recorder.ro,0,1,0,1,-1.0,1.0
miliardar,recorder.ro,0,1,1,2,-0.5,0.5
Pavel Durov,recorder.ro,0,1,1,2,-0.5,0.5
Cătălin Dumitru,snoop.ro,0,0,2,2,0.0,0.0
Dumitru,snoop.ro,0,0,1,1,0.0,0.0
New York,snoop.ro,0,0,3,3,0.0,0.0
român,snoop.ro,0,0,1,1,0.0,0.0
Răzvan Săndulescu,snoop.ro,0,0,1,1,0.0,0.0
domnie,snoop.ro,0,0,1,1,0.0,0.0
Alexandr Kondyakov,www.g4media.ro,0,0,1,1,0.0,0.0
Costiuc,www.g4media.ro,0,1,0,1,-1.0,1.0
Federația Rusă,www.g4media.ro,0,1,0,1,-1.0,1.0
Vasile Costiuc,www.g4media.ro,0,1,0,1,-1.0,1.0
consultant,www.g4media.ro,0,3,2,5,-0.6,0.6
general,www.g4media.ro,0,1,3,4,-0.25,0.25
Sorin Ozon,www.g4media.ro,0,0,1,1,0.0,0.0
Madalin Voicu,a1.ro,0,1,0,1,-1.0,1.0
Austria,www.activenews.ro,0,1,1,2,-0.5,0.5
austriac,www.activenews.ro,0,0,1,1,0.0,0.0
Blaga,www.activenews.ro,0,2,0,2,-1.0,1.0
Dan Voiculescu,www.activenews.ro,0,1,0,1,-1.0,1.0
Elena Udrea,www.activenews.ro,0,1,0,1,-1.0,1.0
Emmanuel Macron,www.activenews.ro,0,2,2,4,-0.5,0.5
emisar,www.activenews.ro,0,1,1,2,-0.5,0.5
Florian Coldea,www.activenews.ro,0,3,0,3,-1.0,1.0
Flutur,www.activenews.ro,0,1,0,1,-1.0,1.0
Gheorghe Flutur,www.activenews.ro,0,0,1,1,0.0,0.0
Hrebenciuc,www.activenews.ro,0,2,0,2,-1.0,1.0
Ilie,www.activenews.ro,0,1,0,1,-1.0,1.0
Ioan Oltean,www.activenews.ro,0,1,0,1,-1.0,1.0
Ioan Rus,www.activenews.ro,0,1,0,1,-1.0,1.0
Ion Marcel Ciolacu,www.activenews.ro,0,1,0,1,-1.0,1.0
Kelemen,www.activenews.ro,0,0,1,1,0.0,0.0
Laura Codruța Kovesi,www.activenews.ro,0,2,0,2,-1.0,1.0
Liviu Dragnea,www.activenews.ro,0,2,0,2,-1.0,1.0
Maia,www.activenews.ro,0,2,0,2,-1.0,1.0
Monica Luisa Macovei,www.activenews.ro,0,1,0,1,-1.0,1.0
Oradea,www.activenews.ro,0,0,1,1,0.0,0.0
preș,www.activenews.ro,0,1,0,1,-1.0,1.0
Rus,www.activenews.ro,0,1,0,1,-1.0,1.0
Sebastian Ghiță,www.activenews.ro,0,1,0,1,-1.0,1.0
Stoica,www.activenews.ro,0,1,0,1,-1.0,1.0
Tanda Manda,www.activenews.ro,0,1,0,1,-1.0,1.0
Traian Băsescu,www.activenews.ro,0,3,0,3,-1.0,1.0
Valer Marian,www.activenews.ro,1,0,1,2,0.5,0.5
Valeriu Stoica,www.activenews.ro,0,1,0,1,-1.0,1.0
Vasile Blaga,www.activenews.ro,0,1,0,1,-1.0,1.0
Vaslui,www.activenews.ro,0,0,2,2,0.0,0.0
Viena,www.activenews.ro,0,0,1,1,0.0,0.0
Viorel Hrebenciuc,www.activenews.ro,0,1,0,1,-1.0,1.0
Zsombor Vajda,www.activenews.ro,0,0,2,2,0.0,0.0
aliat,www.activenews.ro,0,3,1,4,-0.75,0.75
asasin,www.activenews.ro,0,2,0,2,-1.0,1.0
colaborator,www.activenews.ro,0,1,0,1,-1.0,1.0
jefuitor,www.activenews.ro,0,1,0,1,-1.0,1.0
luptător,www.activenews.ro,0,1,0,1,-1.0,1.0
George Soros,www.activenews.ro,0,0,1,1,0.0,0.0
nepot,www.activenews.ro,0,1,1,2,-0.5,0.5
Călin Popescu-Tăriceanu,www.activenews.ro,0,0,1,1,0.0,0.0
Maia Sanda,www.activenews.ro,0,0,1,1,0.0,0.0
păpușar,www.activenews.ro,0,1,0,1,-1.0,1.0
Cristian Porumboiu,www.activenews.ro,1,0,0,1,1.0,1.0
revoluționar,www.activenews.ro,0,2,0,2,-1.0,1.0
erou militar,www.realitatea.net,1,0,0,1,1.0,1.0
erou,www.realitatea.net,1,0,0,1,1.0,1.0
partener,www.realitatea.net,1,1,0,2,0.0,0.0
personal,www.realitatea.net,1,0,1,2,0.5,0.5
rezervist,www.realitatea.net,0,1,0,1,-1.0,1.0
specialist,www.realitatea.net,1,0,3,4,0.25,0.25
vicepremier,www.realitatea.net,0,0,1,1,0.0,0.0
Oana Stancu Zamfir,www.antena3.ro,0,0,1,1,0.0,0.0
Oanei Stancu-Zamfir,www.antena3.ro,0,0,1,1,0.0,0.0
Ion Cristoiu,adevarul.ro,0,0,4,4,0.0,0.0
Rareș Bogdan,www.romaniatv.net,0,0,2,2,0.0,0.0
Bianca Ionescu,a1.ro,0,0,1,1,0.0,0.0
Daniela Vlădescu,a1.ro,0,0,1,1,0.0,0.0
Micky,a1.ro,0,0,1,1,0.0,0.0
Olguta Vasilescu,a1.ro,0,0,1,1,0.0,0.0
Daniela Vladescu,a1.ro,0,0,1,1,0.0,0.0
Ionescu,a1.ro,0,0,1,1,0.0,0.0
Adrian Mihăiță Todoran,recorder.ro,0,0,1,1,0.0,0.0
Baird Spalding,recorder.ro,0,0,1,1,0.0,0.0
Cristian Brian,recorder.ro,0,0,1,1,0.0,0.0
Dumbrăvița,recorder.ro,0,0,1,1,0.0,0.0
Dumitru Constantin Dulcan,recorder.ro,0,0,1,1,0.0,0.0
Felician Ciceu,recorder.ro,0,1,0,1,-1.0,1.0
Florin Alexandru Alexe,recorder.ro,0,0,1,1,0.0,0.0
Gabriel Zetea,recorder.ro,0,0,1,1,0.0,0.0
Gheorghe Șimon,recorder.ro,0,0,1,1,0.0,0.0
Ioan Călin Bota,recorder.ro,0,1,0,1,-1.0,1.0
Lucian Titus Morar,recorder.ro,0,0,1,1,0.0,0.0
Maramureș,recorder.ro,2,0,2,4,0.5,0.5
Marian Ilea,recorder.ro,0,0,1,1,0.0,0.0
Marin Preda,recorder.ro,0,0,3,3,0.0,0.0
Napoca,recorder.ro,0,0,3,3,0.0,0.0
Omului,recorder.ro,0,0,1,1,0.0,0.0
Seppo Rainisto,recorder.ro,0,0,1,1,0.0,0.0
Sorin Vlașin,recorder.ro,0,0,1,1,0.0,0.0
Teemu Moilanen,recorder.ro,0,0,1,1,0.0,0.0
Ulmeni,recorder.ro,0,0,1,1,0.0,0.0
Viorica Marincaș,recorder.ro,0,0,1,1,0.0,0.0
cunoscut,recorder.ro,0,1,0,1,-1.0,1.0
virusolog,recorder.ro,0,1,0,1,-1.0,1.0
Samuel Zărnescu,www.g4media.ro,0,0,1,1,0.0,0.0
Szabó Ödön,www.g4media.ro,0,1,1,2,-0.5,0.5
Alba,www.realitatea.net,0,0,1,1,0.0,0.0
Corneliu Olar,www.realitatea.net,1,0,0,1,1.0,1.0
Mircea Hava,www.realitatea.net,2,0,0,2,1.0,1.0
Horea,www.realitatea.net,0,0,1,1,0.0,0.0
olar,www.realitatea.net,1,0,0,1,1.0,1.0
luptător,www.realitatea.net,0,1,1,2,-0.5,0.5
Alex Enășescu,pressone.ro,0,0,1,1,0.0,0.0
Alexa,pressone.ro,0,0,1,1,0.0,0.0
Liviu Alexa,pressone.ro,0,0,1,1,0.0,0.0
Postolache,pressone.ro,0,0,1,1,0.0,0.0
Munchen,www.gandul.ro,0,0,2,2,0.0,0.0
tehnician,stirileprotv.ro,0,0,1,1,0.0,0.0
CIOCLII,www.luju.ro,0,1,0,1,-1.0,1.0
Stan,www.luju.ro,0,0,1,1,0.0,0.0
Iulia Scantei,www.luju.ro,2,0,1,3,0.6666666666666666,0.6666666666666666
Mihaela Ciochina,www.luju.ro,0,0,2,2,0.0,0.0
Simina Tănăsescu,www.luju.ro,0,0,1,1,0.0,0.0
Attila Varga,www.luju.ro,0,0,2,2,0.0,0.0
Bogdan Licu,www.luju.ro,0,0,1,1,0.0,0.0
Cristian Deliorga,www.luju.ro,0,0,2,2,0.0,0.0
Marian Enache,www.luju.ro,0,1,1,2,-0.5,0.5
Cristian Terheș,www.gandul.ro,2,0,4,6,0.3333333333333333,0.3333333333333333
Dăncilă,www.gandul.ro,0,0,1,1,0.0,0.0
Liviu Dragnea,www.gandul.ro,0,1,2,3,-0.3333333333333333,0.3333333333333333
Terheș,www.gandul.ro,2,0,1,3,0.6666666666666666,0.6666666666666666
inginer,www.gandul.ro,0,0,3,3,0.0,0.0
Abydos,a1.ro,0,0,1,1,0.0,0.0
Egiptul antic,a1.ro,0,0,1,1,0.0,0.0
Grecia Antică,a1.ro,1,0,0,1,1.0,1.0
India,a1.ro,0,0,2,2,0.0,0.0
multor,a1.ro,0,0,1,1,0.0,0.0
tuturor,a1.ro,0,1,1,2,-0.5,0.5
vindecător,a1.ro,0,0,1,1,0.0,0.0
Anamaria Gavrilă,primanews.ro,0,2,1,3,-0.6666666666666666,0.6666666666666666
Dorin Popa,primanews.ro,0,1,0,1,-1.0,1.0
Bogdan Licu,www.euronews.ro,0,0,1,1,0.0,0.0
Cristi Danileț,www.euronews.ro,0,0,1,1,0.0,0.0
Iulia Scântei,www.euronews.ro,0,0,1,1,0.0,0.0
Licu,www.euronews.ro,0,0,1,1,0.0,0.0
Mona Pivniceru,www.euronews.ro,0,0,1,1,0.0,0.0
Peter Eckstein Kovács,www.euronews.ro,0,0,1,1,0.0,0.0
Radu Ghidău,www.euronews.ro,0,0,1,1,0.0,0.0
Valer Dorneanu,www.euronews.ro,0,0,1,1,0.0,0.0
doctor,www.euronews.ro,0,2,0,2,-1.0,1.0
Daniel Morar,www.euronews.ro,0,0,1,1,0.0,0.0
senatoare,www.euronews.ro,0,0,1,1,0.0,0.0
Ceaușescu,agerpres.ro,0,1,0,1,-1.0,1.0
Nicolae-Ionel Ciucă,agerpres.ro,0,1,0,1,-1.0,1.0
Geoană,agerpres.ro,0,1,0,1,-1.0,1.0
Dumnezeu,agerpres.ro,0,0,1,1,0.0,0.0
Horațiu Potra,agerpres.ro,0,0,1,1,0.0,0.0
Londra,agerpres.ro,0,0,1,1,0.0,0.0
Măgurele,agerpres.ro,1,0,0,1,1.0,1.0
Regele Charles,agerpres.ro,0,0,1,1,0.0,0.0
Rio,agerpres.ro,0,1,0,1,-1.0,1.0
Rio de Janeiro,agerpres.ro,0,0,1,1,0.0,0.0
Silviu Predoiu,agerpres.ro,0,0,3,3,0.0,0.0
Washington,agerpres.ro,0,0,1,1,0.0,0.0
Nicolae Oprișor,agerpres.ro,0,0,1,1,0.0,0.0
marinar,agerpres.ro,0,0,2,2,0.0,0.0
militar,agerpres.ro,2,0,1,3,0.6666666666666666,0.6666666666666666
Traian Băsescu,agerpres.ro,0,1,0,1,-1.0,1.0
Ion Iliescu,agerpres.ro,1,1,1,3,0.0,0.0
soldat,agerpres.ro,0,1,0,1,-1.0,1.0
viceprimar,agerpres.ro,0,1,0,1,-1.0,1.0
Țările Arabe,agerpres.ro,0,0,1,1,0.0,0.0
naționalist,pressone.ro,0,0,1,1,0.0,0.0
turișt,pressone.ro,0,1,3,4,-0.25,0.25
Afganistan,pressone.ro,0,0,3,3,0.0,0.0
Alexandru Bolintineanu,pressone.ro,0,0,1,1,0.0,0.0
Armaș,pressone.ro,0,0,1,1,0.0,0.0
Bosnia și Herțegovina,pressone.ro,0,0,1,1,0.0,0.0
Boutros Boutros-Ghali,pressone.ro,0,0,1,1,0.0,0.0
Bădălan,pressone.ro,0,1,0,1,-1.0,1.0
Calogeropoulos Stratis,pressone.ro,0,0,1,1,0.0,0.0
Cornel Purcărea,pressone.ro,0,0,1,1,0.0,0.0
Dan Stroescu,pressone.ro,0,0,1,1,0.0,0.0
Dorin Mara,pressone.ro,0,0,1,1,0.0,0.0
Duță,pressone.ro,0,1,0,1,-1.0,1.0
Emil Chețe,pressone.ro,0,0,3,3,0.0,0.0
Eugen Bădălan,pressone.ro,0,1,0,1,-1.0,1.0
F. Cardini,pressone.ro,0,0,1,1,0.0,0.0
Frunzeti,pressone.ro,0,0,1,1,0.0,0.0
Ion Dragoman,pressone.ro,0,0,1,1,0.0,0.0
Ionel Cloșcă,pressone.ro,0,0,1,1,0.0,0.0
Iosif Armaș,pressone.ro,0,0,1,1,0.0,0.0
James Adams,pressone.ro,0,0,1,1,0.0,0.0
John,pressone.ro,0,1,0,1,-1.0,1.0
John Adams,pressone.ro,0,0,1,1,0.0,0.0
M. Jopp,pressone.ro,0,0,1,1,0.0,0.0
Mircea Mândru,pressone.ro,0,1,0,1,-1.0,1.0
Mândru,pressone.ro,0,1,0,1,-1.0,1.0
Paul Cerjan,pressone.ro,0,0,1,1,0.0,0.0
Paul Dănuț Duță,pressone.ro,0,0,1,1,0.0,0.0
Petre Tobă,pressone.ro,0,1,1,2,-0.5,0.5
Purcărea,pressone.ro,0,0,1,1,0.0,0.0
Sănătății,pressone.ro,0,0,1,1,0.0,0.0
Teodor Frunzeti,pressone.ro,0,0,2,2,0.0,0.0
Valentin Arsenie,pressone.ro,0,0,2,2,0.0,0.0
altcineva,pressone.ro,0,1,1,2,-0.5,0.5
Cătălin Avramescu,pressone.ro,0,0,1,1,0.0,0.0
apărător,pressone.ro,1,1,1,3,0.0,0.0
conferențiar universitar,pressone.ro,0,0,1,1,0.0,0.0
general de brigadă,pressone.ro,0,0,1,1,0.0,0.0
locotenent-colonel,pressone.ro,0,0,1,1,0.0,0.0
Premierul Năstase,pressone.ro,0,1,0,1,-1.0,1.0
îndrumător,pressone.ro,0,1,3,4,-0.25,0.25
Modrogan,observatornews.ro,0,0,1,1,0.0,0.0
Tulcea,www.comisarul.ro,0,0,2,2,0.0,0.0
comandant,www.comisarul.ro,0,0,2,2,0.0,0.0
Cioroianu,recorder.ro,0,2,1,3,-0.6666666666666666,0.6666666666666666
Condoleezza Rice,recorder.ro,0,1,0,1,-1.0,1.0
Cristiano Bergodi,recorder.ro,0,0,1,1,0.0,0.0
Dida,recorder.ro,0,1,0,1,-1.0,1.0
Eminescu,recorder.ro,0,1,0,1,-1.0,1.0
Genică,recorder.ro,0,1,0,1,-1.0,1.0
Genică Boerică,recorder.ro,0,1,0,1,-1.0,1.0
Gică Hagi,recorder.ro,0,0,1,1,0.0,0.0
Gigi Becali,recorder.ro,0,1,0,1,-1.0,1.0
Nati Meir,recorder.ro,0,1,0,1,-1.0,1.0
Viorel Hizo,recorder.ro,0,0,1,1,0.0,0.0
Dorel Zaharia,recorder.ro,0,1,0,1,-1.0,1.0
Dida Drăgan,recorder.ro,0,0,1,1,0.0,0.0
iști,recorder.ro,0,2,0,2,-1.0,1.0
participant,recorder.ro,0,3,2,5,-0.6,0.6
Tăriceanu,recorder.ro,0,3,3,6,-0.5,0.5
sponsor,www.realitatea.net,0,1,0,1,-1.0,1.0
Crin,www.realitatea.net,0,0,1,1,0.0,0.0
boț,www.realitatea.net,0,1,0,1,-1.0,1.0
Bejinariu,pressone.ro,0,2,0,2,-1.0,1.0
Cornel Popa,pressone.ro,0,0,1,1,0.0,0.0
Cristian Sorin Dumitrescu,pressone.ro,0,0,1,1,0.0,0.0
Decanul,pressone.ro,0,0,1,1,0.0,0.0
Dobre,pressone.ro,0,0,1,1,0.0,0.0
Eugen Bejinariu,pressone.ro,0,1,1,2,-0.5,0.5
Ioan Stan,pressone.ro,0,0,1,1,0.0,0.0
Nicolae Bacalbașa Dobrovici,pressone.ro,0,0,1,1,0.0,0.0
Ovidiu Marciu,pressone.ro,0,0,1,1,0.0,0.0
Victor Dobre,pressone.ro,0,0,1,1,0.0,0.0
Victorel Lupu,pressone.ro,0,0,1,1,0.0,0.0
neurochirurg,pressone.ro,0,0,1,1,0.0,0.0
notar,pressone.ro,0,1,3,4,-0.25,0.25
Alexandru,www.aktual24.ro,0,0,1,1,0.0,0.0
Violeta Alexandru,www.aktual24.ro,0,0,1,1,0.0,0.0
Austria,a1.ro,0,0,2,2,0.0,0.0
Baile Herculane,a1.ro,0,1,0,1,-1.0,1.0
Nicusor Vasilescu,a1.ro,0,0,1,1,0.0,0.0
yoghin,a1.ro,0,0,1,1,0.0,0.0
cioloș,www.digi24.ro,1,1,1,3,0.0,0.0
Ursula von der Leyen,www.digi24.ro,0,0,3,3,0.0,0.0
eurodeputat,www.digi24.ro,0,0,2,2,0.0,0.0
Albert Einstein,www.cotidianul.ro,1,0,0,1,1.0,1.0
Einstein,www.cotidianul.ro,1,0,0,1,1.0,1.0
Gavrilă,www.cotidianul.ro,0,1,3,4,-0.25,0.25
Madrid,www.cotidianul.ro,0,0,1,1,0.0,0.0
Ana Maria Gavrilă,www.antena3.ro,0,0,1,1,0.0,0.0
Dan Dungagiu,www.antena3.ro,0,0,1,1,0.0,0.0
Cîrstoiu,www.realitatea.net,0,1,1,2,-0.5,0.5
Cătălin Cîrstoiu,www.realitatea.net,0,1,1,2,-0.5,0.5
medic,www.realitatea.net,1,1,2,4,0.0,0.0
Ioana Mihăilă,stirileprotv.ro,0,0,2,2,0.0,0.0
Ioan Mihăilă,stirileprotv.ro,0,0,1,1,0.0,0.0
Mihăilă,stirileprotv.ro,0,0,1,1,0.0,0.0
cadru medical,stirileprotv.ro,0,0,1,1,0.0,0.0
personal medical,stirileprotv.ro,0,0,1,1,0.0,0.0
registrator,stirileprotv.ro,0,0,1,1,0.0,0.0
Tudose,www.mediafax.ro,0,2,3,5,-0.4,0.4
Firea,www.gandul.ro,2,4,3,9,-0.2222222222222222,0.2222222222222222
Kiseleff,www.gandul.ro,0,0,1,1,0.0,0.0
apropiat,www.gandul.ro,0,2,1,3,-0.6666666666666666,0.6666666666666666
Ștefan Godei,www.gandul.ro,0,1,0,1,-1.0,1.0
Chișinău,www.news.ro,0,0,3,3,0.0,0.0
Giorgia Meloni,www.news.ro,0,0,1,1,0.0,0.0
Giorgio Meloni,www.news.ro,0,0,1,1,0.0,0.0
Irlanda de Nord,www.news.ro,0,0,1,1,0.0,0.0
Keir Starmer,www.news.ro,0,0,1,1,0.0,0.0
Regatul Unit al Marii Britanii,www.news.ro,0,0,1,1,0.0,0.0
Regatul Unit al Marii Britanii și al Irlandei de Nord,www.news.ro,0,0,1,1,0.0,0.0
Varujan Pambuccian,observatornews.ro,0,0,2,2,0.0,0.0
victimă,observatornews.ro,0,0,1,1,0.0,0.0
Stelian Ion,pressone.ro,0,3,2,5,-0.6,0.6
Z,pressone.ro,0,0,1,1,0.0,0.0
Alexander,www.euronews.ro,0,0,1,1,0.0,0.0
Alexander Hamas,www.euronews.ro,0,0,1,1,0.0,0.0
Edan Alexander,www.euronews.ro,0,0,1,1,0.0,0.0
Recep Tayyip Erdogan,www.euronews.ro,0,0,4,4,0.0,0.0
aliaț,www.euronews.ro,0,1,0,1,-1.0,1.0
militant,www.euronews.ro,0,2,0,2,-1.0,1.0
Țara Oașului,www.euronews.ro,0,0,1,1,0.0,0.0
funcționar public,adevarul.ro,0,0,1,1,0.0,0.0
subsecretar de stat,adevarul.ro,0,1,0,1,-1.0,1.0
Masha,pressone.ro,1,0,0,1,1.0,1.0
Viktor Orbán,pressone.ro,0,3,3,6,-0.5,0.5
migrant,pressone.ro,0,4,2,6,-0.6666666666666666,0.6666666666666666
Cristiana Anghel,pressone.ro,0,1,0,1,-1.0,1.0
Daniel Suciu,www.news.ro,0,0,2,2,0.0,0.0
Suciu,www.news.ro,0,0,1,1,0.0,0.0
Vasile Blaga,adevarul.ro,0,2,3,5,-0.4,0.4
liberator,adevarul.ro,0,1,0,1,-1.0,1.0
Adrian Thiess,adevarul.ro,0,0,2,2,0.0,0.0
Aurelian Virgil Băluță,adevarul.ro,0,0,1,1,0.0,0.0
Bleahu,adevarul.ro,0,0,1,1,0.0,0.0
Constantin Vacusta,adevarul.ro,0,0,2,2,0.0,0.0
Emil Calotă,adevarul.ro,0,0,1,1,0.0,0.0
George Teșeleanu,adevarul.ro,0,0,4,4,0.0,0.0
Marcian Bleahu,adevarul.ro,0,0,2,2,0.0,0.0
Marius Vizer,adevarul.ro,0,0,2,2,0.0,0.0
Miercurea Ciuc,adevarul.ro,0,0,2,2,0.0,0.0
Mihail Gorbaciov,adevarul.ro,0,0,1,1,0.0,0.0
Radu Rey,adevarul.ro,0,0,1,1,0.0,0.0
Regatul Unit,adevarul.ro,1,0,2,3,0.3333333333333333,0.3333333333333333
Teșeleanu,adevarul.ro,0,0,1,1,0.0,0.0
Thiess,adevarul.ro,0,0,2,2,0.0,0.0
Vălenii de Munte,adevarul.ro,0,0,1,1,0.0,0.0
Cristina Dumitrache,adevarul.ro,0,0,1,1,0.0,0.0
fin,adevarul.ro,0,0,2,2,0.0,0.0
greblă,stirileprotv.ro,0,0,1,1,0.0,0.0
Ilan Laufer,stirileprotv.ro,0,0,1,1,0.0,0.0
Liei Olguța Vasilescu,stirileprotv.ro,0,0,1,1,0.0,0.0
Mircea Drăghici,stirileprotv.ro,0,0,1,1,0.0,0.0
Toni Greblă,stirileprotv.ro,0,0,1,1,0.0,0.0
Vasilescu,stirileprotv.ro,0,0,1,1,0.0,0.0
Abrudean,www.realitatea.net,0,0,1,1,0.0,0.0
Mircea Abrudean,www.realitatea.net,0,0,1,1,0.0,0.0
pucist,www.romaniatv.net,0,1,0,1,-1.0,1.0
Codruța Kovesi,adevarul.ro,0,0,1,1,0.0,0.0
Kovesi,adevarul.ro,0,1,1,2,-0.5,0.5
Alex Thompson,www.g4media.ro,0,0,1,1,0.0,0.0
Barack Obama,www.g4media.ro,0,0,1,1,0.0,0.0
Beau,www.g4media.ro,0,0,1,1,0.0,0.0
Bill Clinton,www.g4media.ro,0,0,1,1,0.0,0.0
Donald Trump Jr,www.g4media.ro,0,1,0,1,-1.0,1.0
Hillary Clinton,www.g4media.ro,0,0,1,1,0.0,0.0
Jake Tapper,www.g4media.ro,0,0,1,1,0.0,0.0
Joe Biden,www.g4media.ro,0,0,1,1,0.0,0.0
Joe,www.g4media.ro,0,1,0,1,-1.0,1.0
Kamala Harris,www.g4media.ro,0,0,1,1,0.0,0.0
X,www.g4media.ro,0,0,1,1,0.0,0.0
adversar,www.g4media.ro,0,3,0,3,-1.0,1.0
democrat,www.g4media.ro,0,0,1,1,0.0,0.0
republican,www.g4media.ro,0,0,1,1,0.0,0.0
tată,www.g4media.ro,0,1,4,5,-0.2,0.2
Moș,www.gandul.ro,0,1,0,1,-1.0,1.0
Moș Crăciun,www.gandul.ro,0,1,0,1,-1.0,1.0
Adriana Dudună,www.romaniatv.net,0,0,1,1,0.0,0.0
Cîmpeanu,www.romaniatv.net,0,0,1,1,0.0,0.0
David,www.romaniatv.net,0,0,1,1,0.0,0.0
Simona Crisbășanu,www.romaniatv.net,0,0,1,1,0.0,0.0
elev,www.romaniatv.net,5,1,3,9,0.4444444444444444,0.4444444444444444
rector,www.romaniatv.net,0,0,1,1,0.0,0.0
diasporă,www.comisarul.ro,0,0,1,1,0.0,0.0
Hosu,www.comisarul.ro,0,0,1,1,0.0,0.0
Ioan Hosu,www.comisarul.ro,0,0,2,2,0.0,0.0
Alexandru Iordan,recorder.ro,0,0,1,1,0.0,0.0
Andaluzia Luca,recorder.ro,0,0,1,1,0.0,0.0
Chilia Veche,recorder.ro,0,0,1,1,0.0,0.0
Eugen Teodorovici,recorder.ro,0,0,3,3,0.0,0.0
George Șișcu,recorder.ro,0,0,1,1,0.0,0.0
Mauritania,recorder.ro,0,0,1,1,0.0,0.0
Michael Gudu,recorder.ro,0,0,1,1,0.0,0.0
Piatra Neamț,recorder.ro,0,2,2,4,-0.5,0.5
Senegal,recorder.ro,0,0,1,1,0.0,0.0
Slovac,recorder.ro,0,0,1,1,0.0,0.0
Sulina,recorder.ro,0,0,1,1,0.0,0.0
Vintilă Corbul,recorder.ro,0,0,1,1,0.0,0.0
Mirela Furtună,recorder.ro,0,0,1,1,0.0,0.0
Pintea,recorder.ro,0,0,1,1,0.0,0.0
dramaturg,recorder.ro,0,0,1,1,0.0,0.0
tulcean,recorder.ro,0,0,2,2,0.0,0.0
tulcen,recorder.ro,0,0,1,1,0.0,0.0
Ștefan Caraman,recorder.ro,0,0,1,1,0.0,0.0
Ștefana Zibileanu,recorder.ro,0,0,1,1,0.0,0.0
Ciolacu,a1.ro,0,0,2,2,0.0,0.0
Israel,www.comisarul.ro,0,0,2,2,0.0,0.0
Andrei Șelaru,www.digi24.ro,0,0,1,1,0.0,0.0
Selly,www.digi24.ro,0,0,1,1,0.0,0.0
adolescent,www.digi24.ro,0,1,1,2,-0.5,0.5
toți,www.digi24.ro,0,1,0,1,-1.0,1.0
Shelly,www.digi24.ro,0,0,1,1,0.0,0.0
Nicolae Vlahu,primanews.ro,0,0,1,1,0.0,0.0
Valeriu Suhan,primanews.ro,0,0,1,1,0.0,0.0
Galileea,www.euronews.ro,0,0,1,1,0.0,0.0
Haifa,www.euronews.ro,0,0,1,1,0.0,0.0
Nazareth,www.euronews.ro,0,0,1,1,0.0,0.0
comandat,www.euronews.ro,0,1,0,1,-1.0,1.0
Elena Costache,www.antena3.ro,0,0,1,1,0.0,0.0
beneficiar,www.antena3.ro,0,0,3,3,0.0,0.0
Marian Neacșu,www.antena3.ro,0,0,1,1,0.0,0.0
Anca Grădinaru,www.antena3.ro,0,0,1,1,0.0,0.0
Anglia,www.antena3.ro,0,0,1,1,0.0,0.0
Taiwan,www.antena3.ro,0,1,1,2,-0.5,0.5
Turcan,www.antena3.ro,0,1,0,1,-1.0,1.0
Turciei,www.antena3.ro,0,0,1,1,0.0,0.0
Eugen Rădulescu,www.romaniatv.net,0,2,1,3,-0.6666666666666666,0.6666666666666666
Rădulescu,www.romaniatv.net,0,1,1,2,-0.5,0.5
antreprenor,www.realitatea.net,1,0,0,1,1.0,1.0
fermier,www.realitatea.net,1,1,0,2,0.0,0.0
von der Leyen,www.realitatea.net,0,1,0,1,-1.0,1.0
Canadei,www.antena3.ro,0,0,1,1,0.0,0.0
Justin Trudeau,www.antena3.ro,0,0,1,1,0.0,0.0
Bixad,recorder.ro,0,0,1,1,0.0,0.0
Gheorghe Cârciu,recorder.ro,0,1,1,2,-0.5,0.5
Hexagon,recorder.ro,0,0,1,1,0.0,0.0
Ioan Tătar,recorder.ro,0,1,0,1,-1.0,1.0
Radu Moraru,recorder.ro,0,0,1,1,0.0,0.0
realizator,recorder.ro,0,1,4,5,-0.2,0.2
Dom,www.news.ro,0,0,1,1,0.0,0.0
Nicolae-Ionel Ciucă,www.news.ro,0,1,0,1,-1.0,1.0
Cazanciuc,www.news.ro,0,0,1,1,0.0,0.0
Alex Dima,www.antena3.ro,0,0,1,1,0.0,0.0
Dani Mocanu,adevarul.ro,0,2,1,3,-0.6666666666666666,0.6666666666666666
internat,adevarul.ro,0,0,2,2,0.0,0.0
manelist,adevarul.ro,0,2,0,2,-1.0,1.0
Gheboasă,adevarul.ro,0,1,0,1,-1.0,1.0
Marian Motocu,www.b1tv.ro,0,2,0,2,-1.0,1.0
Motoc,www.b1tv.ro,0,1,0,1,-1.0,1.0
operator,www.b1tv.ro,0,1,0,1,-1.0,1.0
Petru Budeanu,www.b1tv.ro,0,0,1,1,0.0,0.0
atașat militar,www.b1tv.ro,0,0,1,1,0.0,0.0
Evgheni Ignatiev,www.b1tv.ro,0,0,1,1,0.0,0.0
Ion Antonescu,www.b1tv.ro,0,1,0,1,-1.0,1.0
polițist,www.b1tv.ro,0,1,0,1,-1.0,1.0
procuror,www.b1tv.ro,0,5,2,7,-0.7142857142857143,0.7142857142857143
suspect,www.b1tv.ro,0,1,0,1,-1.0,1.0
persoană adultă,www.romaniatv.net,0,0,1,1,0.0,0.0
creditor,www.euronews.ro,0,0,1,1,0.0,0.0
Mihai Predoiu,www.euronews.ro,0,1,0,1,-1.0,1.0
Gheorghe Vela,www.romaniatv.net,0,0,1,1,0.0,0.0
Tanczos Barna,www.romaniatv.net,0,0,2,2,0.0,0.0
Violeta Alexandru,www.romaniatv.net,0,0,1,1,0.0,0.0
farmacist,www.romaniatv.net,0,0,1,1,0.0,0.0
personal militar,www.romaniatv.net,0,0,1,1,0.0,0.0
salvator,www.romaniatv.net,0,0,1,1,0.0,0.0
Gigi Becali,www.comisarul.ro,0,3,4,7,-0.42857142857142855,0.42857142857142855
Marcel Boloș,www.g4media.ro,0,0,3,3,0.0,0.0
bugetar,www.g4media.ro,0,6,0,6,-1.0,1.0
Drulă,www.cotidianul.ro,0,1,0,1,-1.0,1.0
constructor,recorder.ro,0,1,1,2,-0.5,0.5
reporter,www.realitatea.net,0,0,1,1,0.0,0.0
austriac,www.antena3.ro,0,1,0,1,-1.0,1.0
Olanda,www.antena3.ro,0,2,2,4,-0.5,0.5
colegiu parlamentar,stirileprotv.ro,0,0,1,1,0.0,0.0
muncitor,stirileprotv.ro,1,0,0,1,1.0,1.0
juriști,www.gandul.ro,0,0,1,1,0.0,0.0
Alexandru Mazăre,www.realitatea.net,0,0,1,1,0.0,0.0
Constanța,www.realitatea.net,1,0,1,2,0.5,0.5
Cătălin Voicu,www.realitatea.net,0,0,1,1,0.0,0.0
Felix Stroe,www.realitatea.net,0,0,1,1,0.0,0.0
Radu Mazăre,www.realitatea.net,0,0,1,1,0.0,0.0
Stroe,www.realitatea.net,0,0,2,2,0.0,0.0
comandant,www.realitatea.net,0,0,1,1,0.0,0.0
frate,www.realitatea.net,0,0,2,2,0.0,0.0
viceprimar,www.realitatea.net,0,0,2,2,0.0,0.0
Attila Verestóy,pressone.ro,0,0,1,1,0.0,0.0
Borbély László,pressone.ro,0,1,0,1,-1.0,1.0
Budapestei,pressone.ro,0,0,2,2,0.0,0.0
Domokos Géza,pressone.ro,0,0,2,2,0.0,0.0
Emil Constantinescu,pressone.ro,0,1,3,4,-0.25,0.25
Kántor Lajos,pressone.ro,0,0,1,1,0.0,0.0
Kőrössi József,pressone.ro,0,0,1,1,0.0,0.0
Lucian Blaga,pressone.ro,0,0,1,1,0.0,0.0
László Tőkés,pressone.ro,0,0,2,2,0.0,0.0
Marko Attila,pressone.ro,0,1,2,3,-0.3333333333333333,0.3333333333333333
Markó Béla,pressone.ro,0,0,4,4,0.0,0.0
Octav Cozmâncă,pressone.ro,0,0,1,1,0.0,0.0
Raul Ștef,pressone.ro,0,1,4,5,-0.2,0.2
Sfântu Gheorghe,pressone.ro,0,0,2,2,0.0,0.0
dizident,pressone.ro,0,1,0,1,-1.0,1.0
Bakk Miklós,pressone.ro,0,1,1,2,-0.5,0.5
majoritate,pressone.ro,0,1,0,1,-1.0,1.0
nevinovat,pressone.ro,0,1,0,1,-1.0,1.0
nomenclaturist,pressone.ro,0,2,0,2,-1.0,1.0
Szőcs Géza,pressone.ro,0,0,1,1,0.0,0.0
secui,pressone.ro,0,0,1,1,0.0,0.0
traducător,pressone.ro,0,0,1,1,0.0,0.0
Ioan Stan,agerpres.ro,0,0,1,1,0.0,0.0
Dubai,www.cotidianul.ro,0,1,1,2,-0.5,0.5
Emil Boc,www.cotidianul.ro,0,1,0,1,-1.0,1.0
Grecia,www.cotidianul.ro,0,0,2,2,0.0,0.0
Ilfov,www.cotidianul.ro,0,0,1,1,0.0,0.0
Statele Unite ale Americii,www.cotidianul.ro,0,0,2,2,0.0,0.0
Tudose,www.cotidianul.ro,0,0,1,1,0.0,0.0
adept,www.cotidianul.ro,0,2,0,2,-1.0,1.0
cirac,www.cotidianul.ro,0,2,0,2,-1.0,1.0
concetățean,www.cotidianul.ro,0,1,0,1,-1.0,1.0
corif,www.cotidianul.ro,0,1,0,1,-1.0,1.0
doctorand,www.cotidianul.ro,0,0,1,1,0.0,0.0
haidamac,www.cotidianul.ro,0,1,0,1,-1.0,1.0
informatician,www.cotidianul.ro,0,0,1,1,0.0,0.0
jurist,www.cotidianul.ro,0,1,1,2,-0.5,0.5
Cristela,www.realitatea.net,0,0,1,1,0.0,0.0
David Popovici,www.realitatea.net,1,0,0,1,1.0,1.0
spectator,www.realitatea.net,0,0,1,1,0.0,0.0
Darmanin,www.aktual24.ro,0,0,1,1,0.0,0.0
Gerald Darmanin,www.aktual24.ro,0,0,1,1,0.0,0.0
Guyana Franceză,www.aktual24.ro,0,0,1,1,0.0,0.0
criminal,www.aktual24.ro,0,2,0,2,-1.0,1.0
traficant,www.aktual24.ro,0,1,0,1,-1.0,1.0
Ilinca,www.cotidianul.ro,0,0,1,1,0.0,0.0
actor,www.digi24.ro,0,1,4,5,-0.2,0.2
Raluca Turcan,agerpres.ro,0,0,5,5,0.0,0.0
Ilie Năstase,www.digi24.ro,0,0,2,2,0.0,0.0
Suciu,agerpres.ro,0,0,2,2,0.0,0.0
Vicepreședintele,agerpres.ro,0,1,1,2,-0.5,0.5
Costanda,www.gandul.ro,0,1,0,1,-1.0,1.0
Constanda,www.gandul.ro,0,0,1,1,0.0,0.0
Creștin,www.gandul.ro,0,0,1,1,0.0,0.0
oricine,www.gandul.ro,0,1,1,2,-0.5,0.5
Ala,www.luju.ro,0,1,0,1,-1.0,1.0
Algeria,www.luju.ro,0,0,1,1,0.0,0.0
America,www.luju.ro,0,0,1,1,0.0,0.0
Amsterdam,www.luju.ro,0,0,1,1,0.0,0.0
Azerbaijan,www.luju.ro,0,1,1,2,-0.5,0.5
Biden,www.luju.ro,0,1,0,1,-1.0,1.0
Canada,www.luju.ro,0,0,1,1,0.0,0.0
China,www.luju.ro,0,1,2,3,-0.3333333333333333,0.3333333333333333
Georgia,www.luju.ro,0,1,0,1,-1.0,1.0
Harley-Davidson,www.luju.ro,1,0,0,1,1.0,1.0
India,www.luju.ro,1,0,0,1,1.0,1.0
Indonezia,www.luju.ro,0,0,1,1,0.0,0.0
indonezian,www.luju.ro,0,0,1,1,0.0,0.0
James Bond,www.luju.ro,0,0,1,1,0.0,0.0
Marin,www.luju.ro,0,0,1,1,0.0,0.0
Musk,www.luju.ro,0,0,2,2,0.0,0.0
Napoleon,www.luju.ro,0,1,0,1,-1.0,1.0
Olanda,www.luju.ro,0,0,1,1,0.0,0.0
Rus,www.luju.ro,1,0,0,1,1.0,1.0
Alexis Sanchez,www.luju.ro,0,1,0,1,-1.0,1.0
Thierry Breton,www.luju.ro,0,1,2,3,-0.3333333333333333,0.3333333333333333
Uniunea,www.luju.ro,0,1,1,2,-0.5,0.5
Ursula von der Leyen,www.luju.ro,0,0,1,1,0.0,0.0
Viena,www.luju.ro,0,0,2,2,0.0,0.0
Voda Lapusneanu,www.luju.ro,0,1,0,1,-1.0,1.0
ală,www.luju.ro,0,1,0,1,-1.0,1.0
băiat,www.luju.ro,0,4,0,4,-1.0,1.0
baschetbalist,www.luju.ro,1,0,0,1,1.0,1.0
comisar,www.luju.ro,0,3,0,3,-1.0,1.0
economist,www.luju.ro,0,0,1,1,0.0,0.0
erou,www.luju.ro,1,0,0,1,1.0,1.0
europen,www.luju.ro,0,1,0,1,-1.0,1.0
fondator,www.luju.ro,1,0,0,1,1.0,1.0
loser,www.luju.ro,0,2,0,2,-1.0,1.0
perdant,www.luju.ro,0,2,0,2,-1.0,1.0
tip,www.luju.ro,1,0,0,1,1.0,1.0
Brazilia,adevarul.ro,0,1,1,2,-0.5,0.5
Iordania,adevarul.ro,0,0,1,1,0.0,0.0
Peru,adevarul.ro,0,0,1,1,0.0,0.0
Zimbabwe,adevarul.ro,0,0,1,1,0.0,0.0
Cristela Georgescu,www.romaniatv.net,0,1,2,3,-0.3333333333333333,0.3333333333333333
Călin,www.romaniatv.net,0,0,2,2,0.0,0.0
Georgiana Teodorescu,www.romaniatv.net,0,0,1,1,0.0,0.0
soție,www.romaniatv.net,0,1,5,6,-0.16666666666666666,0.16666666666666666
Nicolae Vlahu,www.romaniatv.net,0,0,1,1,0.0,0.0
Vladimir Voronin,adevarul.ro,0,1,0,1,-1.0,1.0
refugiat,adevarul.ro,0,1,1,2,-0.5,0.5
plen,www.luju.ro,0,0,1,1,0.0,0.0
asistent,www.luju.ro,0,0,1,1,0.0,0.0
bodyguard,adevarul.ro,0,1,0,1,-1.0,1.0
individ,adevarul.ro,0,2,2,4,-0.5,0.5
Botond,primanews.ro,0,0,1,1,0.0,0.0
Bord,pressone.ro,0,1,0,1,-1.0,1.0
Brătian,pressone.ro,1,0,0,1,1.0,1.0
Liliana Stîngaciu,pressone.ro,0,0,2,2,0.0,0.0
Petru Tâmpla,pressone.ro,1,0,1,2,0.5,0.5
Cucerdea,pressone.ro,0,0,1,1,0.0,0.0
Gheorghe Stroia,pressone.ro,0,1,0,1,-1.0,1.0
Ghiță Stroia,pressone.ro,0,1,0,1,-1.0,1.0
Maxim,pressone.ro,0,2,0,2,-1.0,1.0
Morar,pressone.ro,0,0,1,1,0.0,0.0
Nea Maxim,pressone.ro,0,0,1,1,0.0,0.0
Peneliști,pressone.ro,0,0,1,1,0.0,0.0
Vasile Morar,pressone.ro,0,0,2,2,0.0,0.0
Stroia,pressone.ro,0,1,0,1,-1.0,1.0
Târnăveni,pressone.ro,0,0,1,1,0.0,0.0
nea Augustin Maxim,pressone.ro,0,0,1,1,0.0,0.0
nea Maxime,pressone.ro,0,1,0,1,-1.0,1.0
suflet,pressone.ro,0,1,0,1,-1.0,1.0
vice,pressone.ro,0,1,0,1,-1.0,1.0
învățătoare,pressone.ro,0,0,2,2,0.0,0.0
Șeulia de Mureș,pressone.ro,0,0,1,1,0.0,0.0
țară,pressone.ro,0,1,0,1,-1.0,1.0
Predoiu,www.aktual24.ro,0,0,2,2,0.0,0.0
Chitila,www.digi24.ro,0,0,1,1,0.0,0.0
Cîrstoiu,www.digi24.ro,0,0,2,2,0.0,0.0
Cătălin Cîrstoiu,www.digi24.ro,0,0,4,4,0.0,0.0
medic,www.digi24.ro,0,6,4,10,-0.6,0.6
Adrian Câciu,www.digi24.ro,0,0,2,2,0.0,0.0
Angela Merkel,www.activenews.ro,0,1,0,1,-1.0,1.0
Angele Mekel,www.activenews.ro,0,1,0,1,-1.0,1.0
Dick Schoof,www.activenews.ro,0,1,0,1,-1.0,1.0
Friedrich Merkel,www.activenews.ro,0,1,0,1,-1.0,1.0
Geert Wilders,www.activenews.ro,0,1,0,1,-1.0,1.0
Germania,www.activenews.ro,0,2,1,3,-0.6666666666666666,0.6666666666666666
Herbert Kichl,www.activenews.ro,0,1,0,1,-1.0,1.0
Merkel,www.activenews.ro,0,1,0,1,-1.0,1.0
Merz,www.activenews.ro,0,3,0,3,-1.0,1.0
Wilders,www.activenews.ro,0,1,0,1,-1.0,1.0
cancelar,www.activenews.ro,0,1,0,1,-1.0,1.0
Adrian Veștea,pressone.ro,0,0,1,1,0.0,0.0
Andrei Țărnea,pressone.ro,0,0,1,1,0.0,0.0
Bianca Felseghi,pressone.ro,0,0,2,2,0.0,0.0
Dortmund,pressone.ro,0,0,1,1,0.0,0.0
Duisburg,pressone.ro,0,0,1,1,0.0,0.0
Laura Popa,pressone.ro,0,0,1,1,0.0,0.0
Luiza Popovici,pressone.ro,0,0,1,1,0.0,0.0
observator,pressone.ro,0,3,8,11,-0.2727272727272727,0.2727272727272727
Pavel Durov,pressone.ro,0,1,0,1,-1.0,1.0
regie,pressone.ro,0,1,0,1,-1.0,1.0
Tristan Tate,pressone.ro,0,1,0,1,-1.0,1.0
Vladimirescu,pressone.ro,0,1,0,1,-1.0,1.0
Bucureștean,pressone.ro,3,3,1,7,0.0,0.0
Adrian Curaj,pressone.ro,0,0,1,1,0.0,0.0
Andea,pressone.ro,0,0,1,1,0.0,0.0
Burnete,pressone.ro,0,0,2,2,0.0,0.0
Constantin Ciutacu,pressone.ro,0,0,1,1,0.0,0.0
Costoiu,pressone.ro,0,0,2,2,0.0,0.0
Călimănești,pressone.ro,0,0,1,1,0.0,0.0
Dobrescu,pressone.ro,0,0,1,1,0.0,0.0
Pușcașu,pressone.ro,0,0,1,1,0.0,0.0
Doru Vladimir Pușcașu,pressone.ro,0,0,1,1,0.0,0.0
Dumitra Popescu,pressone.ro,0,0,2,2,0.0,0.0
Flagrant,pressone.ro,0,1,0,1,-1.0,1.0
Gabriel Boroi,pressone.ro,0,0,2,2,0.0,0.0
Gheorghiță Mateuț,pressone.ro,0,2,1,3,-0.6666666666666666,0.6666666666666666
Gălbenușă,pressone.ro,0,1,0,1,-1.0,1.0
Horia Iovu,pressone.ro,0,0,1,1,0.0,0.0
Iamandi,pressone.ro,0,1,1,2,-0.5,0.5
Iovu,pressone.ro,0,0,1,1,0.0,0.0
Laurei Codruța Kövesi,pressone.ro,0,0,1,1,0.0,0.0
Luca Iamandi,pressone.ro,0,1,1,2,-0.5,0.5
Marius Gălbenușă,pressone.ro,0,0,1,1,0.0,0.0
Mateuț,pressone.ro,0,1,0,1,-1.0,1.0
Mihail Hărdău,pressone.ro,0,0,1,1,0.0,0.0
Muraru,pressone.ro,0,1,2,3,-0.3333333333333333,0.3333333333333333
Paul Dobrescu,pressone.ro,0,0,3,3,0.0,0.0
Petru Andea,pressone.ro,0,0,1,1,0.0,0.0
Romeo Muraru,pressone.ro,0,0,1,1,0.0,0.0
Teodor Petrescu,pressone.ro,0,0,1,1,0.0,0.0
Tobă,pressone.ro,0,0,1,1,0.0,0.0
Vergil Marian Muraru,pressone.ro,0,0,1,1,0.0,0.0
Vergil Muraru,pressone.ro,0,0,2,2,0.0,0.0
Vladimir Tismăneanu,pressone.ro,0,0,2,2,0.0,0.0
component,pressone.ro,0,0,1,1,0.0,0.0
Ovidiu Tender,pressone.ro,0,0,1,1,0.0,0.0
Ștefan Grigoraș,pressone.ro,0,0,1,1,0.0,0.0
Crin,www.antena3.ro,0,0,3,3,0.0,0.0
ambii,www.antena3.ro,0,1,0,1,-1.0,1.0
Australia,www.g4media.ro,0,2,1,3,-0.6666666666666666,0.6666666666666666
Budapesta,www.g4media.ro,1,0,2,3,0.3333333333333333,0.3333333333333333
Canada,www.g4media.ro,0,2,0,2,-1.0,1.0
Zelea Codreanu,www.g4media.ro,0,1,0,1,-1.0,1.0
absent,www.g4media.ro,0,1,0,1,-1.0,1.0
absentist,www.g4media.ro,0,1,0,1,-1.0,1.0
asasin,www.g4media.ro,0,1,0,1,-1.0,1.0
bugetari,www.g4media.ro,0,1,0,1,-1.0,1.0
nehotărât,www.g4media.ro,0,1,0,1,-1.0,1.0
sabotor,www.g4media.ro,0,1,0,1,-1.0,1.0
strămoș,www.g4media.ro,0,1,0,1,-1.0,1.0
Mihaiu,www.b1tv.ro,0,1,1,2,-0.5,0.5
AUR,stirileprotv.ro,0,1,0,1,-1.0,1.0
Tanczos Barna,stirileprotv.ro,0,5,2,7,-0.7142857142857143,0.7142857142857143
Slovenia,stirileprotv.ro,0,1,0,1,-1.0,1.0
domn,stirileprotv.ro,0,1,1,2,-0.5,0.5
Eduard Novak,stirileprotv.ro,0,1,0,1,-1.0,1.0
Novak,stirileprotv.ro,0,1,0,1,-1.0,1.0
etnic,stirileprotv.ro,0,0,1,1,0.0,0.0
hocheist,stirileprotv.ro,0,1,0,1,-1.0,1.0
iști,stirileprotv.ro,0,1,0,1,-1.0,1.0
jucător,stirileprotv.ro,0,1,0,1,-1.0,1.0
lume,stirileprotv.ro,0,4,0,4,-1.0,1.0
suporter,stirileprotv.ro,0,0,1,1,0.0,0.0
Ținutul Secuiesc,stirileprotv.ro,0,0,2,2,0.0,0.0
Daniel Constantin,www.comisarul.ro,0,1,0,1,-1.0,1.0
Domnia Sa,www.comisarul.ro,0,1,0,1,-1.0,1.0
Voiculescu,www.comisarul.ro,0,1,0,1,-1.0,1.0
chiulangiu,www.comisarul.ro,0,1,0,1,-1.0,1.0
consoartă,www.comisarul.ro,0,0,1,1,0.0,0.0
Mircea Marian,www.comisarul.ro,0,0,1,1,0.0,0.0
turnător,www.comisarul.ro,0,2,0,2,-1.0,1.0
Felix,www.comisarul.ro,0,1,0,1,-1.0,1.0
șomer,www.comisarul.ro,0,1,0,1,-1.0,1.0
Ion Mihalache,www.realitatea.net,0,0,1,1,0.0,0.0
Muscelu,www.realitatea.net,0,0,1,1,0.0,0.0
bunică,www.realitatea.net,1,0,1,2,0.5,0.5
fondator,www.realitatea.net,0,0,1,1,0.0,0.0
străbunic,www.realitatea.net,0,0,1,1,0.0,0.0
,www.mediafax.ro,0,2,0,2,-1.0,1.0
Alexandru Nazare,www.mediafax.ro,0,1,1,2,-0.5,0.5
dictator,www.mediafax.ro,0,2,0,2,-1.0,1.0
mascul,www.mediafax.ro,0,1,0,1,-1.0,1.0
răvășitor,www.mediafax.ro,0,1,0,1,-1.0,1.0
Vlad Voiculescu,www.mediafax.ro,0,1,1,2,-0.5,0.5
birjar,www.mediafax.ro,0,1,0,1,-1.0,1.0
caltaboș,www.mediafax.ro,0,1,0,1,-1.0,1.0
comentator,www.mediafax.ro,0,1,0,1,-1.0,1.0
ins,www.mediafax.ro,0,1,0,1,-1.0,1.0
înlocuitor,www.mediafax.ro,0,0,2,2,0.0,0.0
buzoi,agerpres.ro,0,1,0,1,-1.0,1.0
pesediști,agerpres.ro,0,1,0,1,-1.0,1.0
Rareș Bogdan,stirileprotv.ro,0,0,1,1,0.0,0.0
MRU,pressone.ro,0,0,1,1,0.0,0.0
Mihai Răzvan Ungureanu,pressone.ro,0,0,1,1,0.0,0.0
Richard Nixon,pressone.ro,0,0,1,1,0.0,0.0
Ronald Reagan,pressone.ro,1,0,1,2,0.5,0.5
Vasile Bănescu,www.antena3.ro,0,0,1,1,0.0,0.0
Raul Ilea,primanews.ro,0,0,1,1,0.0,0.0
meteorolog,primanews.ro,0,0,1,1,0.0,0.0
Craiova,www.romaniatv.net,0,0,1,1,0.0,0.0
subsecretar de stat,www.romaniatv.net,0,0,1,1,0.0,0.0
Sorin Cîmpeanu,www.antena3.ro,0,0,1,1,0.0,0.0
Valeriu Steriu,www.antena3.ro,0,0,1,1,0.0,0.0
Bogdan Locu,www.luju.ro,0,0,1,1,0.0,0.0
Dianei Sosoaca,www.luju.ro,1,0,1,2,0.5,0.5
Gheorghe Stan,www.luju.ro,0,0,1,1,0.0,0.0
Președintele României,www.luju.ro,0,0,1,1,0.0,0.0
Scantei,www.luju.ro,1,0,0,1,1.0,1.0
contestator,www.luju.ro,0,0,1,1,0.0,0.0
particular,www.luju.ro,0,0,2,2,0.0,0.0
semnător,www.luju.ro,0,0,1,1,0.0,0.0
Alexandru Iacobescu,pressone.ro,0,0,1,1,0.0,0.0
Constantin Popescu,pressone.ro,0,0,1,1,0.0,0.0
Cătălin Teodorescu,pressone.ro,0,1,0,1,-1.0,1.0
Dar,pressone.ro,0,0,1,1,0.0,0.0
Dariela Nicolae,pressone.ro,0,0,1,1,0.0,0.0
Dary,pressone.ro,1,0,0,1,1.0,1.0
Dorel Ciută,pressone.ro,0,0,1,1,0.0,0.0
Emma Victoria Țârlea,pressone.ro,0,0,1,1,0.0,0.0
Florian Nicolae,pressone.ro,0,0,1,1,0.0,0.0
Ioan Oltean,pressone.ro,0,0,2,2,0.0,0.0
Ionel Manțog,pressone.ro,0,0,2,2,0.0,0.0
Liviu Nicolicea,pressone.ro,0,0,1,1,0.0,0.0
Manțog,pressone.ro,0,1,0,1,-1.0,1.0
Nicolae Băloi,pressone.ro,0,0,1,1,0.0,0.0
Nicolicea,pressone.ro,0,2,2,4,-0.5,0.5
Niculina Mocioi,pressone.ro,0,0,1,1,0.0,0.0
Niculinei Mocioi,pressone.ro,0,0,1,1,0.0,0.0
Peia,pressone.ro,0,0,1,1,0.0,0.0
Piteștiu,pressone.ro,0,0,1,1,0.0,0.0
Radu Gelu Alin,pressone.ro,0,0,2,2,0.0,0.0
Vera,pressone.ro,1,0,0,1,1.0,1.0
Speranța Ianculescu,pressone.ro,0,0,1,1,0.0,0.0
Tudor Pendiuc,pressone.ro,0,0,1,1,0.0,0.0
Vasile Arcanu,pressone.ro,0,0,2,2,0.0,0.0
asistent manager,pressone.ro,0,0,1,1,0.0,0.0
Bogdan Bocșe,pressone.ro,0,0,1,1,0.0,0.0
Bogdan Pascu,pressone.ro,0,0,1,1,0.0,0.0
Bogdan Trif,www.aktual24.ro,0,1,0,1,-1.0,1.0
Călin,www.aktual24.ro,0,1,0,1,-1.0,1.0
Cornesti,www.aktual24.ro,0,0,1,1,0.0,0.0
Dorian Potra,www.aktual24.ro,0,0,1,1,0.0,0.0
Florin Lascu,www.aktual24.ro,0,2,0,2,-1.0,1.0
Horatiu Potra,www.aktual24.ro,0,2,1,3,-0.6666666666666666,0.6666666666666666
Manești,www.aktual24.ro,0,0,1,1,0.0,0.0
Medias,www.aktual24.ro,0,0,1,1,0.0,0.0
Mediasu,www.aktual24.ro,0,0,1,1,0.0,0.0
mercenar,www.aktual24.ro,0,3,0,3,-1.0,1.0
polițist,www.aktual24.ro,0,0,1,1,0.0,0.0
Potra,www.aktual24.ro,0,1,0,1,-1.0,1.0
Sibiu,www.aktual24.ro,0,1,3,4,-0.25,0.25
Trif,www.aktual24.ro,0,1,0,1,-1.0,1.0
Tuca,www.aktual24.ro,0,1,1,2,-0.5,0.5
anchetator,www.aktual24.ro,0,0,1,1,0.0,0.0
Sechila,www.aktual24.ro,0,1,0,1,-1.0,1.0
lucrător,www.aktual24.ro,0,1,1,2,-0.5,0.5
pedestru,www.aktual24.ro,0,1,0,1,-1.0,1.0
suspect,www.aktual24.ro,0,1,1,2,-0.5,0.5
personal,www.b1tv.ro,1,0,1,2,0.5,0.5
Bistrița,pressone.ro,0,0,3,3,0.0,0.0
Bălăjan,pressone.ro,0,1,0,1,-1.0,1.0
Corina Lupu,pressone.ro,0,0,1,1,0.0,0.0
Cristian Țetcu,pressone.ro,0,0,1,1,0.0,0.0
Dan Purel,pressone.ro,0,0,2,2,0.0,0.0
Dumitra,pressone.ro,0,0,1,1,0.0,0.0
Emil Moldovan,pressone.ro,0,0,1,1,0.0,0.0
Emil Radu Moldovan,pressone.ro,0,0,1,1,0.0,0.0
Gheorghe Bălăjan,pressone.ro,0,0,2,2,0.0,0.0
Ion Banciu,pressone.ro,0,0,1,1,0.0,0.0
Istrate Ștețco,pressone.ro,0,0,3,3,0.0,0.0
Iulian Herțanu,pressone.ro,0,0,1,1,0.0,0.0
Laurențiu Vamă,pressone.ro,0,1,0,1,-1.0,1.0
Liviu Rusu,pressone.ro,0,1,0,1,-1.0,1.0
Maria Anca,pressone.ro,0,0,1,1,0.0,0.0
Ministrul Pană,pressone.ro,0,1,0,1,-1.0,1.0
Moldovan,pressone.ro,0,0,1,1,0.0,0.0
Năsăud,pressone.ro,0,0,1,1,0.0,0.0
Octavian Morariu,pressone.ro,0,0,2,2,0.0,0.0
Silviu Florin Novac,pressone.ro,0,0,1,1,0.0,0.0
Tărpiu,pressone.ro,0,1,0,1,-1.0,1.0
Vasile Lupu,pressone.ro,0,0,2,2,0.0,0.0
auditor,pressone.ro,0,1,1,2,-0.5,0.5
Daniel Suciu,pressone.ro,0,1,0,1,-1.0,1.0
Tinel Gheorghe,pressone.ro,0,0,2,2,0.0,0.0
Ioan Țintean,pressone.ro,0,0,1,1,0.0,0.0
proiectant,pressone.ro,0,0,1,1,0.0,0.0
sfătuitor,pressone.ro,0,0,1,1,0.0,0.0
suroră,pressone.ro,0,0,2,2,0.0,0.0
Ștețco,pressone.ro,0,0,1,1,0.0,0.0
Țetcu,pressone.ro,0,0,1,1,0.0,0.0
Țintean,pressone.ro,0,0,1,1,0.0,0.0
Adrian Năstase,www.digi24.ro,0,2,2,4,-0.5,0.5
Armand Schor,www.digi24.ro,0,0,1,1,0.0,0.0
Arthur Finkelstein,www.digi24.ro,0,0,1,1,0.0,0.0
Arye Deri,www.digi24.ro,0,1,1,2,-0.5,0.5
Asaf Eisin,www.digi24.ro,0,0,1,1,0.0,0.0
Avital,www.digi24.ro,0,0,1,1,0.0,0.0
Avraham Morgenstern,www.digi24.ro,0,0,1,1,0.0,0.0
Benjamin Steinmetz,www.digi24.ro,0,0,1,1,0.0,0.0
Benny,www.digi24.ro,0,0,1,1,0.0,0.0
Schor,www.digi24.ro,0,0,2,2,0.0,0.0
Colette Avital,www.digi24.ro,0,0,1,1,0.0,0.0
Constanța,www.digi24.ro,0,0,3,3,0.0,0.0
Corbeanca,www.digi24.ro,0,0,1,1,0.0,0.0
Corneliu Tudor,www.digi24.ro,0,0,1,1,0.0,0.0
Dan Ioan Popescu,www.digi24.ro,0,0,1,1,0.0,0.0
Daniel Dragomir,www.digi24.ro,0,1,0,1,-1.0,1.0
David Geclowicz,www.digi24.ro,0,1,0,1,-1.0,1.0
Deri,www.digi24.ro,0,1,0,1,-1.0,1.0
Eyal,www.digi24.ro,1,0,0,1,1.0,1.0
Guineea,www.digi24.ro,0,0,1,1,0.0,0.0
Laura Codruța Kovesi,www.digi24.ro,0,1,1,2,-0.5,0.5
Mazăre,www.digi24.ro,0,1,1,2,-0.5,0.5
Morgenstern,www.digi24.ro,0,1,0,1,-1.0,1.0
Moshe Agavi,www.digi24.ro,0,0,1,1,0.0,0.0
Moshe Kantor,www.digi24.ro,0,1,0,1,-1.0,1.0
Moshe Klughaft,www.digi24.ro,0,0,1,1,0.0,0.0
Ovidiu Puțura,www.digi24.ro,0,1,0,1,-1.0,1.0
Radu Mazăre,www.digi24.ro,0,0,2,2,0.0,0.0
Ron Weiner,www.digi24.ro,0,1,0,1,-1.0,1.0
Roșia Montana,www.digi24.ro,0,1,0,1,-1.0,1.0
Sefi Shaked,www.digi24.ro,0,0,1,1,0.0,0.0
Shimon Shevez,www.digi24.ro,0,0,1,1,0.0,0.0
Silberstein,www.digi24.ro,0,0,1,1,0.0,0.0
Soroș,www.digi24.ro,0,1,0,1,-1.0,1.0
Steinmetz,www.digi24.ro,0,0,1,1,0.0,0.0
Săftica,www.digi24.ro,0,0,1,1,0.0,0.0
Tal Silberstein,www.digi24.ro,0,0,1,1,0.0,0.0
Vladimir Putin,www.digi24.ro,0,5,1,6,-0.8333333333333334,0.8333333333333334
Yitzhak Herzog,www.digi24.ro,0,0,2,2,0.0,0.0
activist,www.digi24.ro,0,1,0,1,-1.0,1.0
acționar,www.digi24.ro,0,0,1,1,0.0,0.0
anchetator,www.digi24.ro,0,1,0,1,-1.0,1.0
ofițer,www.digi24.ro,0,4,0,4,-1.0,1.0
Benjamin Netanyahu,www.digi24.ro,0,0,1,1,0.0,0.0
Ariel Sharon,www.digi24.ro,1,0,0,1,1.0,1.0
Beniamin Netanyahu,www.digi24.ro,0,0,1,1,0.0,0.0
Yitzhak Rabin,www.digi24.ro,0,0,1,1,0.0,0.0
Shimon Peres,www.digi24.ro,0,0,1,1,0.0,0.0
Ovadia Yosef,www.digi24.ro,0,0,1,1,0.0,0.0
strateg,www.digi24.ro,0,0,2,2,0.0,0.0
terorist,www.digi24.ro,0,1,0,1,-1.0,1.0
trădător,www.digi24.ro,0,1,0,1,-1.0,1.0
Olguța Vasilescu,observatornews.ro,0,1,1,2,-0.5,0.5
Radu Marinescu,observatornews.ro,0,1,2,3,-0.3333333333333333,0.3333333333333333
Mihai Tudose,primanews.ro,0,0,4,4,0.0,0.0
Alin Colega,www.comisarul.ro,0,0,1,1,0.0,0.0
Pîrvulescu,www.comisarul.ro,0,0,1,1,0.0,0.0
Grindeanu,primanews.ro,0,1,3,4,-0.25,0.25
lor,www.aktual24.ro,0,1,0,1,-1.0,1.0
pesedist,www.aktual24.ro,0,5,1,6,-0.8333333333333334,0.8333333333333334
putin,www.aktual24.ro,0,1,0,1,-1.0,1.0
comandant,www.euronews.ro,0,1,1,2,-0.5,0.5
Copenhaga,www.euronews.ro,0,1,0,1,-1.0,1.0
Danemarca,www.euronews.ro,0,0,2,2,0.0,0.0
Danemarcei,www.euronews.ro,0,0,1,1,0.0,0.0
Groenlanda,www.euronews.ro,0,0,2,2,0.0,0.0
JD Vance,www.euronews.ro,0,0,1,1,0.0,0.0
Regatul Danemarcei,www.euronews.ro,0,0,1,1,0.0,0.0
Susannah Meyers,www.euronews.ro,0,0,2,2,0.0,0.0
Vance,www.euronews.ro,0,1,0,1,-1.0,1.0
Chicago,www.comisarul.ro,0,0,1,1,0.0,0.0
Francisc,www.comisarul.ro,0,0,1,1,0.0,0.0
JD Vance,www.comisarul.ro,0,1,0,1,-1.0,1.0
Papa Francisc,www.comisarul.ro,0,1,0,1,-1.0,1.0
Papa Leon,www.comisarul.ro,0,0,1,1,0.0,0.0
Papei Leon,www.comisarul.ro,0,0,1,1,0.0,0.0
Ramesh Ponnuru,www.comisarul.ro,0,0,1,1,0.0,0.0
Robert Prevost,www.comisarul.ro,0,0,1,1,0.0,0.0
Steve Bannon,www.comisarul.ro,0,1,2,3,-0.3333333333333333,0.3333333333333333
credincios,www.comisarul.ro,1,1,0,2,0.0,0.0
papă,www.comisarul.ro,0,2,0,2,-1.0,1.0
proros,www.gandul.ro,0,1,0,1,-1.0,1.0
Abu Dhabi,www.romaniatv.net,0,0,1,1,0.0,0.0
Eduard Hellvig,www.romaniatv.net,0,0,1,1,0.0,0.0
Gabriel Vlase,www.romaniatv.net,0,1,0,1,-1.0,1.0
Hellvig,www.romaniatv.net,0,0,1,1,0.0,0.0
Kiev,www.romaniatv.net,0,0,1,1,0.0,0.0
Laura Codruța Kovesi,www.romaniatv.net,0,0,1,1,0.0,0.0
Liviu Stanciu,www.romaniatv.net,0,0,1,1,0.0,0.0
Lucian Pahonțu,www.romaniatv.net,0,1,0,1,-1.0,1.0
Marian Enache,www.romaniatv.net,0,0,2,2,0.0,0.0
Mihai Weber,www.romaniatv.net,0,0,1,1,0.0,0.0
Pahonțu,www.romaniatv.net,0,0,1,1,0.0,0.0
Victor Ciorbea,www.romaniatv.net,0,0,1,1,0.0,0.0
cei,www.romaniatv.net,0,2,0,2,-1.0,1.0
Iohannis,www.romaniatv.net,0,0,1,1,0.0,0.0
procuror general,www.romaniatv.net,0,0,1,1,0.0,0.0
finalist,www.gandul.ro,1,0,0,1,1.0,1.0
Ionuț Cristache,www.luju.ro,0,0,3,3,0.0,0.0
Vasile Dâncu,pressone.ro,0,1,0,1,-1.0,1.0
Balint Porcsalmi,primanews.ro,0,0,1,1,0.0,0.0
consultant,primanews.ro,0,0,1,1,0.0,0.0
președinte executiv,primanews.ro,0,0,1,1,0.0,0.0
Andreea Gabriela Onogea,agerpres.ro,0,0,1,1,0.0,0.0
Scandalagiii,www.comisarul.ro,0,1,0,1,-1.0,1.0
Statele Unite ale Americii,observatornews.ro,1,1,1,3,0.0,0.0
Cristian Erbașu,www.comisarul.ro,0,0,2,2,0.0,0.0
Erbașu,www.comisarul.ro,0,0,1,1,0.0,0.0
Iași,www.comisarul.ro,0,0,5,5,0.0,0.0
Mihai Rotaru,www.comisarul.ro,0,0,2,2,0.0,0.0
Rotaru,www.comisarul.ro,0,0,1,1,0.0,0.0
Sorina Stan Docuz,www.comisarul.ro,0,0,1,1,0.0,0.0
Sorin Stan Docuz,www.comisarul.ro,0,1,0,1,-1.0,1.0
Stan Docuz,www.comisarul.ro,0,0,1,1,0.0,0.0
ambii,www.comisarul.ro,0,1,0,1,-1.0,1.0
interpuși,www.comisarul.ro,0,1,0,1,-1.0,1.0
Dac,www.activenews.ro,0,0,1,1,0.0,0.0
Ghinion,www.aktual24.ro,0,1,0,1,-1.0,1.0
Sebastian Lazaroiu,www.aktual24.ro,0,0,3,3,0.0,0.0
Tarziu,www.aktual24.ro,0,2,1,3,-0.6666666666666666,0.6666666666666666
Vadim Tudor,www.aktual24.ro,0,1,0,1,-1.0,1.0
calaret,www.aktual24.ro,0,0,1,1,0.0,0.0
complice,www.aktual24.ro,0,1,0,1,-1.0,1.0
fraier,www.aktual24.ro,0,1,0,1,-1.0,1.0
sponsor,www.aktual24.ro,0,1,0,1,-1.0,1.0
Dominic Fritz,agerpres.ro,0,0,3,3,0.0,0.0
Fritz,agerpres.ro,0,0,3,3,0.0,0.0
bunică,agerpres.ro,0,0,1,1,0.0,0.0
mamelă,agerpres.ro,0,0,1,1,0.0,0.0
Dmitri Soin,www.antena3.ro,0,0,2,2,0.0,0.0
RSS Moldovenească,www.antena3.ro,0,0,1,1,0.0,0.0
Serghei Baburin,www.antena3.ro,0,0,1,1,0.0,0.0
Soin,www.antena3.ro,0,0,1,1,0.0,0.0
Tiraspol,www.antena3.ro,0,0,1,1,0.0,0.0
activist,www.antena3.ro,0,0,1,1,0.0,0.0
locotenent-colonel,www.antena3.ro,0,0,1,1,0.0,0.0
spion,www.antena3.ro,0,1,0,1,-1.0,1.0
veteran,www.antena3.ro,0,0,1,1,0.0,0.0
Bihor,www.romaniatv.net,1,0,1,2,0.5,0.5
bihorean,www.romaniatv.net,0,1,0,1,-1.0,1.0
nenorocit,www.romaniatv.net,0,1,0,1,-1.0,1.0
Andrew Tate,recorder.ro,0,0,2,2,0.0,0.0
Frații Tate,recorder.ro,0,2,0,2,-1.0,1.0
Orban Lasconi,recorder.ro,0,0,1,1,0.0,0.0
Sergei Lavrov,recorder.ro,0,1,0,1,-1.0,1.0
Tristan,recorder.ro,0,0,1,1,0.0,0.0
Alina Gorghiu,stirileprotv.ro,0,0,4,4,0.0,0.0
Cristian Parvulescu,stirileprotv.ro,0,0,2,2,0.0,0.0
consumator,primanews.ro,0,0,1,1,0.0,0.0
Guy Verhofstadt,www.cotidianul.ro,1,0,0,1,1.0,1.0
JD Vance,www.cotidianul.ro,0,1,0,1,-1.0,1.0
Leslie Nielsen,www.cotidianul.ro,0,0,1,1,0.0,0.0
Marine Le Pen,www.cotidianul.ro,0,1,2,3,-0.3333333333333333,0.3333333333333333
Neil Clark,www.cotidianul.ro,0,1,0,1,-1.0,1.0
aliat,www.cotidianul.ro,0,1,0,1,-1.0,1.0
critic,www.cotidianul.ro,0,1,0,1,-1.0,1.0
mahăr,www.cotidianul.ro,0,1,0,1,-1.0,1.0
delegat,www.gandul.ro,0,0,2,2,0.0,0.0
Daniel Zamfir,primanews.ro,0,0,2,2,0.0,0.0
client,primanews.ro,2,0,0,2,1.0,1.0
notar,primanews.ro,0,0,1,1,0.0,0.0
Cornu,adevarul.ro,0,0,1,1,0.0,0.0
Dubai,adevarul.ro,0,0,3,3,0.0,0.0
Istanbul,adevarul.ro,0,0,3,3,0.0,0.0
femeie,www.romaniatv.net,0,2,5,7,-0.2857142857142857,0.2857142857142857
Mehedinți,www.romaniatv.net,0,0,2,2,0.0,0.0
consilieră,www.romaniatv.net,0,0,1,1,0.0,0.0
Gorghiu,www.antena3.ro,0,0,2,2,0.0,0.0
interimar,www.antena3.ro,0,1,1,2,-0.5,0.5
Sofia,recorder.ro,0,0,2,2,0.0,0.0
Ecaterina Andronescu,a1.ro,0,1,2,3,-0.3333333333333333,0.3333333333333333
Marga,a1.ro,0,1,1,2,-0.5,0.5
Rector,a1.ro,0,1,0,1,-1.0,1.0
tot,a1.ro,0,1,3,4,-0.25,0.25
Cristina Tărteață,www.romaniatv.net,0,0,1,1,0.0,0.0
Crstina Tărteață,www.romaniatv.net,0,0,1,1,0.0,0.0
Marian Miluț,www.romaniatv.net,0,0,1,1,0.0,0.0
Sinecuriștii,www.romaniatv.net,0,1,0,1,-1.0,1.0
lucrătoare,www.romaniatv.net,0,1,0,1,-1.0,1.0
Belgia,adevarul.ro,0,0,4,4,0.0,0.0
Canada,adevarul.ro,0,0,2,2,0.0,0.0
Cristian Presură,adevarul.ro,0,0,1,1,0.0,0.0
Cătălin Predoi,adevarul.ro,0,1,0,1,-1.0,1.0
Danemarca,adevarul.ro,0,0,2,2,0.0,0.0
Monica Dajbog,adevarul.ro,0,0,1,1,0.0,0.0
Puntea de Greci,adevarul.ro,0,0,1,1,0.0,0.0
fizician,adevarul.ro,0,0,1,1,0.0,0.0
Țările de Jos,adevarul.ro,0,0,2,2,0.0,0.0
Bernd Baumann,www.aktual24.ro,0,0,1,1,0.0,0.0
Bjoern Hoecke,www.aktual24.ro,0,1,0,1,-1.0,1.0
Ferat Kocak,www.aktual24.ro,0,0,1,1,0.0,0.0
Germania de Vest,www.aktual24.ro,0,0,1,1,0.0,0.0
Gregor Gysi,www.aktual24.ro,0,0,1,1,0.0,0.0
Hoecke,www.aktual24.ro,0,0,1,1,0.0,0.0
Julia Kloeckner,www.aktual24.ro,0,0,1,1,0.0,0.0
Mathias Helferich,www.aktual24.ro,0,0,1,1,0.0,0.0
Maximilian Krah,www.aktual24.ro,0,0,1,1,0.0,0.0
Stanga,www.aktual24.ro,0,0,1,1,0.0,0.0
economist,www.aktual24.ro,1,1,0,2,0.0,0.0
Alexander Gauland,www.aktual24.ro,0,0,1,1,0.0,0.0
cadru medical,www.luju.ro,0,0,1,1,0.0,0.0
profesor,www.luju.ro,0,1,0,1,-1.0,1.0
Cătălin Tolontan,www.realitatea.net,0,1,0,1,-1.0,1.0
JD Vance,www.realitatea.net,1,1,0,2,0.0,0.0
Robert Turcescu,www.realitatea.net,0,0,2,2,0.0,0.0
Tolontan,www.realitatea.net,0,0,1,1,0.0,0.0
Turcescu,www.realitatea.net,0,0,1,1,0.0,0.0
Borcea,pressone.ro,0,1,0,1,-1.0,1.0
Senior Fellow,pressone.ro,0,0,1,1,0.0,0.0
colaboratoare,pressone.ro,0,0,1,1,0.0,0.0
comentatoare,pressone.ro,0,0,1,1,0.0,0.0
comunicatoare,pressone.ro,0,0,1,1,0.0,0.0
incomod,pressone.ro,0,1,0,1,-1.0,1.0
loialist,pressone.ro,0,1,0,1,-1.0,1.0
Bogotă,adevarul.ro,0,0,1,1,0.0,0.0
Columbia,adevarul.ro,0,1,1,2,-0.5,0.5
Columbie,adevarul.ro,0,0,1,1,0.0,0.0
Karoline Leavitt,adevarul.ro,0,0,1,1,0.0,0.0
Luis Gilberto Murillo,adevarul.ro,0,0,1,1,0.0,0.0
Gustavo Petro,adevarul.ro,0,0,1,1,0.0,0.0
Tom Homan,adevarul.ro,0,1,0,1,-1.0,1.0
imigrant,adevarul.ro,0,1,2,3,-0.3333333333333333,0.3333333333333333
migrant,adevarul.ro,0,1,1,2,-0.5,0.5
Fritz,www.euronews.ro,0,0,1,1,0.0,0.0
Sebastian Buzilă,agerpres.ro,0,0,1,1,0.0,0.0
Toplița,agerpres.ro,0,0,1,1,0.0,0.0
Alexandru Gussi,www.aktual24.ro,0,0,2,2,0.0,0.0
Pierre Hassner,www.aktual24.ro,0,0,1,1,0.0,0.0
Vladimir Tismaneanu,www.aktual24.ro,0,0,1,1,0.0,0.0
actorii,www.aktual24.ro,1,1,0,2,0.0,0.0
colaborator,www.aktual24.ro,0,1,0,1,-1.0,1.0
doamna Lasconi,www.aktual24.ro,1,0,1,2,0.5,0.5
politolog,www.aktual24.ro,0,1,3,4,-0.25,0.25
trădător,www.aktual24.ro,0,3,0,3,-1.0,1.0
victimă,www.aktual24.ro,0,1,0,1,-1.0,1.0
Alin Coleșa,www.cotidianul.ro,0,0,1,1,0.0,0.0
Ringo Dămureanu,www.cotidianul.ro,0,0,3,3,0.0,0.0
Dămureanu,www.cotidianul.ro,0,0,1,1,0.0,0.0
Neagu,www.cotidianul.ro,0,0,1,1,0.0,0.0
Scipnic,www.cotidianul.ro,0,0,1,1,0.0,0.0
Scripnic,www.cotidianul.ro,0,0,1,1,0.0,0.0
Neagu Ionuț,www.cotidianul.ro,0,0,1,1,0.0,0.0
Liliana Scripnic,www.cotidianul.ro,0,0,1,1,0.0,0.0
Dvs,www.digi24.ro,0,1,1,2,-0.5,0.5
Volodimir Zelenski,www.digi24.ro,0,3,1,4,-0.75,0.75
dictator,www.digi24.ro,0,1,0,1,-1.0,1.0
Ana Maria Gavrilă,www.romaniatv.net,0,0,1,1,0.0,0.0
Dan Dungaciu,www.romaniatv.net,0,0,2,2,0.0,0.0
Sorin Constantinescu,www.romaniatv.net,0,0,1,1,0.0,0.0
George Rîpă,www.gandul.ro,0,1,1,2,-0.5,0.5
Măruță,www.gandul.ro,0,0,1,1,0.0,0.0
Rîpă,www.gandul.ro,0,1,0,1,-1.0,1.0
Turciei,www.gandul.ro,0,0,1,1,0.0,0.0
Predoiu,primanews.ro,0,0,1,1,0.0,0.0
Băsescu,primanews.ro,0,1,1,2,-0.5,0.5
Constantinescu,primanews.ro,0,0,1,1,0.0,0.0
cei,primanews.ro,0,0,1,1,0.0,0.0
Kovesi,primanews.ro,0,1,0,1,-1.0,1.0
domn,primanews.ro,0,2,1,3,-0.6666666666666666,0.6666666666666666
motociclist,primanews.ro,0,1,0,1,-1.0,1.0
polițist,primanews.ro,0,1,0,1,-1.0,1.0
Iohannis,primanews.ro,0,1,0,1,-1.0,1.0
Aggasi,www.comisarul.ro,0,0,1,1,0.0,0.0
Alcaraz,www.comisarul.ro,0,0,1,1,0.0,0.0
antrenor,www.comisarul.ro,0,0,1,1,0.0,0.0
Cahill,www.comisarul.ro,0,0,1,1,0.0,0.0
Carlos Alcaraz,www.comisarul.ro,0,0,1,1,0.0,0.0
Darren Cahill,www.comisarul.ro,0,0,1,1,0.0,0.0
Hewitt,www.comisarul.ro,0,0,1,1,0.0,0.0
Jannik Sinner,www.comisarul.ro,0,0,1,1,0.0,0.0
Murcia,www.comisarul.ro,1,0,0,1,1.0,1.0
Simona Halep,www.comisarul.ro,0,0,1,1,0.0,0.0
Sinner,www.comisarul.ro,0,1,0,1,-1.0,1.0
campion,www.comisarul.ro,0,0,2,2,0.0,0.0
fan,www.comisarul.ro,0,0,1,1,0.0,0.0
jucător,www.comisarul.ro,1,0,1,2,0.5,0.5
tehnician,www.comisarul.ro,0,0,2,2,0.0,0.0
tenismen,www.comisarul.ro,0,0,1,1,0.0,0.0
Andrei Tarnea,www.aktual24.ro,0,0,1,1,0.0,0.0
Maria Zaharova,www.aktual24.ro,0,0,1,1,0.0,0.0
Tarnea,www.aktual24.ro,0,0,1,1,0.0,0.0
Zaharova,www.aktual24.ro,0,0,1,1,0.0,0.0
Daniel Băluță,www.mediafax.ro,0,0,1,1,0.0,0.0
director general,www.aktual24.ro,0,0,2,2,0.0,0.0
Dmitri Peskov,www.aktual24.ro,0,0,4,4,0.0,0.0
Dubai,www.aktual24.ro,0,0,7,7,0.0,0.0
Durov,www.aktual24.ro,0,1,1,2,-0.5,0.5
Leonid Slutsky,www.aktual24.ro,0,2,0,2,-1.0,1.0
Pavel Durov,www.aktual24.ro,0,2,0,2,-1.0,1.0
soldat,www.aktual24.ro,0,0,1,1,0.0,0.0
utilizator,www.aktual24.ro,0,1,6,7,-0.14285714285714285,0.14285714285714285
Alexandra Damian,pressone.ro,0,0,1,1,0.0,0.0
Andreea Gavrilă,pressone.ro,0,0,1,1,0.0,0.0
Bărbulești,pressone.ro,0,0,1,1,0.0,0.0
Georgiana Drăghici,pressone.ro,0,0,2,2,0.0,0.0
Jilavele,pressone.ro,0,0,1,1,0.0,0.0
Mircea,pressone.ro,0,0,1,1,0.0,0.0
Mărculești,pressone.ro,0,0,1,1,0.0,0.0
Adrian Zăbavă,www.comisarul.ro,0,0,1,1,0.0,0.0
Bogdan Velcescu,www.comisarul.ro,0,1,0,1,-1.0,1.0
analist politic,www.comisarul.ro,0,0,1,1,0.0,0.0
copreședinte,www.comisarul.ro,0,0,2,2,0.0,0.0
legionar,www.comisarul.ro,0,1,0,1,-1.0,1.0
Ciocoii,www.romaniatv.net,0,1,0,1,-1.0,1.0
Cristela,www.romaniatv.net,0,0,1,1,0.0,0.0
Mesia,www.romaniatv.net,0,1,0,1,-1.0,1.0
individ,www.romaniatv.net,0,1,0,1,-1.0,1.0
manifestant,www.romaniatv.net,0,2,0,2,-1.0,1.0
meditator,www.romaniatv.net,0,1,0,1,-1.0,1.0
mulțime,www.romaniatv.net,0,1,1,2,-0.5,0.5
participanț,www.romaniatv.net,1,0,3,4,0.25,0.25
reporter,www.romaniatv.net,0,0,5,5,0.0,0.0
Aleș,www.digi24.ro,0,1,1,2,-0.5,0.5
America,www.digi24.ro,0,1,4,5,-0.2,0.2
Corneliu Bichineț,www.digi24.ro,0,0,1,1,0.0,0.0
Hans Klemm,www.digi24.ro,0,0,1,1,0.0,0.0
James Mattis,www.digi24.ro,0,0,1,1,0.0,0.0
Mihai Fifor,www.digi24.ro,0,0,2,2,0.0,0.0
Rex Tillerson,www.digi24.ro,0,0,1,1,0.0,0.0
Ghimbav,a1.ro,0,0,1,1,0.0,0.0
Ioana Muntean,a1.ro,0,0,1,1,0.0,0.0
Marian Vanghelie,a1.ro,0,3,1,4,-0.75,0.75
Canada,pressone.ro,0,0,2,2,0.0,0.0
George S,pressone.ro,0,1,0,1,-1.0,1.0
Lucian Muntean George Simion,pressone.ro,0,0,1,1,0.0,0.0
Minsk,pressone.ro,0,0,1,1,0.0,0.0
Silicon Valley,pressone.ro,0,0,1,1,0.0,0.0
agricultor,pressone.ro,0,1,1,2,-0.5,0.5
cioban,pressone.ro,0,1,1,2,-0.5,0.5
George,pressone.ro,0,1,1,2,-0.5,0.5
manifestanț,pressone.ro,0,1,0,1,-1.0,1.0
sindicalist,pressone.ro,0,2,0,2,-1.0,1.0
ultras,pressone.ro,0,2,0,2,-1.0,1.0
Bogan,pressone.ro,0,0,1,1,0.0,0.0
Codrin,pressone.ro,0,0,1,1,0.0,0.0
Criștioru,pressone.ro,0,0,1,1,0.0,0.0
Criștioru de Jos,pressone.ro,0,0,1,1,0.0,0.0
Criștioru de Sus,pressone.ro,0,0,1,1,0.0,0.0
mitralieră,pressone.ro,0,1,0,1,-1.0,1.0
Szabó,pressone.ro,0,0,1,1,0.0,0.0
Traian,pressone.ro,0,1,1,2,-0.5,0.5
Traian Bogan,pressone.ro,0,0,3,3,0.0,0.0
Tribunul,pressone.ro,0,0,1,1,0.0,0.0
Szabó Ödön,pressone.ro,0,0,1,1,0.0,0.0
fruntaș,pressone.ro,0,1,0,1,-1.0,1.0
Alexandru Dobre,recorder.ro,0,0,1,1,0.0,0.0
Constantinescu,recorder.ro,0,0,1,1,0.0,0.0
consilier prezidențial,recorder.ro,0,0,1,1,0.0,0.0
Katharina Reiche,primanews.ro,0,0,1,1,0.0,0.0
Reiche,primanews.ro,0,0,1,1,0.0,0.0
Gura Humorului,www.gandul.ro,0,0,1,1,0.0,0.0
Nașul,www.gandul.ro,0,0,1,1,0.0,0.0
Petrică Negrea,www.gandul.ro,0,1,0,1,-1.0,1.0
invitat,www.gandul.ro,0,0,4,4,0.0,0.0
Hurezeanu,adevarul.ro,0,0,1,1,0.0,0.0
Joe Biden,adevarul.ro,0,1,2,3,-0.3333333333333333,0.3333333333333333
München,adevarul.ro,0,0,2,2,0.0,0.0
Soros,adevarul.ro,0,1,0,1,-1.0,1.0
bursier,adevarul.ro,0,0,1,1,0.0,0.0
filantrop,adevarul.ro,0,0,1,1,0.0,0.0
investitor,adevarul.ro,2,1,2,5,0.2,0.2
podcaster,adevarul.ro,0,0,1,1,0.0,0.0
Viktor Orbán,adevarul.ro,0,0,2,2,0.0,0.0
vedet,adevarul.ro,0,0,3,3,0.0,0.0
Grindeanu,www.antena3.ro,0,0,2,2,0.0,0.0
Sorin Grindeanu,www.antena3.ro,0,0,3,3,0.0,0.0
Erevan,www.activenews.ro,0,0,1,1,0.0,0.0
Israel,www.activenews.ro,3,1,0,4,0.5,0.5
Poporul,www.activenews.ro,0,1,0,1,-1.0,1.0
ascultător,www.activenews.ro,0,0,1,1,0.0,0.0
Silviu Vexler,www.activenews.ro,1,0,0,1,1.0,1.0
elită,www.activenews.ro,0,2,0,2,-1.0,1.0
martir,www.activenews.ro,2,2,1,5,0.0,0.0
Țara Sfântă,www.activenews.ro,0,1,0,1,-1.0,1.0
decident,www.mediafax.ro,0,1,1,2,-0.5,0.5
Alexander Kondyakov,www.comisarul.ro,0,1,0,1,-1.0,1.0
Alexandr Kondyakov,www.comisarul.ro,0,0,1,1,0.0,0.0
Anatol Șalaru,www.comisarul.ro,0,0,1,1,0.0,0.0
Cernăuți,www.comisarul.ro,0,0,1,1,0.0,0.0
consilier prezidențial,www.comisarul.ro,0,0,1,1,0.0,0.0
Costiuc,www.comisarul.ro,0,1,0,1,-1.0,1.0
Kondyakov,www.comisarul.ro,0,1,0,1,-1.0,1.0
Sebastian Lăzăroiu,www.comisarul.ro,0,0,1,1,0.0,0.0
Sorin Ozon,www.comisarul.ro,0,0,2,2,0.0,0.0
Vasile Costiuc,www.comisarul.ro,0,0,1,1,0.0,0.0
Victor Costiuc,www.comisarul.ro,0,0,1,1,0.0,0.0
Viktor Ianukovici,www.comisarul.ro,0,0,1,1,0.0,0.0
Vladimir Voronin,www.comisarul.ro,0,0,1,1,0.0,0.0
consultant,www.comisarul.ro,0,1,1,2,-0.5,0.5
spion,www.comisarul.ro,0,0,1,1,0.0,0.0
Ștefan Gligor,www.comisarul.ro,0,0,2,2,0.0,0.0
Burduja,www.euronews.ro,0,0,2,2,0.0,0.0
Ciprian Șerban,www.euronews.ro,0,0,4,4,0.0,0.0
Cseke Attilla,www.euronews.ro,0,0,1,1,0.0,0.0
Cîțu,www.euronews.ro,0,0,1,1,0.0,0.0
Oradea,www.euronews.ro,0,1,0,1,-1.0,1.0
Simona Bucura-Oprescu,www.euronews.ro,1,0,0,1,1.0,1.0
arhitect șef,www.euronews.ro,0,0,1,1,0.0,0.0
arhitect,www.euronews.ro,0,0,1,1,0.0,0.0
Budapesta,www.euronews.ro,0,0,5,5,0.0,0.0
Florina Vita,recorder.ro,0,0,1,1,0.0,0.0
Stelian Tănase,recorder.ro,0,0,3,3,0.0,0.0
Oprea,recorder.ro,0,3,1,4,-0.75,0.75
Sorin Roșca Stănescu,recorder.ro,0,1,0,1,-1.0,1.0
patriot,recorder.ro,1,0,1,2,0.5,0.5
promotor,recorder.ro,0,2,0,2,-1.0,1.0
Paraguay,www.gandul.ro,0,0,1,1,0.0,0.0
Raúl Luis Latorre Martínez,www.gandul.ro,0,0,1,1,0.0,0.0
Veneția,www.gandul.ro,1,0,0,1,1.0,1.0
votant,www.gandul.ro,1,1,0,2,0.0,0.0
competitor,pressone.ro,0,2,1,3,-0.6666666666666666,0.6666666666666666
Cosmin Vasile,agerpres.ro,0,0,2,2,0.0,0.0
Dolj,agerpres.ro,1,0,2,3,0.3333333333333333,0.3333333333333333
sinistraț,adevarul.ro,0,1,0,1,-1.0,1.0
Simona Spătaru,www.news.ro,0,0,1,1,0.0,0.0
absolvent,www.g4media.ro,0,1,0,1,-1.0,1.0
Austria,www.luju.ro,0,0,2,2,0.0,0.0
Claire Bazy Malaurie,www.luju.ro,0,0,1,1,0.0,0.0
Strasbourg,www.luju.ro,0,0,1,1,0.0,0.0
Varșovia,www.luju.ro,0,0,2,2,0.0,0.0
tip,www.gandul.ro,0,1,0,1,-1.0,1.0
Weidel,www.gandul.ro,0,0,1,1,0.0,0.0
X,www.gandul.ro,0,0,1,1,0.0,0.0
Adrian Thies,www.gandul.ro,0,0,1,1,0.0,0.0
Alan Stone,www.gandul.ro,0,0,1,1,0.0,0.0
Anton Pisaroglu,www.gandul.ro,0,0,1,1,0.0,0.0
consultant politic,www.gandul.ro,0,1,0,1,-1.0,1.0
Dragoș Dobrescu,www.gandul.ro,0,0,1,1,0.0,0.0
Frank Timiș,www.gandul.ro,0,0,1,1,0.0,0.0
Marshall Comins,www.gandul.ro,0,0,1,1,0.0,0.0
Peter Imre,www.gandul.ro,0,0,1,1,0.0,0.0
afacerist,www.gandul.ro,0,1,1,2,-0.5,0.5
rugbyst,www.gandul.ro,0,0,1,1,0.0,0.0
capitală,www.euronews.ro,0,1,3,4,-0.25,0.25
Tânăra,www.euronews.ro,0,0,1,1,0.0,0.0
revoluționar,www.euronews.ro,0,0,1,1,0.0,0.0
Aurora Martin,snoop.ro,0,1,0,1,-1.0,1.0
Benga,snoop.ro,0,1,0,1,-1.0,1.0
Camelia Vlad,snoop.ro,0,0,1,1,0.0,0.0
Carmen Herciu,snoop.ro,0,0,1,1,0.0,0.0
Chiuariu,snoop.ro,0,0,1,1,0.0,0.0
Corina Benga,snoop.ro,0,0,1,1,0.0,0.0
Corinei Benga,snoop.ro,0,0,1,1,0.0,0.0
Cătălina Tăbăcaru,snoop.ro,0,1,0,1,-1.0,1.0
Decanul,snoop.ro,0,0,1,1,0.0,0.0
Editor,snoop.ro,0,0,3,3,0.0,0.0
Emanuela,snoop.ro,0,0,2,2,0.0,0.0
Laura,snoop.ro,0,0,1,1,0.0,0.0
Lucian Vineticu,snoop.ro,0,0,1,1,0.0,0.0
Marian Popescu,snoop.ro,1,0,0,1,1.0,1.0
Marius Pieleanu,snoop.ro,0,0,2,2,0.0,0.0
Paula,snoop.ro,0,0,2,2,0.0,0.0
Paula Căbescu,snoop.ro,0,0,1,1,0.0,0.0
Pieleanu,snoop.ro,0,0,1,1,0.0,0.0
Pîrvulescu,snoop.ro,0,1,0,1,-1.0,1.0
Ramona,snoop.ro,0,0,1,1,0.0,0.0
Roma Gavrilă,snoop.ro,0,0,1,1,0.0,0.0
Stere Gulea,snoop.ro,0,1,0,1,-1.0,1.0
Tudor Chiuariu,snoop.ro,0,0,1,1,0.0,0.0
Vineticu,snoop.ro,0,0,1,1,0.0,0.0
Zoom,snoop.ro,0,0,1,1,0.0,0.0
anchetator,snoop.ro,0,1,2,3,-0.3333333333333333,0.3333333333333333
Cristian Pîrvulescu,snoop.ro,0,0,1,1,0.0,0.0
diriginte,snoop.ro,0,0,1,1,0.0,0.0
dvs,snoop.ro,0,1,1,2,-0.5,0.5
fete,snoop.ro,0,1,2,3,-0.3333333333333333,0.3333333333333333
gazdă,snoop.ro,0,1,0,1,-1.0,1.0
persoană vătămată,snoop.ro,0,2,0,2,-1.0,1.0
Ștefan Stanciugelu,snoop.ro,0,1,0,1,-1.0,1.0
rebel,snoop.ro,0,0,1,1,0.0,0.0
terapeut,snoop.ro,0,1,0,1,-1.0,1.0
vegetarian,snoop.ro,0,0,1,1,0.0,0.0
Avramescu,www.antena3.ro,0,0,1,1,0.0,0.0
Cătălin Avramescu,www.antena3.ro,0,0,1,1,0.0,0.0
doctor,www.antena3.ro,0,0,3,3,0.0,0.0
Finlada,www.antena3.ro,0,0,1,1,0.0,0.0
Helsinki,www.antena3.ro,0,0,1,1,0.0,0.0
Mizil,www.antena3.ro,0,0,1,1,0.0,0.0
Prahova,www.antena3.ro,0,0,1,1,0.0,0.0
Daniel Vodă,www.comisarul.ro,0,0,1,1,0.0,0.0
Boureanu,a1.ro,0,1,0,1,-1.0,1.0
Cristache Radulescu,a1.ro,0,0,1,1,0.0,0.0
Cristian Boureanu,a1.ro,0,0,1,1,0.0,0.0
Florin Popescu,a1.ro,0,0,1,1,0.0,0.0
Republica Moldova,a1.ro,1,0,2,3,0.3333333333333333,0.3333333333333333
Sulfina Barbu,a1.ro,0,0,2,2,0.0,0.0
argeseni,a1.ro,1,0,0,1,1.0,1.0
Adrian Damii,pressone.ro,0,0,1,1,0.0,0.0
Adrian Munteanu,pressone.ro,0,0,1,1,0.0,0.0
Adriana Ailincăi,pressone.ro,0,0,1,1,0.0,0.0
Alexandru Matinca,pressone.ro,0,0,1,1,0.0,0.0
Antonio Colamonici,pressone.ro,0,0,1,1,0.0,0.0
Berariu,pressone.ro,0,0,1,1,0.0,0.0
Bereș,pressone.ro,0,0,1,1,0.0,0.0
Ciprian Huc,pressone.ro,0,0,1,1,0.0,0.0
Ciprian Tudosă,pressone.ro,0,0,1,1,0.0,0.0
Constantin Adam,pressone.ro,0,0,1,1,0.0,0.0
Constantin Radu,pressone.ro,0,0,1,1,0.0,0.0
Cosmin Pascari,pressone.ro,0,0,1,1,0.0,0.0
Daniela Druncea,pressone.ro,0,0,1,1,0.0,0.0
Denisa Tîlvescu,pressone.ro,1,0,0,1,1.0,1.0
Durnești,pressone.ro,0,0,1,1,0.0,0.0
Gabriel Saritov,pressone.ro,0,0,1,1,0.0,0.0
Glasgow,pressone.ro,0,0,1,1,0.0,0.0
Gura Humorului,pressone.ro,0,0,2,2,0.0,0.0
Huc,pressone.ro,0,0,1,1,0.0,0.0
Ioana Vrânceanu,pressone.ro,0,0,1,1,0.0,0.0
Ionuț Prundeanu,pressone.ro,0,0,1,1,0.0,0.0
Iuliana Buhuș,pressone.ro,0,0,1,1,0.0,0.0
Iuliana Popa,pressone.ro,0,0,1,1,0.0,0.0
Japonia,pressone.ro,1,0,0,1,1.0,1.0
Linz,pressone.ro,0,0,1,1,0.0,0.0
Maliș,pressone.ro,2,0,1,3,0.6666666666666666,0.6666666666666666
Maria Tivodariu,pressone.ro,0,0,1,1,0.0,0.0
Marius Vasile Cozmiuc,pressone.ro,0,0,1,1,0.0,0.0
medaliat,pressone.ro,0,0,2,2,0.0,0.0
Mergea,pressone.ro,0,1,0,1,-1.0,1.0
Mircea Roman,pressone.ro,0,0,1,1,0.0,0.0
Mogoșești,pressone.ro,0,0,1,1,0.0,0.0
Mădălina,pressone.ro,1,0,1,2,0.5,0.5
Mădălina Bereș,pressone.ro,1,0,0,1,1.0,1.0
Mădălina Hegheș,pressone.ro,0,0,1,1,0.0,0.0
Orșova,pressone.ro,0,0,2,2,0.0,0.0
Orșovei,pressone.ro,0,0,1,1,0.0,0.0
Pascari,pressone.ro,0,0,1,1,0.0,0.0
Păltinoasa,pressone.ro,0,0,1,1,0.0,0.0
Rio,pressone.ro,0,0,1,1,0.0,0.0
Saratosa,pressone.ro,0,0,1,1,0.0,0.0
Scoția,pressone.ro,0,0,1,1,0.0,0.0
Snagov,pressone.ro,0,0,2,2,0.0,0.0
Tecău,pressone.ro,0,1,0,1,-1.0,1.0
Tokyo,pressone.ro,0,0,1,1,0.0,0.0
Mariana Maliș,pressone.ro,1,0,0,1,1.0,1.0
campioană,pressone.ro,2,0,0,2,1.0,1.0
canotaj,pressone.ro,0,0,1,1,0.0,0.0
canotoare,pressone.ro,0,1,1,2,-0.5,0.5
canotor,pressone.ro,1,2,2,5,-0.2,0.2
cârmaci,pressone.ro,0,1,0,1,-1.0,1.0
căutătoare,pressone.ro,0,0,1,1,0.0,0.0
senior,pressone.ro,0,0,1,1,0.0,0.0
Țigănescu,pressone.ro,0,0,1,1,0.0,0.0
Adrian Wiener,www.mediafax.ro,0,0,1,1,0.0,0.0
Anisia Georgiana Costescu,www.mediafax.ro,0,0,1,1,0.0,0.0
băcan,www.mediafax.ro,0,0,1,1,0.0,0.0
Brașov,www.mediafax.ro,0,0,1,1,0.0,0.0
Dumbrăvița,www.mediafax.ro,0,0,1,1,0.0,0.0
Florin Gârbacea,www.mediafax.ro,0,0,1,1,0.0,0.0
Lucian Viziteu,www.mediafax.ro,0,0,2,2,0.0,0.0
Constantinescu,stirileprotv.ro,0,0,1,1,0.0,0.0
Horia Constantinescu,stirileprotv.ro,0,0,1,1,0.0,0.0
Vergil Chițac,stirileprotv.ro,0,0,1,1,0.0,0.0
Craiova,www.cotidianul.ro,0,0,2,2,0.0,0.0
Cristina Pocora,www.cotidianul.ro,0,0,1,1,0.0,0.0
Daniela Bârsan,www.cotidianul.ro,0,0,1,1,0.0,0.0
Georgică Severin,www.cotidianul.ro,0,0,1,1,0.0,0.0
Liei Olguța Vasilescu,www.cotidianul.ro,0,0,1,1,0.0,0.0
Lucian Dindirică,www.cotidianul.ro,0,0,1,1,0.0,0.0
Monica Gubernat,www.cotidianul.ro,0,0,3,3,0.0,0.0
Nicolaie Bălașa,www.cotidianul.ro,0,0,1,1,0.0,0.0
Oana Dincă,www.cotidianul.ro,0,0,1,1,0.0,0.0
Orsolya Borsos,www.cotidianul.ro,0,0,1,1,0.0,0.0
Ramona Sorescu,www.cotidianul.ro,0,0,1,1,0.0,0.0
Răsvan Popescu,www.cotidianul.ro,0,0,1,1,0.0,0.0
Valentin Jucan,www.cotidianul.ro,0,0,1,1,0.0,0.0
Vasile Bănescu,www.cotidianul.ro,0,0,1,1,0.0,0.0
primăriță,www.cotidianul.ro,0,1,0,1,-1.0,1.0
șefă,www.cotidianul.ro,0,1,1,2,-0.5,0.5
Cynthia Paun,www.aktual24.ro,0,0,2,2,0.0,0.0
Ghinea,www.aktual24.ro,0,0,3,3,0.0,0.0
Viena,www.comisarul.ro,0,0,1,1,0.0,0.0
Bernhard Zeeman,www.comisarul.ro,0,0,1,1,0.0,0.0
Douglas Chesley,www.comisarul.ro,0,0,1,1,0.0,0.0
Heerhugowaard,www.comisarul.ro,0,1,2,3,-0.3333333333333333,0.3333333333333333
Olanda de Nord,www.comisarul.ro,0,0,1,1,0.0,0.0
actor,www.romaniatv.net,0,1,1,2,-0.5,0.5
Dorin Lulea,www.romaniatv.net,1,0,0,1,1.0,1.0
Garcea,www.romaniatv.net,0,0,1,1,0.0,0.0
Kamala,www.romaniatv.net,0,1,0,1,-1.0,1.0
Mugur Mihăescu,www.romaniatv.net,0,0,1,1,0.0,0.0
Adrian Chesnoiu,www.euronews.ro,0,0,3,3,0.0,0.0
Chesnoiu,www.euronews.ro,0,0,1,1,0.0,0.0
procuror general,www.euronews.ro,0,0,1,1,0.0,0.0
europarlamentar,agerpres.ro,0,0,5,5,0.0,0.0
Vincze,agerpres.ro,0,0,1,1,0.0,0.0
Vincze Lorant,agerpres.ro,0,0,1,1,0.0,0.0
partener,agerpres.ro,0,0,1,1,0.0,0.0
Israel,a1.ro,1,0,0,1,1.0,1.0
Johnson,a1.ro,0,0,1,1,0.0,0.0
Louisiana,a1.ro,0,0,1,1,0.0,0.0
Mike Johnson,a1.ro,1,0,0,1,1.0,1.0
Speaker,a1.ro,0,0,1,1,0.0,0.0
adept,a1.ro,0,0,1,1,0.0,0.0
imigrant,a1.ro,0,0,1,1,0.0,0.0
populație,a1.ro,0,0,5,5,0.0,0.0
urmaș,a1.ro,0,0,1,1,0.0,0.0
aceeasi,www.aktual24.ro,0,1,0,1,-1.0,1.0
sfătuitor,www.aktual24.ro,0,1,0,1,-1.0,1.0
Adrian Câciu,snoop.ro,0,0,1,1,0.0,0.0
Alexandru,snoop.ro,0,0,1,1,0.0,0.0
Alexandru Băjenaru,snoop.ro,0,0,1,1,0.0,0.0
Bogdan Stroe,snoop.ro,0,0,1,1,0.0,0.0
Bucureștean,snoop.ro,0,1,0,1,-1.0,1.0
Băjenaru,snoop.ro,0,0,1,1,0.0,0.0
Cavarnali,snoop.ro,0,0,1,1,0.0,0.0
Cocoru,snoop.ro,0,0,1,1,0.0,0.0
Constanda,snoop.ro,0,1,0,1,-1.0,1.0
Constantin Daniel,snoop.ro,0,0,1,1,0.0,0.0
Costică Constanda,snoop.ro,0,0,2,2,0.0,0.0
Cristache Rădulescu,snoop.ro,0,0,1,1,0.0,0.0
Cristian Teodor,snoop.ro,0,0,1,1,0.0,0.0
Cănuțoiu,snoop.ro,0,0,1,1,0.0,0.0
Dan Băjenaru,snoop.ro,0,0,1,1,0.0,0.0
Daniel,snoop.ro,0,0,1,1,0.0,0.0
Dobrescu,snoop.ro,0,1,0,1,-1.0,1.0
Dragoș Dobrescu,snoop.ro,0,1,1,2,-0.5,0.5
Eduard Ioan Dan Romalo,snoop.ro,0,0,1,1,0.0,0.0
Ion,snoop.ro,0,0,2,2,0.0,0.0
Lazăr,snoop.ro,0,1,0,1,-1.0,1.0
Liviu Negoiță,snoop.ro,0,0,1,1,0.0,0.0
Lucian Ionuț Băjenaru,snoop.ro,0,0,1,1,0.0,0.0
Maria Cocoru,snoop.ro,0,1,1,2,-0.5,0.5
Marin Băjenaru,snoop.ro,0,0,1,1,0.0,0.0
Mihai Lazăr,snoop.ro,0,0,1,1,0.0,0.0
Mihai Mușat,snoop.ro,0,0,1,1,0.0,0.0
Mihăiță Băjenaru,snoop.ro,0,0,1,1,0.0,0.0
Mușat,snoop.ro,0,1,1,2,-0.5,0.5
Paraschiva Băjenaru,snoop.ro,0,0,1,1,0.0,0.0
Petre Băjenaru,snoop.ro,0,0,2,2,0.0,0.0
Rareș Hopincă,snoop.ro,0,0,1,1,0.0,0.0
Rovana Plumb,snoop.ro,0,0,1,1,0.0,0.0
Dan Ștefan Trifu,snoop.ro,0,0,1,1,0.0,0.0
Sorin Mușat,snoop.ro,0,0,1,1,0.0,0.0
Sorin Tuță,snoop.ro,0,1,1,2,-0.5,0.5
Spirea Băjenaru,snoop.ro,0,0,1,1,0.0,0.0
Stroe,snoop.ro,0,0,1,1,0.0,0.0
Teodor,snoop.ro,0,0,1,1,0.0,0.0
Tineri,snoop.ro,0,0,1,1,0.0,0.0
Traian Băsescu,snoop.ro,0,0,1,1,0.0,0.0
Tuță,snoop.ro,0,1,0,1,-1.0,1.0
Vidra,snoop.ro,0,0,1,1,0.0,0.0
Vlad Cavarnali,snoop.ro,0,0,1,1,0.0,0.0
alergător,snoop.ro,0,0,1,1,0.0,0.0
arendaș,snoop.ro,0,1,0,1,-1.0,1.0
arhitect,snoop.ro,0,0,1,1,0.0,0.0
artist,snoop.ro,0,0,1,1,0.0,0.0
chiriaș,snoop.ro,0,1,2,3,-0.3333333333333333,0.3333333333333333
contabil,snoop.ro,0,1,0,1,-1.0,1.0
enoriaș,snoop.ro,0,1,0,1,-1.0,1.0
familia Băjenaru,snoop.ro,0,1,1,2,-0.5,0.5
frați,snoop.ro,0,0,1,1,0.0,0.0
interlop,snoop.ro,0,1,0,1,-1.0,1.0
moșier,snoop.ro,0,1,0,1,-1.0,1.0
moștenitor,snoop.ro,0,2,1,3,-0.6666666666666666,0.6666666666666666
mătușă,snoop.ro,0,0,1,1,0.0,0.0
nonagenar,snoop.ro,0,0,1,1,0.0,0.0
pensionar,snoop.ro,0,1,4,5,-0.2,0.2
prefect,snoop.ro,0,0,1,1,0.0,0.0
Hopincă,snoop.ro,0,1,0,1,-1.0,1.0
proiectant,snoop.ro,0,0,2,2,0.0,0.0
proprietarii,snoop.ro,0,0,1,1,0.0,0.0
ranger,snoop.ro,0,2,0,2,-1.0,1.0
rude,snoop.ro,0,2,2,4,-0.5,0.5
urmaș,snoop.ro,0,1,0,1,-1.0,1.0
Alina Gorghiu,www.g4media.ro,0,0,3,3,0.0,0.0
inculpat,www.g4media.ro,0,1,0,1,-1.0,1.0
Alexander Stubb,www.aktual24.ro,0,0,1,1,0.0,0.0
Estonia,www.aktual24.ro,0,0,2,2,0.0,0.0
Finlanda,www.aktual24.ro,0,0,2,2,0.0,0.0
Graham,www.aktual24.ro,0,0,1,1,0.0,0.0
Lennart Meri,www.aktual24.ro,0,0,1,1,0.0,0.0
Richard Blumenthal,www.aktual24.ro,0,0,1,1,0.0,0.0
Stubb,www.aktual24.ro,0,0,1,1,0.0,0.0
Tallinn,www.aktual24.ro,0,0,1,1,0.0,0.0
Algeria,www.euronews.ro,0,0,1,1,0.0,0.0
Argentina,www.euronews.ro,0,0,1,1,0.0,0.0
Austria,www.euronews.ro,0,1,3,4,-0.25,0.25
Belarus,www.euronews.ro,0,0,2,2,0.0,0.0
Belgia,www.euronews.ro,0,0,2,2,0.0,0.0
Bosnia și Herțegovina,www.euronews.ro,0,0,1,1,0.0,0.0
Calgary,www.euronews.ro,0,0,1,1,0.0,0.0
Cehia,www.euronews.ro,0,0,1,1,0.0,0.0
Chicago,www.euronews.ro,0,0,1,1,0.0,0.0
Chile,www.euronews.ro,0,0,1,1,0.0,0.0
Columbia,www.euronews.ro,0,0,1,1,0.0,0.0
Croația,www.euronews.ro,0,0,1,1,0.0,0.0
Cuba,www.euronews.ro,0,0,1,1,0.0,0.0
Dallas,www.euronews.ro,0,0,1,1,0.0,0.0
Dieppe,www.euronews.ro,0,0,1,1,0.0,0.0
Edmonton,www.euronews.ro,0,0,1,1,0.0,0.0
Houston,www.euronews.ro,0,0,1,1,0.0,0.0
Irlanda,www.euronews.ro,0,0,1,1,0.0,0.0
Islanda,www.euronews.ro,0,0,1,1,0.0,0.0
Luxemburg,www.euronews.ro,1,0,1,2,0.5,0.5
Macedonia de Nord,www.euronews.ro,0,0,2,2,0.0,0.0
Maroc,www.euronews.ro,0,0,1,1,0.0,0.0
Miami,www.euronews.ro,0,0,1,1,0.0,0.0
Montreal,www.euronews.ro,0,0,1,1,0.0,0.0
Muntenegru,www.euronews.ro,0,0,2,2,0.0,0.0
Nigeria,www.euronews.ro,0,0,1,1,0.0,0.0
Norvegia,www.euronews.ro,0,0,1,1,0.0,0.0
Olanda,www.euronews.ro,0,0,2,2,0.0,0.0
Ottawa,www.euronews.ro,0,0,1,1,0.0,0.0
Peru,www.euronews.ro,0,0,1,1,0.0,0.0
Portugalia,www.euronews.ro,0,0,3,3,0.0,0.0
Quebec,www.euronews.ro,0,0,1,1,0.0,0.0
San Francisco,www.euronews.ro,0,0,1,1,0.0,0.0
Senegal,www.euronews.ro,0,0,1,1,0.0,0.0
Slovacia,www.euronews.ro,0,0,1,1,0.0,0.0
Slovenia,www.euronews.ro,0,0,1,1,0.0,0.0
Suedia,www.euronews.ro,0,0,1,1,0.0,0.0
Toronto,www.euronews.ro,0,0,1,1,0.0,0.0
Tunisia,www.euronews.ro,0,0,1,1,0.0,0.0
Uruguay,www.euronews.ro,0,0,1,1,0.0,0.0
Vancouver,www.euronews.ro,0,0,1,1,0.0,0.0
Winnipeg,www.euronews.ro,0,0,1,1,0.0,0.0
Regatul Unit al Marii Britanii și Irlandei de Nord,pressone.ro,0,1,0,1,-1.0,1.0
stakeholder,pressone.ro,0,1,0,1,-1.0,1.0
Péter Magyar,www.comisarul.ro,0,1,1,2,-0.5,0.5
Beijing,recorder.ro,0,0,1,1,0.0,0.0
Coldea,recorder.ro,0,1,0,1,-1.0,1.0
denunțător,recorder.ro,0,1,0,1,-1.0,1.0
Scott Bessent,recorder.ro,0,0,2,2,0.0,0.0
Negrescu,primanews.ro,0,0,3,3,0.0,0.0
Roxana Mînzatu,primanews.ro,0,0,1,1,0.0,0.0
Victor Negrescu,primanews.ro,0,0,2,2,0.0,0.0
comisar,primanews.ro,0,0,3,3,0.0,0.0
Mircea Dinescu,www.comisarul.ro,0,0,3,3,0.0,0.0
poet,www.comisarul.ro,0,0,2,2,0.0,0.0
Marin Preda,www.comisarul.ro,1,0,0,1,1.0,1.0
Bogdan Cojocaru,www.g4media.ro,0,0,2,2,0.0,0.0
Daniel Funeriu,www.euronews.ro,0,0,4,4,0.0,0.0
John Ion Banu,www.euronews.ro,0,0,1,1,0.0,0.0
Lavinia Șandru,www.euronews.ro,0,0,4,4,0.0,0.0
Coreea de Sud,adevarul.ro,0,0,3,3,0.0,0.0
Iulian Badea,adevarul.ro,0,0,3,3,0.0,0.0
Kazahstan,adevarul.ro,0,0,1,1,0.0,0.0
Riga,adevarul.ro,0,0,1,1,0.0,0.0
Adrian,adevarul.ro,0,0,1,1,0.0,0.0
Adrian Mocanu,adevarul.ro,0,1,0,1,-1.0,1.0
Alexandru,adevarul.ro,0,0,1,1,0.0,0.0
Cei,adevarul.ro,0,2,0,2,-1.0,1.0
Constantin,adevarul.ro,0,1,1,2,-0.5,0.5
Elena Uioreanu,adevarul.ro,0,0,1,1,0.0,0.0
Florentin Pandele,adevarul.ro,0,0,1,1,0.0,0.0
Florin Anghel,adevarul.ro,0,0,1,1,0.0,0.0
Horea Uioreanu,adevarul.ro,0,0,1,1,0.0,0.0
Manuela Mitrea,adevarul.ro,0,0,1,1,0.0,0.0
Mircea Cosma,adevarul.ro,0,1,0,1,-1.0,1.0
Radu Mazăre,adevarul.ro,0,2,2,4,-0.5,0.5
Rudele,adevarul.ro,0,1,0,1,-1.0,1.0
Victor Mocanu,adevarul.ro,0,0,1,1,0.0,0.0
Vlad,adevarul.ro,0,1,0,1,-1.0,1.0
junior,adevarul.ro,0,0,3,3,0.0,0.0
Edi Hellvig,www.antena3.ro,0,1,0,1,-1.0,1.0
subaltern,www.antena3.ro,0,1,0,1,-1.0,1.0
Crimeea,primanews.ro,0,0,1,1,0.0,0.0
arhitect,www.gandul.ro,0,0,1,1,0.0,0.0
congresman,www.gandul.ro,0,1,6,7,-0.14285714285714285,0.14285714285714285
Mihai Enache,www.cotidianul.ro,0,0,3,3,0.0,0.0
Maia,pressone.ro,0,0,1,1,0.0,0.0
votant,stirileprotv.ro,0,1,2,3,-0.3333333333333333,0.3333333333333333
António Costa,adevarul.ro,0,0,2,2,0.0,0.0
Portugalia,adevarul.ro,0,1,2,3,-0.3333333333333333,0.3333333333333333
medic,adevarul.ro,1,0,4,5,0.2,0.2
Adrian Isac,a1.ro,0,0,1,1,0.0,0.0
Costel Casuneanu,a1.ro,0,1,3,4,-0.25,0.25
Marius Locic,a1.ro,0,0,5,5,0.0,0.0
Bogdan Popescu,a1.ro,0,0,1,1,0.0,0.0
general,a1.ro,0,1,1,2,-0.5,0.5
Viorica Costiniu,a1.ro,0,0,1,1,0.0,0.0
Florin Costiniu,a1.ro,0,2,3,5,-0.4,0.4
martor,a1.ro,0,0,2,2,0.0,0.0
Cătălin Voicu,a1.ro,0,0,1,1,0.0,0.0
Capricorn,www.romaniatv.net,1,0,1,2,0.5,0.5
nativ,www.romaniatv.net,3,0,0,3,1.0,1.0
divinitate,www.romaniatv.net,1,0,0,1,1.0,1.0
Giuliani,www.gandul.ro,0,0,1,1,0.0,0.0
Louis Freeh,www.gandul.ro,0,0,1,1,0.0,0.0
Rudolph Giuliani,www.gandul.ro,0,0,1,1,0.0,0.0
CG,www.activenews.ro,0,3,0,3,-1.0,1.0
Constantin Dulcan,www.activenews.ro,0,1,0,1,-1.0,1.0
Dorel Vișan,www.activenews.ro,0,1,0,1,-1.0,1.0
Iisus Hristos,www.activenews.ro,2,1,0,3,0.3333333333333333,0.3333333333333333
Pieleanu,www.activenews.ro,0,1,0,1,-1.0,1.0
Vladimir Putin,www.activenews.ro,0,1,1,2,-0.5,0.5
comanditar,www.activenews.ro,0,1,0,1,-1.0,1.0
Constantinescu,www.activenews.ro,0,0,1,1,0.0,0.0
junior,www.activenews.ro,0,1,0,1,-1.0,1.0
înlocuitor,www.activenews.ro,0,1,0,1,-1.0,1.0
Șoșoacă,www.activenews.ro,0,2,0,2,-1.0,1.0
Alexandru Zidaru,www.g4media.ro,0,1,0,1,-1.0,1.0
Allin,www.g4media.ro,0,0,1,1,0.0,0.0
Feraru,www.g4media.ro,0,0,1,1,0.0,0.0
Gâdea,www.g4media.ro,0,1,0,1,-1.0,1.0
Machiavelli,www.g4media.ro,0,1,0,1,-1.0,1.0
Mihai Gâdea,www.g4media.ro,0,1,0,1,-1.0,1.0
Victor Micula,www.g4media.ro,0,1,0,1,-1.0,1.0
fan,www.g4media.ro,0,1,0,1,-1.0,1.0
Makaveli,www.g4media.ro,0,0,1,1,0.0,0.0
George Pian,www.g4media.ro,0,1,0,1,-1.0,1.0
internat,www.g4media.ro,0,0,2,2,0.0,0.0
portavoce,www.g4media.ro,0,1,0,1,-1.0,1.0
șefă,www.g4media.ro,0,1,1,2,-0.5,0.5
dușman,www.digi24.ro,0,1,0,1,-1.0,1.0
Necsu,www.luju.ro,0,1,0,1,-1.0,1.0
europarlamentar,www.luju.ro,0,2,1,3,-0.6666666666666666,0.6666666666666666
Afganistan,a1.ro,0,0,1,1,0.0,0.0
Principele Radu,a1.ro,0,0,1,1,0.0,0.0
Constantin Simirad,a1.ro,1,0,0,1,1.0,1.0
Mihai I,a1.ro,1,0,0,1,1.0,1.0
Simirad,a1.ro,0,0,1,1,0.0,0.0
militar,a1.ro,0,0,1,1,0.0,0.0
executor,observatornews.ro,0,1,0,1,-1.0,1.0
Adrian Diaconu,a1.ro,0,0,1,1,0.0,0.0
Adrian Mutu,a1.ro,0,0,1,1,0.0,0.0
Alexandra Savin,a1.ro,0,0,1,1,0.0,0.0
Andrei Giugasvili,a1.ro,0,0,1,1,0.0,0.0
Angela Gheorghiu,a1.ro,0,0,1,1,0.0,0.0
Belize,a1.ro,0,0,1,1,0.0,0.0
Busteni,a1.ro,0,2,0,2,-1.0,1.0
Ilie Nastase,a1.ro,0,0,1,1,0.0,0.0
Ionel Ganea,a1.ro,0,0,1,1,0.0,0.0
Kurt Albert Neuschitzer,a1.ro,0,0,1,1,0.0,0.0
Leonard Doroftei,a1.ro,0,0,1,1,0.0,0.0
Lucian Bute,a1.ro,0,0,1,1,0.0,0.0
Nadia Comăneci,a1.ro,0,0,1,1,0.0,0.0
Octavian Murariu,a1.ro,0,0,1,1,0.0,0.0
Savin,a1.ro,0,1,0,1,-1.0,1.0
Tudor Chirilă,a1.ro,0,0,1,1,0.0,0.0
alții,a1.ro,0,0,1,1,0.0,0.0
boxer,a1.ro,0,0,1,1,0.0,0.0
cercetător,a1.ro,0,1,0,1,-1.0,1.0
Neuschitzer,a1.ro,0,1,0,1,-1.0,1.0
fotbalist,a1.ro,0,0,1,1,0.0,0.0
Orban,www.g4media.ro,0,1,0,1,-1.0,1.0
Cotilde Armand,recorder.ro,0,0,1,1,0.0,0.0
Dumitru Dumbravă,recorder.ro,0,0,1,1,0.0,0.0
Florian Coldea,recorder.ro,0,0,1,1,0.0,0.0
Hellvig,recorder.ro,0,1,1,2,-0.5,0.5
Laura Codruța Kovesi,recorder.ro,0,0,1,1,0.0,0.0
Liviu Negoiță,recorder.ro,0,1,0,1,-1.0,1.0
Lucian Croitoriu,recorder.ro,0,0,1,1,0.0,0.0
Primăria,recorder.ro,0,1,0,1,-1.0,1.0
Ramona Ioana Bruynseels,recorder.ro,0,0,2,2,0.0,0.0
consilieră,recorder.ro,0,0,3,3,0.0,0.0
figură,recorder.ro,0,1,1,2,-0.5,0.5
Sergiu Moroianu,recorder.ro,0,0,1,1,0.0,0.0
susținătoare,recorder.ro,0,1,1,2,-0.5,0.5
Bușteni,adevarul.ro,0,0,1,1,0.0,0.0
Oțelu Roșu,adevarul.ro,0,0,1,1,0.0,0.0
Liviu Rusu,a1.ro,0,0,1,1,0.0,0.0
Luca Iancu,a1.ro,0,0,1,1,0.0,0.0
Oltean,a1.ro,0,0,1,1,0.0,0.0
elev,a1.ro,0,1,0,1,-1.0,1.0
Băile Tușnad,pressone.ro,0,0,2,2,0.0,0.0
Novak,pressone.ro,0,1,0,1,-1.0,1.0
Bogdan Ciucă,www.gandul.ro,0,2,2,4,-0.5,0.5
Ciprian FARAON,www.gandul.ro,0,0,1,1,0.0,0.0
Cristian Barbu,www.gandul.ro,0,0,1,1,0.0,0.0
Cătălin Davidesco,www.gandul.ro,0,0,1,1,0.0,0.0
Adrian Curenuc,www.gandul.ro,0,0,1,1,0.0,0.0
Dumitru Miroiu Constantin Harasim,www.gandul.ro,0,0,1,1,0.0,0.0
Gheorghe Pintea Mihai Iacob,www.gandul.ro,0,0,1,1,0.0,0.0
Ioan Simionca,www.gandul.ro,0,0,1,1,0.0,0.0
Ionuț Gherga Barbu,www.gandul.ro,0,0,1,1,0.0,0.0
lume,www.gandul.ro,1,0,2,3,0.3333333333333333,0.3333333333333333
Mariana Vârgă,www.gandul.ro,0,0,1,1,0.0,0.0
Mihaela Pundiche,www.gandul.ro,0,0,1,1,0.0,0.0
Mugur Ciuvică,www.gandul.ro,0,0,1,1,0.0,0.0
Mărie,www.gandul.ro,0,1,0,1,-1.0,1.0
Raluca Bugar,www.gandul.ro,0,0,1,1,0.0,0.0
actriță,www.gandul.ro,0,0,1,1,0.0,0.0
microbist,www.gandul.ro,0,1,0,1,-1.0,1.0
Suceava,stirileprotv.ro,0,0,4,4,0.0,0.0
responsabil,stirileprotv.ro,0,2,0,2,-1.0,1.0
ea,www.b1tv.ro,0,3,0,3,-1.0,1.0
demonstrant,www.aktual24.ro,0,1,0,1,-1.0,1.0
Florin Jianu,www.gandul.ro,0,0,1,1,0.0,0.0
Răzvan Filipescu,www.gandul.ro,0,0,1,1,0.0,0.0
Locic,a1.ro,0,1,0,1,-1.0,1.0
Tariceanu,a1.ro,0,1,0,1,-1.0,1.0
dna,a1.ro,0,0,1,1,0.0,0.0
Atenei,primanews.ro,0,0,1,1,0.0,0.0
Mykonos,primanews.ro,0,0,1,1,0.0,0.0
Paros,primanews.ro,0,1,0,1,-1.0,1.0
pompier,primanews.ro,1,0,1,2,0.5,0.5
vedet,primanews.ro,0,1,0,1,-1.0,1.0
public,agerpres.ro,0,1,0,1,-1.0,1.0
Remus Ștefureac,www.euronews.ro,0,0,7,7,0.0,0.0
Ștefureac,www.euronews.ro,0,0,1,1,0.0,0.0
Yalta,www.antena3.ro,0,1,0,1,-1.0,1.0
Nicolae Mischie,a1.ro,0,1,0,1,-1.0,1.0
Sefa,a1.ro,0,1,1,2,-0.5,0.5
Romașcanu,www.digi24.ro,0,1,1,2,-0.5,0.5
Chichirău,www.news.ro,0,0,1,1,0.0,0.0
Cosette Chichirău,www.news.ro,0,0,2,2,0.0,0.0
Vlad Gheorghe,www.news.ro,0,0,1,1,0.0,0.0
ieșen,www.news.ro,0,0,1,1,0.0,0.0
Craiovei,www.gandul.ro,0,0,1,1,0.0,0.0
Adrian Solomon,adevarul.ro,0,0,1,1,0.0,0.0
Adrian Vasilescu,adevarul.ro,0,0,1,1,0.0,0.0
baron,adevarul.ro,0,2,0,2,-1.0,1.0
Bogdan Ivanov,adevarul.ro,0,0,1,1,0.0,0.0
Bucovina,adevarul.ro,0,0,1,1,0.0,0.0
Bârlad,adevarul.ro,0,0,1,1,0.0,0.0
Băiculești,adevarul.ro,0,1,0,1,-1.0,1.0
Constanta,adevarul.ro,0,1,0,1,-1.0,1.0
Constantin Stoica,adevarul.ro,0,0,1,1,0.0,0.0
Costești,adevarul.ro,0,2,0,2,-1.0,1.0
Daniel Constantin,adevarul.ro,0,0,1,1,0.0,0.0
Dumitru Buzatu,adevarul.ro,0,0,1,1,0.0,0.0
Florin Chirilă,adevarul.ro,0,1,1,2,-0.5,0.5
Flutur,adevarul.ro,0,0,1,1,0.0,0.0
Gabriel Oprea,adevarul.ro,0,1,4,5,-0.2,0.2
Gheorghe Flutur,adevarul.ro,0,0,3,3,0.0,0.0
Gheorghe Nichita,adevarul.ro,0,1,1,2,-0.5,0.5
Gheorghe Stanciu,adevarul.ro,0,0,2,2,0.0,0.0
IAȘI,adevarul.ro,0,0,1,1,0.0,0.0
Ioan Poenar,adevarul.ro,0,1,0,1,-1.0,1.0
Ioan Roman,adevarul.ro,0,0,1,1,0.0,0.0
Iulian Dascălu,adevarul.ro,0,0,1,1,0.0,0.0
Maica Domnului,adevarul.ro,0,0,1,1,0.0,0.0
Mamaia,adevarul.ro,0,0,1,1,0.0,0.0
Maramureș,adevarul.ro,0,0,2,2,0.0,0.0
Mazăre,adevarul.ro,0,0,2,2,0.0,0.0
Mugur Isărescu,adevarul.ro,0,0,3,3,0.0,0.0
Iustin Sigheteanu,adevarul.ro,1,0,1,2,0.5,0.5
patriarh,adevarul.ro,1,0,1,2,0.5,0.5
Daniel,adevarul.ro,1,0,0,1,1.0,1.0
Petru Vodă,adevarul.ro,0,0,1,1,0.0,0.0
Podele,adevarul.ro,0,0,1,1,0.0,0.0
Ioachim Băcăuanul,adevarul.ro,0,0,1,1,0.0,0.0
Pungești,adevarul.ro,0,0,1,1,0.0,0.0
Rădăuți,adevarul.ro,0,0,1,1,0.0,0.0
Siliștea,adevarul.ro,0,0,1,1,0.0,0.0
Someșan,adevarul.ro,0,0,1,1,0.0,0.0
Stanciu,adevarul.ro,0,1,1,2,-0.5,0.5
Stoica,adevarul.ro,0,1,1,2,-0.5,0.5
Sucevei,adevarul.ro,0,0,1,1,0.0,0.0
Tomis,adevarul.ro,0,0,1,1,0.0,0.0
arhiereu,adevarul.ro,0,0,1,1,0.0,0.0
consiler,adevarul.ro,0,1,0,1,-1.0,1.0
enoriaș,adevarul.ro,0,1,2,3,-0.3333333333333333,0.3333333333333333
guvernant,adevarul.ro,0,3,1,4,-0.75,0.75
guvernator,adevarul.ro,0,0,3,3,0.0,0.0
mai,adevarul.ro,0,0,2,2,0.0,0.0
mare,adevarul.ro,0,1,0,1,-1.0,1.0
monah,adevarul.ro,0,0,1,1,0.0,0.0
mulțime,adevarul.ro,0,0,1,1,0.0,0.0
paroh,adevarul.ro,0,1,1,2,-0.5,0.5
prelat,adevarul.ro,0,1,1,2,-0.5,0.5
Ilie Geangavelea,adevarul.ro,0,1,0,1,-1.0,1.0
Vasile Lăiu,adevarul.ro,1,0,0,1,1.0,1.0
promotor,adevarul.ro,0,1,0,1,-1.0,1.0
protopop,adevarul.ro,0,1,1,2,-0.5,0.5
slujitor,adevarul.ro,0,0,1,1,0.0,0.0
strateg,adevarul.ro,0,1,1,2,-0.5,0.5
turist,adevarul.ro,0,1,0,1,-1.0,1.0
Pimen,adevarul.ro,0,2,1,3,-0.6666666666666666,0.6666666666666666
Teodosie,adevarul.ro,0,1,1,2,-0.5,0.5
Belarus,www.g4media.ro,0,0,1,1,0.0,0.0
Daniel Ene,www.g4media.ro,0,0,1,1,0.0,0.0
Ene,www.g4media.ro,0,1,0,1,-1.0,1.0
Făgăraș,www.g4media.ro,0,0,1,1,0.0,0.0
Matei Păun,www.g4media.ro,0,0,1,1,0.0,0.0
Predeal,www.g4media.ro,0,0,1,1,0.0,0.0
Păun,www.g4media.ro,0,1,0,1,-1.0,1.0
activist,www.g4media.ro,0,2,3,5,-0.4,0.4
Berceni,www.aktual24.ro,0,0,1,1,0.0,0.0
Clinceni,www.aktual24.ro,0,0,1,1,0.0,0.0
Corbeanca,www.aktual24.ro,0,0,1,1,0.0,0.0
Dimieni,www.aktual24.ro,0,0,1,1,0.0,0.0
Domnesti,www.aktual24.ro,0,0,1,1,0.0,0.0
Ilfov,www.aktual24.ro,0,1,4,5,-0.2,0.2
Otopeni,www.aktual24.ro,0,0,1,1,0.0,0.0
Pantelimon,www.aktual24.ro,0,0,1,1,0.0,0.0
Popesti Leordeni,www.aktual24.ro,0,0,1,1,0.0,0.0
Stefăneștii de Jos,www.aktual24.ro,0,0,1,1,0.0,0.0
Victor Viorel Ponta,www.luju.ro,0,0,1,1,0.0,0.0
Alexandru Vasile,www.luju.ro,1,2,2,5,-0.2,0.2
Drulă,www.mediafax.ro,0,1,1,2,-0.5,0.5
Elena Laconi,www.mediafax.ro,0,0,1,1,0.0,0.0
Oana Țoiu,www.mediafax.ro,0,0,1,1,0.0,0.0
actor,www.mediafax.ro,0,0,1,1,0.0,0.0
aliat,www.mediafax.ro,0,1,1,2,-0.5,0.5
Leonardo Rejón,www.comisarul.ro,0,0,1,1,0.0,0.0
Rejón,www.comisarul.ro,0,0,1,1,0.0,0.0
chirurg,www.comisarul.ro,0,0,1,1,0.0,0.0
multor,www.comisarul.ro,0,1,0,1,-1.0,1.0
Ana Birchall,www.gandul.ro,0,0,1,1,0.0,0.0
Silviu Predoiu,www.gandul.ro,0,0,1,1,0.0,0.0
Moise Guran,www.mediafax.ro,0,0,1,1,0.0,0.0
Vlad Petreanu,www.mediafax.ro,0,0,1,1,0.0,0.0
frate,www.antena3.ro,2,0,1,3,0.6666666666666666,0.6666666666666666
Zuckermann,www.antena3.ro,0,0,1,1,0.0,0.0
baron,www.antena3.ro,0,1,0,1,-1.0,1.0
bunică,www.antena3.ro,2,0,0,2,1.0,1.0
celor,www.antena3.ro,0,1,0,1,-1.0,1.0
fricos,www.antena3.ro,0,1,0,1,-1.0,1.0
eu,www.antena3.ro,0,2,0,2,-1.0,1.0
izolaționist,www.antena3.ro,0,1,0,1,-1.0,1.0
salvator,www.antena3.ro,0,1,0,1,-1.0,1.0
Adrian Iacob,pressone.ro,0,0,5,5,0.0,0.0
Bogdan Licu,pressone.ro,2,0,2,4,0.5,0.5
Pop,pressone.ro,0,2,1,3,-0.6666666666666666,0.6666666666666666
Dumitru Dumbravă,pressone.ro,0,2,3,5,-0.4,0.4
Emilia Șercan Nicolae Istudor,pressone.ro,0,0,1,1,0.0,0.0
George Antoniu Pișleag,pressone.ro,0,0,1,1,0.0,0.0
George Țical,pressone.ro,0,0,3,3,0.0,0.0
Ioan Crăciun,pressone.ro,1,1,1,3,0.0,0.0
Istudor,pressone.ro,0,1,0,1,-1.0,1.0
Liviu Marian Pop,pressone.ro,0,1,0,1,-1.0,1.0
Nicolae Istudor,pressone.ro,1,0,2,3,0.3333333333333333,0.3333333333333333
Pișleag,pressone.ro,0,1,0,1,-1.0,1.0
Țuțu Pișleag,pressone.ro,0,1,4,5,-0.2,0.2
referent,pressone.ro,0,1,4,5,-0.2,0.2
bursier,pressone.ro,0,0,1,1,0.0,0.0
domnișoară,pressone.ro,0,2,2,4,-0.5,0.5
SRI,pressone.ro,0,0,1,1,0.0,0.0
Florica Diaconescu,pressone.ro,0,1,1,2,-0.5,0.5
miliardar,pressone.ro,0,2,1,3,-0.6666666666666666,0.6666666666666666
Neculai Onțanu,pressone.ro,0,1,2,3,-0.3333333333333333,0.3333333333333333
profesorul Pișleag,pressone.ro,0,1,0,1,-1.0,1.0
însoțitoare,pressone.ro,0,1,0,1,-1.0,1.0
Țical,pressone.ro,0,0,1,1,0.0,0.0
Cristina Belce,www.g4media.ro,0,0,1,1,0.0,0.0
Boc,www.g4media.ro,0,1,0,1,-1.0,1.0
Bălașa Dana,www.g4media.ro,0,0,1,1,0.0,0.0
Constantea Radu,www.g4media.ro,0,0,1,1,0.0,0.0
Câmpean Ovidiu,www.g4media.ro,0,0,1,1,0.0,0.0
Daniel Buda,www.g4media.ro,0,0,2,2,0.0,0.0
Fărgaciu Călin,www.g4media.ro,0,0,1,1,0.0,0.0
Gliga Florin,www.g4media.ro,0,0,1,1,0.0,0.0
Moga Bogdan,www.g4media.ro,0,0,1,1,0.0,0.0
Moisin Radu,www.g4media.ro,0,0,1,1,0.0,0.0
Moldovan Sorin,www.g4media.ro,0,0,1,1,0.0,0.0
Mircea Moroșan,www.g4media.ro,0,0,1,1,0.0,0.0
Rusu Rareș,www.g4media.ro,0,0,1,1,0.0,0.0
Sima Georgiana,www.g4media.ro,0,0,1,1,0.0,0.0
Radu Moisin,www.g4media.ro,0,0,1,1,0.0,0.0
Mihai Flamaropol,primanews.ro,0,0,1,1,0.0,0.0
Andreas Richter,www.comisarul.ro,0,0,1,1,0.0,0.0
Anna Nowakowska,www.comisarul.ro,0,0,1,1,0.0,0.0
Breslau,www.comisarul.ro,0,0,1,1,0.0,0.0
Kamila Świerczyńska,www.comisarul.ro,0,0,1,1,0.0,0.0
Piotr Koper,www.comisarul.ro,0,0,1,1,0.0,0.0
Wałbrzych,www.comisarul.ro,0,0,1,1,0.0,0.0
Wrocław,www.comisarul.ro,0,0,1,1,0.0,0.0
martor,www.comisarul.ro,0,2,2,4,-0.5,0.5
pasionat,www.comisarul.ro,0,0,1,1,0.0,0.0
Amedeea Enache,snoop.ro,0,0,1,1,0.0,0.0
Ciumăgeanu,snoop.ro,0,0,1,1,0.0,0.0
Cristina Dobre,snoop.ro,0,0,1,1,0.0,0.0
Eugen Nicolăescu,snoop.ro,0,0,2,2,0.0,0.0
Georgiana,snoop.ro,1,0,0,1,1.0,1.0
Poiana Mare,snoop.ro,0,1,0,1,-1.0,1.0
Prelipceanu,snoop.ro,0,1,1,2,-0.5,0.5
Radu Teodorescu,snoop.ro,0,0,1,1,0.0,0.0
Snoop Dogg,snoop.ro,0,0,2,2,0.0,0.0
Valentin Câmpeanu,snoop.ro,0,1,0,1,-1.0,1.0
Winkler,snoop.ro,0,1,0,1,-1.0,1.0
aparținător,snoop.ro,0,1,0,1,-1.0,1.0
asistentă medicală,snoop.ro,1,0,0,1,1.0,1.0
lucrător social,snoop.ro,0,0,1,1,0.0,0.0
nimănui,snoop.ro,0,1,0,1,-1.0,1.0
psihoterapeut,snoop.ro,1,0,1,2,0.5,0.5
tutore,snoop.ro,0,0,1,1,0.0,0.0
Elon Musk,www.realitatea.net,0,0,4,4,0.0,0.0
aliaț,www.realitatea.net,0,2,1,3,-0.6666666666666666,0.6666666666666666
miliardar,www.realitatea.net,0,0,5,5,0.0,0.0
Gorj,www.digi24.ro,0,0,1,1,0.0,0.0
jurist,www.digi24.ro,0,0,1,1,0.0,0.0
Tanczos,www.digi24.ro,0,0,1,1,0.0,0.0
Tanczos Barna,www.digi24.ro,0,0,3,3,0.0,0.0
Bulgaria,www.cotidianul.ro,0,0,1,1,0.0,0.0
Letonia,www.cotidianul.ro,0,0,1,1,0.0,0.0
Abrudean,www.antena3.ro,0,0,1,1,0.0,0.0
Mircea Abrudean,www.antena3.ro,1,0,1,2,0.5,0.5
Vasile Dîncu,stirileprotv.ro,0,0,1,1,0.0,0.0
competitor,stirileprotv.ro,0,3,0,3,-1.0,1.0
regină,stirileprotv.ro,1,0,1,2,0.5,0.5
sociolog,stirileprotv.ro,0,1,4,5,-0.2,0.2
sultanat,stirileprotv.ro,0,0,1,1,0.0,0.0
sultan,stirileprotv.ro,0,1,0,1,-1.0,1.0
Antal Rogán,www.romaniatv.net,0,1,0,1,-1.0,1.0
András Hort,www.romaniatv.net,0,0,1,1,0.0,0.0
Viktor Orbán,www.romaniatv.net,0,3,0,3,-1.0,1.0
Péter Magyar,www.romaniatv.net,0,1,1,2,-0.5,0.5
Tisza,www.romaniatv.net,0,0,1,1,0.0,0.0
editor,www.romaniatv.net,0,0,1,1,0.0,0.0
Gulyás,www.romaniatv.net,0,1,0,1,-1.0,1.0
Luju,www.luju.ro,0,0,3,3,0.0,0.0
Rareș Bogdan,www.luju.ro,0,1,0,1,-1.0,1.0
Gheorghe Piperea,www.luju.ro,0,0,1,1,0.0,0.0
reporter,www.luju.ro,0,0,1,1,0.0,0.0
Faiăr,www.gandul.ro,0,0,1,1,0.0,0.0
Boloș,www.antena3.ro,0,0,1,1,0.0,0.0
Marcel Boloș,www.antena3.ro,0,0,1,1,0.0,0.0
Bogdan Trif,www.news.ro,0,0,1,1,0.0,0.0
Horațiu Potra,www.news.ro,0,1,1,2,-0.5,0.5
Mediaș,www.news.ro,0,0,1,1,0.0,0.0
Potra,www.news.ro,0,0,1,1,0.0,0.0
Trif,www.news.ro,0,1,0,1,-1.0,1.0
anchetator,www.news.ro,0,1,0,1,-1.0,1.0
Gheorghe Roman,www.news.ro,0,0,1,1,0.0,0.0
Dana,www.digi24.ro,0,0,1,1,0.0,0.0
Mona Muscă,www.digi24.ro,0,1,0,1,-1.0,1.0
Monei Muscă,www.digi24.ro,0,1,0,1,-1.0,1.0
Georges Wolinski,www.digi24.ro,0,0,1,1,0.0,0.0
cercetător,www.digi24.ro,2,0,1,3,0.6666666666666666,0.6666666666666666
colaboratoare,www.digi24.ro,0,1,0,1,-1.0,1.0
informatoare,www.digi24.ro,0,0,1,1,0.0,0.0
Maryse Wolinski,www.digi24.ro,0,0,1,1,0.0,0.0
studentă,www.digi24.ro,0,0,1,1,0.0,0.0
oponent,www.gandul.ro,0,1,0,1,-1.0,1.0
Botoșani,www.gandul.ro,0,0,1,1,0.0,0.0
Doinei Federovici,www.gandul.ro,0,0,1,1,0.0,0.0
Doina Fedorovici,www.gandul.ro,0,0,1,1,0.0,0.0
Ihor Klimenko,www.news.ro,0,0,2,2,0.0,0.0
Sumî,www.news.ro,0,0,2,2,0.0,0.0
civil,www.news.ro,1,1,0,2,0.0,0.0
China,stirileprotv.ro,0,1,3,4,-0.25,0.25
Cornu,stirileprotv.ro,0,0,1,1,0.0,0.0
Dana Nastase,stirileprotv.ro,0,1,0,1,-1.0,1.0
Irina Jianu,stirileprotv.ro,0,0,1,1,0.0,0.0
Iulia Timosenko,stirileprotv.ro,0,0,1,1,0.0,0.0
guvernant,stirileprotv.ro,0,1,0,1,-1.0,1.0
Caracas,adevarul.ro,0,0,1,1,0.0,0.0
Coromoto Gotoy,adevarul.ro,0,0,1,1,0.0,0.0
Cuba,adevarul.ro,0,0,1,1,0.0,0.0
Fernando Carrillo,adevarul.ro,0,0,1,1,0.0,0.0
latină,adevarul.ro,0,0,1,1,0.0,0.0
Maduro,adevarul.ro,0,2,0,2,-1.0,1.0
Nicaragua,adevarul.ro,0,0,1,1,0.0,0.0
Nicolas Maduro,adevarul.ro,0,2,0,2,-1.0,1.0
Venezuela,adevarul.ro,0,1,1,2,-0.5,0.5
autocrat,adevarul.ro,0,1,0,1,-1.0,1.0
viceministru,adevarul.ro,0,0,1,1,0.0,0.0
Alexandru Rafila,www.aktual24.ro,0,0,4,4,0.0,0.0
Angel Tilvar,www.aktual24.ro,0,0,1,1,0.0,0.0
Ciprian Serban,www.aktual24.ro,0,0,4,4,0.0,0.0
Ladislau Cseke,www.aktual24.ro,0,0,1,1,0.0,0.0
Luminița Odobescu,www.aktual24.ro,0,0,1,1,0.0,0.0
Marcel Bolos Mediu,www.aktual24.ro,0,0,1,1,0.0,0.0
Mircea Fechet,www.aktual24.ro,0,0,3,3,0.0,0.0
Sebastian Burduja,www.aktual24.ro,0,0,5,5,0.0,0.0
Simona Bucura,www.aktual24.ro,0,0,1,1,0.0,0.0
Tánczos Barna,www.aktual24.ro,0,0,1,1,0.0,0.0
rival,www.euronews.ro,0,1,0,1,-1.0,1.0
Argeș,observatornews.ro,0,0,1,1,0.0,0.0
Marian Voicu,www.g4media.ro,0,0,1,1,0.0,0.0
Ramona Avramescu,www.g4media.ro,0,0,1,1,0.0,0.0
David,www.digi24.ro,0,0,2,2,0.0,0.0
Edupedu,www.digi24.ro,0,0,1,1,0.0,0.0
Ligia Deca,www.digi24.ro,0,1,0,1,-1.0,1.0
Mircea Miclea,www.digi24.ro,0,0,1,1,0.0,0.0
New York,www.digi24.ro,0,0,1,1,0.0,0.0
rector,www.digi24.ro,0,0,3,3,0.0,0.0
Rector,www.digi24.ro,0,0,2,2,0.0,0.0
cavaler,www.digi24.ro,0,0,1,1,0.0,0.0
doctor,www.digi24.ro,0,0,1,1,0.0,0.0
om de știință,www.digi24.ro,1,0,0,1,1.0,1.0
Radu Marinescu,www.romaniatv.net,0,0,2,2,0.0,0.0
decan,www.romaniatv.net,0,0,5,5,0.0,0.0
bonă,www.romaniatv.net,0,0,3,3,0.0,0.0
tutore,www.romaniatv.net,0,0,1,1,0.0,0.0
tutorel,www.romaniatv.net,0,0,1,1,0.0,0.0
preșcolar,www.romaniatv.net,0,0,1,1,0.0,0.0
Bulai,adevarul.ro,0,0,1,1,0.0,0.0
Islanda,adevarul.ro,0,0,1,1,0.0,0.0
Malta,adevarul.ro,0,1,0,1,-1.0,1.0
Norvegia,adevarul.ro,0,0,1,1,0.0,0.0
Oana Băluță,adevarul.ro,0,0,2,2,0.0,0.0
Suedia,adevarul.ro,0,0,3,3,0.0,0.0
Nicu Fălcoi,www.euronews.ro,0,0,2,2,0.0,0.0
Gabriel Vlase,www.euronews.ro,0,1,0,1,-1.0,1.0
compatriot,adevarul.ro,1,0,0,1,1.0,1.0
multor,adevarul.ro,0,2,0,2,-1.0,1.0
Brătieni,adevarul.ro,0,1,0,1,-1.0,1.0
cioloș,adevarul.ro,0,0,4,4,0.0,0.0
David Cameron,adevarul.ro,0,0,1,1,0.0,0.0
Djuvara,adevarul.ro,0,1,0,1,-1.0,1.0
Dudă,adevarul.ro,0,1,0,1,-1.0,1.0
Principele Nicolae,adevarul.ro,0,0,1,1,0.0,0.0
socialist,adevarul.ro,0,1,0,1,-1.0,1.0
neamț,adevarul.ro,0,1,0,1,-1.0,1.0
Cioloș,adevarul.ro,0,1,0,1,-1.0,1.0
tip,adevarul.ro,0,2,0,2,-1.0,1.0
EBA,a1.ro,0,0,1,1,0.0,0.0
basescu,a1.ro,0,1,0,1,-1.0,1.0
Elena Basescu,a1.ro,0,1,0,1,-1.0,1.0
Mihai Gheorghiu,adevarul.ro,0,0,1,1,0.0,0.0
Einstein,www.comisarul.ro,0,0,1,1,0.0,0.0
Ciucu,www.aktual24.ro,0,0,5,5,0.0,0.0
Costa,www.euronews.ro,0,0,1,1,0.0,0.0
Dmitri Peskov,www.euronews.ro,0,1,2,3,-0.3333333333333333,0.3333333333333333
Kremlin,www.euronews.ro,0,2,0,2,-1.0,1.0
Sergei Lavrov,www.euronews.ro,0,0,1,1,0.0,0.0
Gheorghe Beschiu,www.antena3.ro,0,0,1,1,0.0,0.0
Sacoșu Turcesc,www.antena3.ro,0,1,0,1,-1.0,1.0
agresor,www.antena3.ro,0,3,0,3,-1.0,1.0
crescător,www.antena3.ro,0,1,0,1,-1.0,1.0
oier,www.antena3.ro,0,1,0,1,-1.0,1.0
stâlp,www.antena3.ro,1,0,0,1,1.0,1.0
victimă,www.antena3.ro,0,3,0,3,-1.0,1.0
Kremlin,www.realitatea.net,0,2,0,2,-1.0,1.0
Turcia,www.realitatea.net,0,0,1,1,0.0,0.0
Gabriel LaBelle,www.cotidianul.ro,0,0,1,1,0.0,0.0
Glen Powell,www.cotidianul.ro,0,0,1,1,0.0,0.0
Hugh Grant,www.cotidianul.ro,0,0,1,1,0.0,0.0
Jesse Eisenberg,www.cotidianul.ro,0,0,1,1,0.0,0.0
Jesse Plemons,www.cotidianul.ro,0,0,1,1,0.0,0.0
Sebastian Stan,www.cotidianul.ro,1,0,0,1,1.0,1.0
Stan,www.cotidianul.ro,0,0,1,1,0.0,0.0
actorii,www.cotidianul.ro,0,0,2,2,0.0,0.0
Paul Giamatti,www.cotidianul.ro,0,0,1,1,0.0,0.0
iubit,www.cotidianul.ro,1,0,0,1,1.0,1.0
mame,www.cotidianul.ro,1,0,0,1,1.0,1.0
star,www.cotidianul.ro,0,0,2,2,0.0,0.0
Eoghan Murphy,adevarul.ro,0,0,1,1,0.0,0.0
Generalul Ciucă,observatornews.ro,0,1,0,1,-1.0,1.0
beneficiar,observatornews.ro,0,1,0,1,-1.0,1.0
demnitar,observatornews.ro,0,2,1,3,-0.6666666666666666,0.6666666666666666
muncitor,observatornews.ro,0,0,1,1,0.0,0.0
vizitator,observatornews.ro,0,0,1,1,0.0,0.0
Grațiela Gavrilescu,pressone.ro,0,0,1,1,0.0,0.0
Natalia Intotero,pressone.ro,0,0,2,2,0.0,0.0
Nicolae Iorga,pressone.ro,2,0,0,2,1.0,1.0
cadru medical,pressone.ro,0,2,0,2,-1.0,1.0
deținătoare,pressone.ro,0,1,0,1,-1.0,1.0
Oradea,stirileprotv.ro,0,0,3,3,0.0,0.0
omolog,www.news.ro,1,1,0,2,0.0,0.0
Cluj Napoca,www.gandul.ro,0,0,1,1,0.0,0.0
Borțun,www.gandul.ro,0,2,0,2,-1.0,1.0
Dumitru Borțun,www.gandul.ro,0,0,1,1,0.0,0.0
Miron Mitrea,www.realitatea.net,0,0,1,1,0.0,0.0
Mitrea,www.realitatea.net,0,0,1,1,0.0,0.0
Emanuel Ungureanu,www.digi24.ro,0,0,1,1,0.0,0.0
Auckland,primanews.ro,0,0,2,2,0.0,0.0
Noua Zeelandă,primanews.ro,0,0,2,2,0.0,0.0
Bogdan,www.aktual24.ro,0,2,1,3,-0.6666666666666666,0.6666666666666666
Rares Bogdan,www.aktual24.ro,0,0,1,1,0.0,0.0
Siegfried Mureșan,www.aktual24.ro,0,1,2,3,-0.3333333333333333,0.3333333333333333
Vlad Ciurea,www.comisarul.ro,0,0,5,5,0.0,0.0
Iusti Fudulu,www.comisarul.ro,0,0,1,1,0.0,0.0
medic neurochirurg,www.comisarul.ro,1,0,0,1,1.0,1.0
Bidzina Ivanishvili,www.aktual24.ro,0,0,1,1,0.0,0.0
Dmitri Medvedev,www.aktual24.ro,0,1,0,1,-1.0,1.0
Georgia,www.aktual24.ro,0,0,2,2,0.0,0.0
Letonia,www.aktual24.ro,0,0,2,2,0.0,0.0
Lituania,www.aktual24.ro,0,0,1,1,0.0,0.0
Moldova,www.aktual24.ro,2,2,3,7,0.0,0.0
Occident,www.aktual24.ro,0,0,3,3,0.0,0.0
Ombudsman,www.aktual24.ro,0,1,0,1,-1.0,1.0
Irakli Kobakhidze,www.aktual24.ro,0,1,0,1,-1.0,1.0
Salome Zourabichvili,www.aktual24.ro,0,0,1,1,0.0,0.0
Zourabichvili,www.aktual24.ro,0,0,1,1,0.0,0.0
instructor,www.aktual24.ro,0,0,1,1,0.0,0.0
manifestant,www.aktual24.ro,0,1,0,1,-1.0,1.0
protestatar,www.aktual24.ro,0,1,1,2,-0.5,0.5
Mihai Rapcea,www.luju.ro,0,0,2,2,0.0,0.0
Dragu,www.luju.ro,0,0,1,1,0.0,0.0
Gadea,www.luju.ro,0,1,0,1,-1.0,1.0
împărat,www.luju.ro,0,1,0,1,-1.0,1.0
Mihai Tociu,www.luju.ro,0,0,1,1,0.0,0.0
Racoare,www.luju.ro,0,1,0,1,-1.0,1.0
Rapcea,www.luju.ro,0,1,0,1,-1.0,1.0
Tiberiu Poparad,www.luju.ro,0,0,1,1,0.0,0.0
frate,www.luju.ro,2,1,0,3,0.3333333333333333,0.3333333333333333
Victor Dogaru,www.luju.ro,0,0,1,1,0.0,0.0
creștin,www.activenews.ro,0,1,0,1,-1.0,1.0
Manciurian,www.activenews.ro,0,1,0,1,-1.0,1.0
Eugen Simion,www.activenews.ro,0,0,1,1,0.0,0.0
Matei Păun,www.activenews.ro,0,2,0,2,-1.0,1.0
manager,www.activenews.ro,0,1,0,1,-1.0,1.0
mântuitor,www.activenews.ro,3,0,0,3,1.0,1.0
sorosist,www.activenews.ro,0,1,0,1,-1.0,1.0
scriitor,www.activenews.ro,0,0,2,2,0.0,0.0
Andrei Andreicuț,www.digi24.ro,0,1,0,1,-1.0,1.0
Cluj,www.digi24.ro,1,0,3,4,0.25,0.25
Feleacu,www.digi24.ro,0,1,0,1,-1.0,1.0
Vadul,www.digi24.ro,0,1,0,1,-1.0,1.0
domnul,www.digi24.ro,0,1,0,1,-1.0,1.0
față,www.digi24.ro,0,1,0,1,-1.0,1.0
fată,www.digi24.ro,0,1,0,1,-1.0,1.0
eu,www.digi24.ro,0,1,0,1,-1.0,1.0
prelat,www.digi24.ro,0,1,0,1,-1.0,1.0
străin,www.digi24.ro,0,1,0,1,-1.0,1.0
turnător,www.digi24.ro,0,2,0,2,-1.0,1.0
violator,www.digi24.ro,0,1,0,1,-1.0,1.0
Înalt Prea,www.digi24.ro,0,1,0,1,-1.0,1.0
Mircea Cărtărescu,www.digi24.ro,0,0,3,3,0.0,0.0
Tudor Chirilă,www.romaniatv.net,1,1,1,3,0.0,0.0
Firea,www.euronews.ro,0,0,3,3,0.0,0.0
Codrin Ștefănescu,adevarul.ro,0,0,1,1,0.0,0.0
Doru Ioan Tărăcilă,adevarul.ro,0,0,1,1,0.0,0.0
tărăcilă,adevarul.ro,0,0,1,1,0.0,0.0
Văcăroiu,adevarul.ro,0,0,1,1,0.0,0.0
Adelina Dobra,agerpres.ro,0,0,1,1,0.0,0.0
Andrei Dîrlău,agerpres.ro,0,0,1,1,0.0,0.0
Carmen Necula,agerpres.ro,0,0,1,1,0.0,0.0
Călin Zvancea Cozan,agerpres.ro,0,0,1,1,0.0,0.0
Demeter Andras Istvan,agerpres.ro,0,0,2,2,0.0,0.0
Mădălin Sîrbu,agerpres.ro,0,0,1,1,0.0,0.0
Nicoleta Pauliuc,agerpres.ro,0,0,2,2,0.0,0.0
Rodica Cușnir,agerpres.ro,0,0,1,1,0.0,0.0
Valeriu Zgonea,agerpres.ro,0,0,1,1,0.0,0.0
cadru universitar,agerpres.ro,0,0,1,1,0.0,0.0
intervenient,agerpres.ro,0,0,1,1,0.0,0.0
participanț,agerpres.ro,0,0,1,1,0.0,0.0
Mihai Coteț,agerpres.ro,0,0,1,1,0.0,0.0
Alex Cistelecan,pressone.ro,0,0,1,1,0.0,0.0
Alexandru Racu,pressone.ro,0,0,1,1,0.0,0.0
Clinton,pressone.ro,0,0,1,1,0.0,0.0
Cornel Ban,pressone.ro,0,0,1,1,0.0,0.0
Gary Gerstle,pressone.ro,0,0,1,1,0.0,0.0
Gerstle,pressone.ro,0,0,1,1,0.0,0.0
Kristen Ghodsee,pressone.ro,0,0,1,1,0.0,0.0
Mitchell Orenstein,pressone.ro,0,0,1,1,0.0,0.0
Nicu,pressone.ro,1,0,0,1,1.0,1.0
Orenstein,pressone.ro,0,0,1,1,0.0,0.0
Președintele Iliescu,pressone.ro,0,0,1,1,0.0,0.0
Silviu Faiăr,pressone.ro,0,0,1,1,0.0,0.0
Văcăroiu,pressone.ro,0,0,1,1,0.0,0.0
frați,pressone.ro,0,2,0,2,-1.0,1.0
premierul Tusk,pressone.ro,0,0,1,1,0.0,0.0
învinși,pressone.ro,0,1,0,1,-1.0,1.0
învinșit,pressone.ro,0,1,0,1,-1.0,1.0
Vâlcu,adevarul.ro,0,0,1,1,0.0,0.0
Val Vâlcu,adevarul.ro,0,0,1,1,0.0,0.0
Arabia Saudită,www.euronews.ro,0,1,0,1,-1.0,1.0
Eugen Sechila,www.euronews.ro,0,0,1,1,0.0,0.0
Sechila,www.euronews.ro,0,1,0,1,-1.0,1.0
personalitate,www.euronews.ro,0,0,4,4,0.0,0.0
Lucrețiu Pătrășcanu,www.luju.ro,0,0,1,1,0.0,0.0
Ma,www.luju.ro,0,1,0,1,-1.0,1.0
Claudiu Sa,www.luju.ro,0,0,1,1,0.0,0.0
Romeo Lungu,www.aktual24.ro,0,0,3,3,0.0,0.0
Adrian Acostoaiei,www.g4media.ro,0,0,1,1,0.0,0.0
Bogdan Iliescu,www.g4media.ro,0,0,1,1,0.0,0.0
Cosmin Stanciu,www.g4media.ro,0,0,1,1,0.0,0.0
Costel Dolachi,www.g4media.ro,0,0,1,1,0.0,0.0
Florentin Ciobotaru,www.g4media.ro,0,0,1,1,0.0,0.0
Ioana Dănilă,www.g4media.ro,0,0,1,1,0.0,0.0
Lucian Rusu,www.g4media.ro,0,0,1,1,0.0,0.0
Luciana Antoci,www.g4media.ro,0,0,1,1,0.0,0.0
Maria Cabalău,www.g4media.ro,0,0,1,1,0.0,0.0
Marius Minea,www.g4media.ro,0,0,1,1,0.0,0.0
Petronela Nechita,www.g4media.ro,1,0,0,1,1.0,1.0
Romeo Vatră,www.g4media.ro,0,0,1,1,0.0,0.0
Sorin Afloarei,www.g4media.ro,0,0,1,1,0.0,0.0
Sorin Năcuță,www.g4media.ro,0,0,1,1,0.0,0.0
ieșen,www.g4media.ro,1,0,0,1,1.0,1.0
Paul Ispas,primanews.ro,0,0,1,1,0.0,0.0
necunoscut,stirileprotv.ro,0,1,0,1,-1.0,1.0
Ștefureac,stirileprotv.ro,0,0,1,1,0.0,0.0
Andra Matei,primanews.ro,0,0,1,1,0.0,0.0
Bogdan Gogoncea,primanews.ro,0,0,1,1,0.0,0.0
Cleopatra David,primanews.ro,0,0,1,1,0.0,0.0
Delia Diaconescu,primanews.ro,0,0,1,1,0.0,0.0
Eugen Popa,primanews.ro,0,0,1,1,0.0,0.0
Gioachino Rossini,primanews.ro,0,0,1,1,0.0,0.0
Iunia Frandeș,primanews.ro,0,0,1,1,0.0,0.0
Natalia Pancec,primanews.ro,0,0,1,1,0.0,0.0
Săndel Smărăndescu,primanews.ro,0,0,1,1,0.0,0.0
Gabriel Oprea,www.antena3.ro,0,0,3,3,0.0,0.0
Liviu Drangea,www.antena3.ro,0,0,1,1,0.0,0.0
Vucic,www.antena3.ro,0,0,1,1,0.0,0.0
Pandele,www.aktual24.ro,0,1,0,1,-1.0,1.0
sustinatoare,www.aktual24.ro,0,1,0,1,-1.0,1.0
juriști,www.realitatea.net,0,1,0,1,-1.0,1.0
deținător,www.realitatea.net,0,1,0,1,-1.0,1.0
liche,www.realitatea.net,0,1,0,1,-1.0,1.0
ori,www.realitatea.net,0,1,0,1,-1.0,1.0
profesionist,www.realitatea.net,0,1,0,1,-1.0,1.0
Ankara,www.g4media.ro,0,0,1,1,0.0,0.0
Bursa,www.g4media.ro,0,0,1,1,0.0,0.0
Instanbul,www.g4media.ro,0,0,1,1,0.0,0.0
Izmir,www.g4media.ro,0,0,1,1,0.0,0.0
Luke John Askew,www.g4media.ro,0,0,1,1,0.0,0.0
Trolii,www.g4media.ro,0,1,0,1,-1.0,1.0
Turciei,www.g4media.ro,0,0,2,2,0.0,0.0
Regatul Unit,www.g4media.ro,0,0,1,1,0.0,0.0
client,www.g4media.ro,0,0,1,1,0.0,0.0
troll,www.g4media.ro,0,1,0,1,-1.0,1.0
șmecher,stirileprotv.ro,0,1,0,1,-1.0,1.0
Boureanu,www.gandul.ro,0,0,1,1,0.0,0.0
Cristian Boureanu,www.gandul.ro,0,0,1,1,0.0,0.0
Cristian Petrescu,www.gandul.ro,0,0,1,1,0.0,0.0
Elene Udrea,www.gandul.ro,0,1,1,2,-0.5,0.5
Ioan Bălan,www.gandul.ro,0,0,1,1,0.0,0.0
Fagaras,www.aktual24.ro,1,0,1,2,0.5,0.5
bunică,www.aktual24.ro,1,0,1,2,0.5,0.5
bunic,www.aktual24.ro,1,0,2,3,0.3333333333333333,0.3333333333333333
mamă,www.aktual24.ro,0,0,3,3,0.0,0.0
nepot,www.aktual24.ro,1,2,0,3,-0.3333333333333333,0.3333333333333333
olimpic,www.aktual24.ro,1,0,0,1,1.0,1.0
Jurnalista Lavinia Șandru,www.antena3.ro,0,0,1,1,0.0,0.0
umanist,www.antena3.ro,0,0,3,3,0.0,0.0
Dîncu,www.cotidianul.ro,0,1,1,2,-0.5,0.5
păpușar,www.gandul.ro,0,1,0,1,-1.0,1.0
Cătălin Striblea,www.antena3.ro,0,0,2,2,0.0,0.0
Mihail Neamțiu,www.antena3.ro,0,0,1,1,0.0,0.0
Mihail Neamțu,www.antena3.ro,0,0,1,1,0.0,0.0
Slănic,www.antena3.ro,0,1,0,1,-1.0,1.0
Ianculescu,recorder.ro,2,1,0,3,0.3333333333333333,0.3333333333333333
Ionuț Cengher,recorder.ro,0,2,1,3,-0.6666666666666666,0.6666666666666666
Ovidiu Ianculescu,recorder.ro,2,3,4,9,-0.1111111111111111,0.1111111111111111
avertizor,recorder.ro,1,0,1,2,0.5,0.5
Gabi Musteață,recorder.ro,0,1,1,2,-0.5,0.5
Birchall,www.antena3.ro,0,1,0,1,-1.0,1.0
Chris Coons,www.aktual24.ro,0,0,1,1,0.0,0.0
Chris Murphy,www.aktual24.ro,0,0,1,1,0.0,0.0
Jeanne Shaheen,www.aktual24.ro,0,0,1,1,0.0,0.0
Katie Britt,www.aktual24.ro,0,0,1,1,0.0,0.0
Pete Ricketts,www.aktual24.ro,0,0,1,1,0.0,0.0
Thom Tillis,www.aktual24.ro,0,0,1,1,0.0,0.0
Adriean Videanu,adevarul.ro,0,1,3,4,-0.25,0.25
Alina Mănoiu,adevarul.ro,0,0,1,1,0.0,0.0
Benea Alexandra Laura,adevarul.ro,0,0,1,1,0.0,0.0
Bogdan Mănoiu,adevarul.ro,0,0,1,1,0.0,0.0
Constantin Niță,adevarul.ro,0,0,1,1,0.0,0.0
Daniel Buda,adevarul.ro,0,0,1,1,0.0,0.0
Dumitru Benga,adevarul.ro,0,1,0,1,-1.0,1.0
Gheorghe Pogea,adevarul.ro,0,0,1,1,0.0,0.0
Grigore Buda,adevarul.ro,0,0,1,1,0.0,0.0
Ioan,adevarul.ro,0,0,1,1,0.0,0.0
Ion Vișoiu,adevarul.ro,0,0,1,1,0.0,0.0
Marius Locic,adevarul.ro,0,0,1,1,0.0,0.0
Mihai Cristian Benga,adevarul.ro,0,1,0,1,-1.0,1.0
Oana Zăvoranu,adevarul.ro,0,0,1,1,0.0,0.0
Oanei Zăvoranu,adevarul.ro,0,0,1,1,0.0,0.0
Pogea Ioan Alexandru,adevarul.ro,0,0,1,1,0.0,0.0
procuror general,adevarul.ro,0,0,3,3,0.0,0.0
Teodor Baconschi,adevarul.ro,0,0,1,1,0.0,0.0
Titus Corlățean,adevarul.ro,1,0,1,2,0.5,0.5
Tudor Tim Ionescu,adevarul.ro,0,0,1,1,0.0,0.0
Tudy,adevarul.ro,0,0,1,1,0.0,0.0
Vasile Creștin,adevarul.ro,0,0,1,1,0.0,0.0
Vișoiu,adevarul.ro,0,0,1,1,0.0,0.0
Vrânceanu Jenica Barbu,adevarul.ro,0,0,1,1,0.0,0.0
bibliotecar,adevarul.ro,0,0,1,1,0.0,0.0
cumnat,adevarul.ro,0,0,1,1,0.0,0.0
cursantă,adevarul.ro,0,0,1,1,0.0,0.0
iubit,adevarul.ro,0,0,2,2,0.0,0.0
Cristian Bușoi,adevarul.ro,0,0,2,2,0.0,0.0
protagonist,adevarul.ro,0,3,2,5,-0.6,0.6
stagiar,adevarul.ro,0,0,1,1,0.0,0.0
Daniel,www.g4media.ro,0,2,0,2,-1.0,1.0
Steve Bannon,www.g4media.ro,0,0,1,1,0.0,0.0
Valea,www.g4media.ro,0,1,0,1,-1.0,1.0
admirator,www.g4media.ro,0,1,0,1,-1.0,1.0
amândoi,www.g4media.ro,0,1,0,1,-1.0,1.0
co,www.g4media.ro,0,2,0,2,-1.0,1.0
contribuabil,www.g4media.ro,0,1,0,1,-1.0,1.0
căpetenie,www.g4media.ro,0,1,0,1,-1.0,1.0
destinatar,www.g4media.ro,0,1,0,1,-1.0,1.0
mareșal,www.g4media.ro,0,0,1,1,0.0,0.0
rude,www.g4media.ro,0,1,1,2,-0.5,0.5
solicitant,www.g4media.ro,0,1,1,2,-0.5,0.5
succesor,www.g4media.ro,0,1,0,1,-1.0,1.0
ultras,www.g4media.ro,0,1,0,1,-1.0,1.0
Aurel Fierăscu,recorder.ro,0,0,1,1,0.0,0.0
Ben Carson,recorder.ro,0,0,1,1,0.0,0.0
Costel Barbu,recorder.ro,0,0,1,1,0.0,0.0
Dănuț Cristescu,recorder.ro,0,0,1,1,0.0,0.0
Ellen White,recorder.ro,0,0,1,1,0.0,0.0
Eugen Pîrvulescu,recorder.ro,0,1,3,4,-0.25,0.25
Florică Ică Calotă,recorder.ro,0,1,0,1,-1.0,1.0
Maria Stoian,recorder.ro,0,0,1,1,0.0,0.0
Paul Stancu,recorder.ro,0,0,1,1,0.0,0.0
Roșiori de Vede,recorder.ro,0,0,2,2,0.0,0.0
Samuel Calotă,recorder.ro,0,0,1,1,0.0,0.0
Turnu Măgurele,recorder.ro,0,1,1,2,-0.5,0.5
Zimnicea,recorder.ro,0,0,1,1,0.0,0.0
stakeholder,recorder.ro,0,0,1,1,0.0,0.0
Diana Șoșoacă,www.mediafax.ro,0,0,1,1,0.0,0.0
Sergiu Mișcoiu,www.mediafax.ro,0,0,1,1,0.0,0.0
Costa,adevarul.ro,0,1,0,1,-1.0,1.0
federație,adevarul.ro,0,1,0,1,-1.0,1.0
Ionela Ciolan,adevarul.ro,0,0,2,2,0.0,0.0
Kajei Kallas,adevarul.ro,0,1,0,1,-1.0,1.0
Ursula von der Leyen,adevarul.ro,0,1,2,3,-0.3333333333333333,0.3333333333333333
estona Kaja Kallas,adevarul.ro,0,0,1,1,0.0,0.0
perdanț,adevarul.ro,0,1,0,1,-1.0,1.0
Chicago,www.gandul.ro,0,0,1,1,0.0,0.0
Corneliu Dobrițoiu,www.gandul.ro,0,0,1,1,0.0,0.0
Dobre,adevarul.ro,0,0,1,1,0.0,0.0
Ioan Rus,adevarul.ro,0,0,1,1,0.0,0.0
Robu,adevarul.ro,0,0,1,1,0.0,0.0
Rus,adevarul.ro,0,1,0,1,-1.0,1.0
Victor Dobre,adevarul.ro,0,0,1,1,0.0,0.0
aceastia,adevarul.ro,0,1,1,2,-0.5,0.5
Dumitrescu,adevarul.ro,0,0,2,2,0.0,0.0
Gheorghe Ursu,adevarul.ro,0,2,0,2,-1.0,1.0
Ionescu,adevarul.ro,0,2,1,3,-0.6666666666666666,0.6666666666666666
Mihail Creangă,adevarul.ro,0,1,0,1,-1.0,1.0
Răzvan Ionescu,adevarul.ro,0,0,1,1,0.0,0.0
Ticu Dumitrescu,adevarul.ro,0,0,1,1,0.0,0.0
Tudor Stănică,adevarul.ro,0,1,0,1,-1.0,1.0
asasin,adevarul.ro,0,1,0,1,-1.0,1.0
militian,adevarul.ro,0,1,0,1,-1.0,1.0
ofiter,adevarul.ro,0,1,0,1,-1.0,1.0
responsabil,adevarul.ro,0,1,1,2,-0.5,0.5
,www.euronews.ro,0,0,1,1,0.0,0.0
Cristian Andrei,www.euronews.ro,0,0,2,2,0.0,0.0
consultant,www.euronews.ro,0,0,1,1,0.0,0.0
nemulțumit,www.euronews.ro,0,1,0,1,-1.0,1.0
public,www.euronews.ro,0,1,2,3,-0.3333333333333333,0.3333333333333333
Cătălina Porumbel,www.antena3.ro,0,1,2,3,-0.3333333333333333,0.3333333333333333
militar,www.antena3.ro,0,1,2,3,-0.3333333333333333,0.3333333333333333
senior,www.digi24.ro,1,0,0,1,1.0,1.0
Adrian Negrescu,primanews.ro,0,1,0,1,-1.0,1.0
român,primanews.ro,1,0,2,3,0.3333333333333333,0.3333333333333333
investitor,primanews.ro,1,1,1,3,0.0,0.0
Sebastian Zachmann,primanews.ro,0,0,2,2,0.0,0.0
Covasna,stirileprotv.ro,0,0,3,3,0.0,0.0
Harghita,stirileprotv.ro,0,0,3,3,0.0,0.0
Jakarta,www.mediafax.ro,0,0,1,1,0.0,0.0
Kovesi,www.mediafax.ro,0,1,1,2,-0.5,0.5
Laura Codruța Kovesi,www.mediafax.ro,0,1,1,2,-0.5,0.5
Nicolae Popa,www.mediafax.ro,0,0,1,1,0.0,0.0
Anamaria Gavrilă,observatornews.ro,0,0,2,2,0.0,0.0
Becali,observatornews.ro,0,0,1,1,0.0,0.0
Gavrilă,observatornews.ro,0,0,2,2,0.0,0.0
Sharaa,www.aktual24.ro,0,0,1,1,0.0,0.0
Siria,www.aktual24.ro,0,0,1,1,0.0,0.0
Sirie,www.aktual24.ro,0,0,1,1,0.0,0.0
Remus Ștefureac,stirileprotv.ro,0,0,1,1,0.0,0.0
Helmut Duckadam,a1.ro,0,0,1,1,0.0,0.0
Eugen Dijmărescu,recorder.ro,0,1,0,1,-1.0,1.0
senatoare,recorder.ro,0,1,1,2,-0.5,0.5
Sfânta,recorder.ro,0,0,1,1,0.0,0.0
Sfântul Andrei,recorder.ro,0,0,1,1,0.0,0.0
Beny Steinmetz,a1.ro,0,1,0,1,-1.0,1.0
Benyamin Steinmetz,a1.ro,0,1,0,1,-1.0,1.0
Băneasa,a1.ro,0,0,1,1,0.0,0.0
Carol Ferdinand,a1.ro,0,0,1,1,0.0,0.0
Dan Andronic,a1.ro,0,1,0,1,-1.0,1.0
Helena Henriette Nagavitzine,a1.ro,0,0,1,1,0.0,0.0
Lia,a1.ro,0,0,1,1,0.0,0.0
Lia Georgia Triff,a1.ro,0,0,1,1,0.0,0.0
Malta,a1.ro,0,0,2,2,0.0,0.0
Maltei,a1.ro,0,0,1,1,0.0,0.0
Mihai,a1.ro,0,0,1,1,0.0,0.0
Mircea Grigore Carol Lambrino,a1.ro,0,0,1,1,0.0,0.0
Moshe Agavi,a1.ro,0,1,0,1,-1.0,1.0
Paul,a1.ro,0,1,1,2,-0.5,0.5
Paul Lambrino,a1.ro,0,0,1,1,0.0,0.0
Paul Philippe,a1.ro,0,1,1,2,-0.5,0.5
Prințul Paul al României,a1.ro,0,0,1,1,0.0,0.0
Remus Truică,a1.ro,0,1,0,1,-1.0,1.0
Tal Silberstein,a1.ro,0,0,1,1,0.0,0.0
Zizi Lambrino,a1.ro,0,0,1,1,0.0,0.0
prințesă,a1.ro,0,0,1,1,0.0,0.0
rege,a1.ro,0,1,0,1,-1.0,1.0
unchi,a1.ro,0,1,0,1,-1.0,1.0
George Crin Laurentiu Antonescu,www.aktual24.ro,0,0,1,1,0.0,0.0
Varujan Pambuccian,www.aktual24.ro,0,0,2,2,0.0,0.0
Slovacia,www.realitatea.net,0,0,1,1,0.0,0.0
Fico,www.realitatea.net,0,1,0,1,-1.0,1.0
Adrian Nastase,www.euronews.ro,0,0,1,1,0.0,0.0
Ambii,www.euronews.ro,0,1,0,1,-1.0,1.0
Emil Boc,www.euronews.ro,0,0,2,2,0.0,0.0
Raluca Turcan,www.euronews.ro,0,0,1,1,0.0,0.0
coordonator,www.euronews.ro,0,1,0,1,-1.0,1.0
sociolog,www.euronews.ro,0,0,3,3,0.0,0.0
suveranist,www.euronews.ro,0,4,0,4,-1.0,1.0
suveran,www.euronews.ro,0,2,0,2,-1.0,1.0
Alison Mutler,www.aktual24.ro,0,0,1,1,0.0,0.0
Laura Codruța Kovesi,www.aktual24.ro,0,1,0,1,-1.0,1.0
Mutler,www.aktual24.ro,0,0,1,1,0.0,0.0
corespondent,www.aktual24.ro,1,0,0,1,1.0,1.0
invins,www.aktual24.ro,0,1,0,1,-1.0,1.0
succesor,www.aktual24.ro,0,0,2,2,0.0,0.0
Godină,www.cotidianul.ro,0,1,0,1,-1.0,1.0
Marian Godină,www.cotidianul.ro,0,1,0,1,-1.0,1.0
comediant,www.cotidianul.ro,0,1,0,1,-1.0,1.0
Simionu,www.cotidianul.ro,0,1,0,1,-1.0,1.0
Călin,www.cotidianul.ro,0,1,0,1,-1.0,1.0
Eduard Hellvig,www.aktual24.ro,0,1,1,2,-0.5,0.5
Hellvig,www.aktual24.ro,0,1,0,1,-1.0,1.0
Gheorghe Falcă,www.b1tv.ro,0,0,2,2,0.0,0.0
Badea,a1.ro,0,0,1,1,0.0,0.0
Florin Paslaru,a1.ro,0,1,0,1,-1.0,1.0
Gadea,a1.ro,0,0,1,1,0.0,0.0
Mihai Gadea,a1.ro,0,0,2,2,0.0,0.0
realizator,a1.ro,0,1,1,2,-0.5,0.5
Bosnia și Herțegovina,www.gandul.ro,0,0,1,1,0.0,0.0
Sibiu,www.gandul.ro,0,0,1,1,0.0,0.0
Breton,www.luju.ro,0,1,0,1,-1.0,1.0
domnului,www.luju.ro,0,1,0,1,-1.0,1.0
JD Vance,www.luju.ro,0,1,0,1,-1.0,1.0
James David Vance,www.luju.ro,0,1,0,1,-1.0,1.0
Munchen,www.luju.ro,0,0,1,1,0.0,0.0
URSS,www.luju.ro,0,1,0,1,-1.0,1.0
Vance,www.luju.ro,0,1,0,1,-1.0,1.0
apărător,www.luju.ro,0,1,0,1,-1.0,1.0
dizident,www.luju.ro,0,1,0,1,-1.0,1.0
Diana Iovanovici Șoșoacă,adevarul.ro,0,0,1,1,0.0,0.0
Diana Iovanovici,adevarul.ro,0,0,2,2,0.0,0.0
subsemnat,adevarul.ro,0,0,1,1,0.0,0.0
Craiova,www.mediafax.ro,0,0,1,1,0.0,0.0
Paul Stănescu,www.mediafax.ro,0,0,4,4,0.0,0.0
Stănescu,www.mediafax.ro,0,0,1,1,0.0,0.0
Varujan Pambucian,www.luju.ro,0,0,1,1,0.0,0.0
Marco Rubio,www.aktual24.ro,0,0,2,2,0.0,0.0
stat,www.aktual24.ro,0,1,0,1,-1.0,1.0
înlocuitor,www.aktual24.ro,0,1,0,1,-1.0,1.0
Dacian Ciolos,www.aktual24.ro,0,0,2,2,0.0,0.0
vameș,www.aktual24.ro,0,1,0,1,-1.0,1.0
Aneta Popescu,www.news.ro,0,0,1,1,0.0,0.0
Bichir,www.news.ro,0,0,1,1,0.0,0.0
Florian Bichir,www.news.ro,0,0,2,2,0.0,0.0
Zelea Codreanu,www.news.ro,0,0,1,1,0.0,0.0
funcționar,www.news.ro,0,3,1,4,-0.75,0.75
mamă,www.news.ro,0,1,1,2,-0.5,0.5
Maramureș,a1.ro,0,0,2,2,0.0,0.0
Mioara Mantale,a1.ro,0,0,1,1,0.0,0.0
Neamțu,a1.ro,0,0,1,1,0.0,0.0
Strasbourg,a1.ro,0,0,1,1,0.0,0.0
consul,a1.ro,0,1,1,2,-0.5,0.5
camarad,www.romaniatv.net,0,1,0,1,-1.0,1.0
latifundar,www.romaniatv.net,0,1,0,1,-1.0,1.0
"Calin Georgescu, candidatul",www.luju.ro,0,1,0,1,-1.0,1.0
Oradea,www.luju.ro,0,0,1,1,0.0,0.0
diplomat,www.aktual24.ro,0,0,2,2,0.0,0.0
Anglia,www.cotidianul.ro,0,1,2,3,-0.3333333333333333,0.3333333333333333
Belgia,www.cotidianul.ro,0,0,1,1,0.0,0.0
Cairo,www.cotidianul.ro,0,0,1,1,0.0,0.0
Dan Amedeo Lăzărescu,www.cotidianul.ro,0,1,0,1,-1.0,1.0
Egipt,www.cotidianul.ro,0,0,1,1,0.0,0.0
Federația Rusă,www.cotidianul.ro,0,1,0,1,-1.0,1.0
Generalul Antonescu,www.cotidianul.ro,0,0,1,1,0.0,0.0
Marele Partener Strategic,www.cotidianul.ro,0,1,0,1,-1.0,1.0
Nicolae Ceaușescu,www.cotidianul.ro,0,1,0,1,-1.0,1.0
omega,www.cotidianul.ro,0,1,0,1,-1.0,1.0
România Mare,www.cotidianul.ro,0,1,0,1,-1.0,1.0
Silviu Predoiu,www.cotidianul.ro,0,0,2,2,0.0,0.0
Vâlcea,www.cotidianul.ro,0,1,1,2,-0.5,0.5
atașat militar,www.cotidianul.ro,0,0,1,1,0.0,0.0
bucătar,www.cotidianul.ro,0,0,1,1,0.0,0.0
camarad,www.cotidianul.ro,0,0,1,1,0.0,0.0
discipol,www.cotidianul.ro,0,1,0,1,-1.0,1.0
figuranț,www.cotidianul.ro,0,1,0,1,-1.0,1.0
Eugen Bădălan,www.cotidianul.ro,0,0,1,1,0.0,0.0
Bogdan Ciucă,www.cotidianul.ro,0,1,0,1,-1.0,1.0
Ion Antonescu,www.cotidianul.ro,0,0,1,1,0.0,0.0
infirmier,www.cotidianul.ro,0,0,1,1,0.0,0.0
kilometru,www.cotidianul.ro,0,1,0,1,-1.0,1.0
maseor,www.cotidianul.ro,0,1,0,1,-1.0,1.0
omenire,www.cotidianul.ro,0,1,0,1,-1.0,1.0
ospătar,www.cotidianul.ro,0,1,0,1,-1.0,1.0
purtător,www.cotidianul.ro,0,1,0,1,-1.0,1.0
rege,www.cotidianul.ro,0,0,2,2,0.0,0.0
subofițer,www.cotidianul.ro,0,1,0,1,-1.0,1.0
superior,www.cotidianul.ro,0,1,0,1,-1.0,1.0
vedet,www.cotidianul.ro,0,1,1,2,-0.5,0.5
Adrian Veștea,primanews.ro,1,0,0,1,1.0,1.0
Alexandru Macedon,primanews.ro,0,0,1,1,0.0,0.0
Alina Gorghiu,primanews.ro,0,0,1,1,0.0,0.0
Antonia Trușcă,primanews.ro,0,0,1,1,0.0,0.0
Arșeș,primanews.ro,0,0,1,1,0.0,0.0
Constantin Brâncuși,primanews.ro,1,0,0,1,1.0,1.0
Dan Motreanu,primanews.ro,0,0,1,1,0.0,0.0
Emil Boc,primanews.ro,1,0,2,3,0.3333333333333333,0.3333333333333333
Geoană,primanews.ro,0,0,1,1,0.0,0.0
Lucian Bode,primanews.ro,1,0,1,2,0.5,0.5
Mario De Mezzo,primanews.ro,0,0,1,1,0.0,0.0
Napoleon,primanews.ro,0,0,1,1,0.0,0.0
Nicu,primanews.ro,0,1,0,1,-1.0,1.0
Paul Stănescu,primanews.ro,0,0,2,2,0.0,0.0
premier candidat,primanews.ro,0,1,0,1,-1.0,1.0
Rareș Bogdan,primanews.ro,2,0,7,9,0.2222222222222222,0.2222222222222222
Tudose,primanews.ro,0,1,2,3,-0.3333333333333333,0.3333333333333333
Valeriu Eftimie,primanews.ro,0,0,1,1,0.0,0.0
Valeriu Stoica,primanews.ro,0,0,1,1,0.0,0.0
antreprenor,primanews.ro,1,0,1,2,0.5,0.5
delegat,primanews.ro,0,0,2,2,0.0,0.0
exponent,primanews.ro,0,1,0,1,-1.0,1.0
muncitor,primanews.ro,1,0,0,1,1.0,1.0
prezidențial,primanews.ro,1,0,0,1,1.0,1.0
învingător,primanews.ro,1,0,0,1,1.0,1.0
Groza,www.b1tv.ro,0,1,0,1,-1.0,1.0
Ioan Rus,www.b1tv.ro,0,0,1,1,0.0,0.0
Ioan Ștefan Groza,www.b1tv.ro,0,1,1,2,-0.5,0.5
Predeal,www.b1tv.ro,0,0,1,1,0.0,0.0
Vasilica Dăncilă,www.b1tv.ro,0,0,1,1,0.0,0.0
animatoare,www.b1tv.ro,0,0,1,1,0.0,0.0
apropiat,www.b1tv.ro,0,0,1,1,0.0,0.0
dansatoare,www.b1tv.ro,0,0,1,1,0.0,0.0
manager,www.b1tv.ro,0,0,1,1,0.0,0.0
secretar de stat,www.b1tv.ro,0,0,1,1,0.0,0.0
emisar,primanews.ro,0,0,3,3,0.0,0.0
Keith Kellogg,primanews.ro,0,0,1,1,0.0,0.0
Steve Witkoff,primanews.ro,0,0,1,1,0.0,0.0
N. Dan,www.cotidianul.ro,0,1,0,1,-1.0,1.0
băiat,www.cotidianul.ro,0,2,0,2,-1.0,1.0
politruc,www.cotidianul.ro,0,3,0,3,-1.0,1.0
profitor,www.cotidianul.ro,0,1,0,1,-1.0,1.0
rapsozii,www.cotidianul.ro,0,1,0,1,-1.0,1.0
Afganistan,www.realitatea.net,0,0,1,1,0.0,0.0
fotograf,recorder.ro,0,1,0,1,-1.0,1.0
proști,recorder.ro,0,2,0,2,-1.0,1.0
Andreea Esca,stirileprotv.ro,0,0,2,2,0.0,0.0
Strasbourg,stirileprotv.ro,0,0,4,4,0.0,0.0
cuiva,stirileprotv.ro,0,1,0,1,-1.0,1.0
susținător,stirileprotv.ro,0,2,1,3,-0.6666666666666666,0.6666666666666666
Bode,snoop.ro,0,1,1,2,-0.5,0.5
Ciprian Ciucu,snoop.ro,0,0,2,2,0.0,0.0
Ciucu,snoop.ro,0,0,1,1,0.0,0.0
Cătălin Tolontan,snoop.ro,0,0,1,1,0.0,0.0
Dan Motreanu,snoop.ro,0,0,1,1,0.0,0.0
Diana Meseșan,snoop.ro,0,0,1,1,0.0,0.0
Dineș,snoop.ro,0,0,1,1,0.0,0.0
Ionuț Pătrășcoiu,snoop.ro,0,0,1,1,0.0,0.0
Kensington,snoop.ro,0,0,1,1,0.0,0.0
Motreanu,snoop.ro,0,0,1,1,0.0,0.0
Predoiu,snoop.ro,0,0,1,1,0.0,0.0
Pătrășcoiu,snoop.ro,0,0,1,1,0.0,0.0
Rareș,snoop.ro,0,0,1,1,0.0,0.0
Roberta,snoop.ro,0,0,1,1,0.0,0.0
Roberta Metsola,snoop.ro,0,0,1,1,0.0,0.0
Strasbourg,snoop.ro,0,0,1,1,0.0,0.0
tip,snoop.ro,0,2,0,2,-1.0,1.0
Gândaci,pressone.ro,0,1,0,1,-1.0,1.0
Petre,pressone.ro,0,0,1,1,0.0,0.0
poponar,pressone.ro,0,1,0,1,-1.0,1.0
Răzvan Biro,pressone.ro,0,0,1,1,0.0,0.0
tânăr patriot,pressone.ro,0,1,0,1,-1.0,1.0
Vlad Petre,pressone.ro,0,0,1,1,0.0,0.0
schior,pressone.ro,0,1,0,1,-1.0,1.0
Alex Nedea,recorder.ro,0,0,1,1,0.0,0.0
Alin Ignat,recorder.ro,0,0,1,1,0.0,0.0
Geoană,recorder.ro,0,2,0,2,-1.0,1.0
guvern,recorder.ro,0,1,0,1,-1.0,1.0
Iuliana Scîntei,recorder.ro,0,0,1,1,0.0,0.0
Liviu Brătescu,recorder.ro,0,0,1,1,0.0,0.0
Ovidiu Voicu,recorder.ro,0,0,1,1,0.0,0.0
Silviu Munteanu,recorder.ro,0,0,1,1,0.0,0.0
Cârța,pressone.ro,0,0,1,1,0.0,0.0
Hunor,pressone.ro,0,0,2,2,0.0,0.0
Kelemen,pressone.ro,0,0,1,1,0.0,0.0
Liviu,pressone.ro,0,1,1,2,-0.5,0.5
Markó,pressone.ro,0,0,1,1,0.0,0.0
Raul Ștef Tîrgu Mureș,pressone.ro,0,0,1,1,0.0,0.0
Transilvania,pressone.ro,0,0,1,1,0.0,0.0
Târgu,pressone.ro,0,0,1,1,0.0,0.0
consilier prezidențial,pressone.ro,0,0,1,1,0.0,0.0
drac,pressone.ro,0,1,0,1,-1.0,1.0
moț,pressone.ro,0,0,1,1,0.0,0.0
prietene,pressone.ro,2,0,0,2,1.0,1.0
Țebea,pressone.ro,0,1,0,1,-1.0,1.0
Drăghici,www.digi24.ro,0,1,0,1,-1.0,1.0
Mircea Drăghici,www.digi24.ro,0,0,1,1,0.0,0.0
trezorier,www.digi24.ro,0,2,0,2,-1.0,1.0
vânzător,www.digi24.ro,0,0,1,1,0.0,0.0
Dacian Ciolos,stirileprotv.ro,0,1,3,4,-0.25,0.25
demnitar,stirileprotv.ro,0,0,1,1,0.0,0.0
Guvernul Ciolacu,observatornews.ro,0,1,0,1,-1.0,1.0
bugetari,observatornews.ro,0,1,0,1,-1.0,1.0
Constantinescu,www.cotidianul.ro,0,1,0,1,-1.0,1.0
prezidențiabil,www.cotidianul.ro,0,1,0,1,-1.0,1.0
prieten,www.cotidianul.ro,2,0,3,5,0.4,0.4
Constanța,www.cotidianul.ro,0,0,3,3,0.0,0.0
Ovidiu Cupșa,www.cotidianul.ro,0,0,1,1,0.0,0.0
Petru Avram,observatornews.ro,0,0,2,2,0.0,0.0
chelner,observatornews.ro,1,0,0,1,1.0,1.0
chelneriță,observatornews.ro,0,1,1,2,-0.5,0.5
domnișoară,observatornews.ro,0,0,1,1,0.0,0.0
student,observatornews.ro,0,0,6,6,0.0,0.0
subordonat,observatornews.ro,0,1,0,1,-1.0,1.0
Dan Dungaciu,adevarul.ro,0,3,9,12,-0.25,0.25
Dungaciu,adevarul.ro,0,0,3,3,0.0,0.0
Târgu Mureș,adevarul.ro,0,0,2,2,0.0,0.0
comodatar,adevarul.ro,0,0,1,1,0.0,0.0
tovarăș,stirileprotv.ro,0,0,1,1,0.0,0.0
Belgrad,www.gandul.ro,0,2,0,2,-1.0,1.0
Diana Stoica,www.b1tv.ro,0,0,3,3,0.0,0.0
Danda,www.luju.ro,0,1,0,1,-1.0,1.0
Ghita,www.luju.ro,0,0,1,1,0.0,0.0
lume,www.luju.ro,0,1,1,2,-0.5,0.5
tuturor,www.luju.ro,1,1,0,2,0.0,0.0
Alexandru Athanasiu,adevarul.ro,0,0,1,1,0.0,0.0
Alexandru Sassu,adevarul.ro,0,1,0,1,-1.0,1.0
Anca Petrescu,adevarul.ro,0,0,1,1,0.0,0.0
Sorin Oprescu,adevarul.ro,0,1,1,2,-0.5,0.5
Bratianu,adevarul.ro,0,1,0,1,-1.0,1.0
Călin Popescu-Tăriceanu,adevarul.ro,0,0,1,1,0.0,0.0
Cornel Dinu,adevarul.ro,0,0,1,1,0.0,0.0
Crin Halaicu,adevarul.ro,0,0,1,1,0.0,0.0
Cristian Popescu,adevarul.ro,0,0,1,1,0.0,0.0
Doru Mihalache,adevarul.ro,1,0,0,1,1.0,1.0
Dumitru Dragomir,adevarul.ro,0,0,1,1,0.0,0.0
George Padure,adevarul.ro,0,0,2,2,0.0,0.0
Gheorghe Popilean,adevarul.ro,0,1,0,1,-1.0,1.0
Gheorghe Tinca,adevarul.ro,0,0,1,1,0.0,0.0
Ioan Radu,adevarul.ro,0,0,1,1,0.0,0.0
Ion I. Bratianu,adevarul.ro,0,1,0,1,-1.0,1.0
Lis,adevarul.ro,0,0,1,1,0.0,0.0
Marian Vanghelie,adevarul.ro,0,1,0,1,-1.0,1.0
Mihai Erbasu,adevarul.ro,0,0,1,1,0.0,0.0
Mihai Florin Nahorniac,adevarul.ro,0,0,1,1,0.0,0.0
Mihail Erbasu,adevarul.ro,0,0,1,1,0.0,0.0
Minodora Ilie,adevarul.ro,0,0,1,1,0.0,0.0
Mircea Chelaru,adevarul.ro,1,0,1,2,0.5,0.5
Mircea Cosea,adevarul.ro,0,0,2,2,0.0,0.0
Mugur Ciuvica,adevarul.ro,0,0,1,1,0.0,0.0
Nahorniac,adevarul.ro,0,1,0,1,-1.0,1.0
Oprescu,adevarul.ro,0,0,1,1,0.0,0.0
Piedone,adevarul.ro,0,3,0,3,-1.0,1.0
Radu Opaina,adevarul.ro,0,0,1,1,0.0,0.0
Ralu Filip,adevarul.ro,0,0,1,1,0.0,0.0
Tatoiu Monica,adevarul.ro,0,1,0,1,-1.0,1.0
Valentin Iliescu,adevarul.ro,0,0,1,1,0.0,0.0
Vanghelie,adevarul.ro,0,0,1,1,0.0,0.0
Varujan Vosganian,adevarul.ro,0,0,2,2,0.0,0.0
Victor Ciorbea,adevarul.ro,0,2,2,4,-0.5,0.5
Victor Surdu,adevarul.ro,0,0,1,1,0.0,0.0
Videanu,adevarul.ro,0,1,0,1,-1.0,1.0
Viorel Catarama,adevarul.ro,0,1,0,1,-1.0,1.0
Viorel Lis,adevarul.ro,0,0,2,2,0.0,0.0
Vlad Țepeș,adevarul.ro,0,1,0,1,-1.0,1.0
bucureștean,adevarul.ro,1,1,4,6,0.0,0.0
celor,adevarul.ro,0,1,0,1,-1.0,1.0
comic,adevarul.ro,0,0,1,1,0.0,0.0
detinator,adevarul.ro,0,1,0,1,-1.0,1.0
Cazimir Ionescu,adevarul.ro,0,1,0,1,-1.0,1.0
Nicolae Nitu,adevarul.ro,0,0,1,1,0.0,0.0
grec,adevarul.ro,0,1,0,1,-1.0,1.0
perdant,adevarul.ro,0,2,0,2,-1.0,1.0
Nica Leon,adevarul.ro,0,0,1,1,0.0,0.0
succesor,adevarul.ro,0,2,1,3,-0.6666666666666666,0.6666666666666666
vizionar,adevarul.ro,2,1,1,4,0.25,0.25
voievod,adevarul.ro,0,1,0,1,-1.0,1.0
zeița Fortuna,adevarul.ro,0,1,0,1,-1.0,1.0
Adrian Țuțuianu,www.cotidianul.ro,0,0,1,1,0.0,0.0
Adriana Antipa,www.cotidianul.ro,0,0,1,1,0.0,0.0
Anca Comănici,www.cotidianul.ro,0,0,1,1,0.0,0.0
Andrei Dolineaschi,www.cotidianul.ro,0,0,1,1,0.0,0.0
Carmen Avram,www.cotidianul.ro,0,0,1,1,0.0,0.0
Cătălin Manea,www.cotidianul.ro,0,0,1,1,0.0,0.0
Daniel Zamfir,www.cotidianul.ro,0,0,2,2,0.0,0.0
Diana Tușa,www.cotidianul.ro,0,0,1,1,0.0,0.0
Firea,www.cotidianul.ro,0,0,1,1,0.0,0.0
Gabriel Mutu,www.cotidianul.ro,0,0,1,1,0.0,0.0
Ioan Mihalcea,www.cotidianul.ro,0,0,1,1,0.0,0.0
Mihai Ghigiu,www.cotidianul.ro,0,0,1,1,0.0,0.0
Mirela Furtună,www.cotidianul.ro,0,0,1,1,0.0,0.0
Mădălin Jijie,www.cotidianul.ro,0,0,1,1,0.0,0.0
Nicuța Enache,www.cotidianul.ro,0,0,1,1,0.0,0.0
Petre Florin Manole,www.cotidianul.ro,0,0,1,1,0.0,0.0
Robert Cazanciuc,www.cotidianul.ro,0,0,1,1,0.0,0.0
Rodica Nassar,www.cotidianul.ro,0,0,1,1,0.0,0.0
Camelia Chicomban,pressone.ro,0,1,0,1,-1.0,1.0
Karl Marx,pressone.ro,0,0,1,1,0.0,0.0
Blaj,www.euronews.ro,0,0,1,1,0.0,0.0
Dej,www.euronews.ro,0,1,0,1,-1.0,1.0
Gherla,www.euronews.ro,0,1,0,1,-1.0,1.0
Papa Francisc,www.euronews.ro,2,0,2,4,0.5,0.5
Daniel,www.euronews.ro,0,0,1,1,0.0,0.0
Patriarhul Teoctist,www.euronews.ro,0,0,1,1,0.0,0.0
Pitești,www.euronews.ro,0,1,0,1,-1.0,1.0
Mihai I,www.euronews.ro,0,0,1,1,0.0,0.0
Regina Ana,www.euronews.ro,0,0,1,1,0.0,0.0
Smolensk,www.euronews.ro,0,0,1,1,0.0,0.0
amator,www.euronews.ro,0,0,1,1,0.0,0.0
episcop,www.euronews.ro,0,1,0,1,-1.0,1.0
junior,www.euronews.ro,0,0,1,1,0.0,0.0
pelerină,www.euronews.ro,0,0,1,1,0.0,0.0
pelerin,www.euronews.ro,1,0,0,1,1.0,1.0
victimă,www.euronews.ro,1,2,1,4,-0.25,0.25
Șumleu Ciuc,www.euronews.ro,0,0,1,1,0.0,0.0
Șumuleu Ciuc,www.euronews.ro,0,0,1,1,0.0,0.0
Blejnar,a1.ro,0,0,1,1,0.0,0.0
Dinescu,a1.ro,0,0,1,1,0.0,0.0
Mircea Dinescu,a1.ro,0,0,1,1,0.0,0.0
vecin,a1.ro,0,0,1,1,0.0,0.0
Daniel Olteanu,www.mediafax.ro,0,0,1,1,0.0,0.0
invitat,www.mediafax.ro,0,0,1,1,0.0,0.0
producător,www.comisarul.ro,1,0,0,1,1.0,1.0
,www.digi24.ro,0,2,1,3,-0.6666666666666666,0.6666666666666666
Mihai Stepanescu,a1.ro,0,0,1,1,0.0,0.0
Argeș,www.b1tv.ro,0,1,1,2,-0.5,0.5
Constantin Nicolescu,www.b1tv.ro,0,1,0,1,-1.0,1.0
Cătălin Rădulescu,www.b1tv.ro,0,1,0,1,-1.0,1.0
Drăghici,www.b1tv.ro,0,1,0,1,-1.0,1.0
Mircea Drăghici,www.b1tv.ro,0,1,0,1,-1.0,1.0
Pendiuc,www.b1tv.ro,0,1,0,1,-1.0,1.0
Rădulcescu,www.b1tv.ro,0,1,0,1,-1.0,1.0
Rădulescu,www.b1tv.ro,0,1,0,1,-1.0,1.0
Rădulești,www.b1tv.ro,0,1,0,1,-1.0,1.0
Silviu Mănăstire,www.b1tv.ro,0,0,1,1,0.0,0.0
jupân,www.b1tv.ro,0,1,0,1,-1.0,1.0
nebun,www.b1tv.ro,0,1,0,1,-1.0,1.0
protejat,www.b1tv.ro,0,1,0,1,-1.0,1.0
Cornelius,www.aktual24.ro,0,0,1,1,0.0,0.0
Istanbul,www.aktual24.ro,0,0,1,1,0.0,0.0
Ștefan Cornelius,www.aktual24.ro,0,0,1,1,0.0,0.0
Von der Leyen,www.aktual24.ro,0,0,1,1,0.0,0.0
Călărași,www.mediafax.ro,0,0,1,1,0.0,0.0
Vasile Iliuță,www.mediafax.ro,0,0,2,2,0.0,0.0
Barron,www.gandul.ro,0,1,0,1,-1.0,1.0
Biden,www.gandul.ro,0,0,2,2,0.0,0.0
Bornstein,www.gandul.ro,0,1,0,1,-1.0,1.0
Harold Bornstein,www.gandul.ro,0,0,1,1,0.0,0.0
Fulton,www.gandul.ro,0,0,1,1,0.0,0.0
Joe Biden,www.gandul.ro,0,1,2,3,-0.3333333333333333,0.3333333333333333
Schwarzenegger,www.gandul.ro,0,1,0,1,-1.0,1.0
Bruce Aronwald,www.gandul.ro,0,0,2,2,0.0,0.0
Afganistan,recorder.ro,0,0,1,1,0.0,0.0
Generalul Ciucă,recorder.ro,0,0,1,1,0.0,0.0
Irak,recorder.ro,0,0,1,1,0.0,0.0
Nassiriya,recorder.ro,0,0,1,1,0.0,0.0
Nassirya,recorder.ro,0,1,0,1,-1.0,1.0
Radu Dobrițoiu,recorder.ro,0,0,1,1,0.0,0.0
prezidențiabil,recorder.ro,0,1,0,1,-1.0,1.0
Diaconescu,a1.ro,0,0,2,2,0.0,0.0
Lia Olguța Vasilescu,a1.ro,0,0,1,1,0.0,0.0
cadru,a1.ro,0,1,0,1,-1.0,1.0
Gheorghe Dobre,a1.ro,0,0,1,1,0.0,0.0
Pedelistul Gheorghe Flutur,a1.ro,0,0,1,1,0.0,0.0
Tiron,a1.ro,0,0,1,1,0.0,0.0
Anca Boagiu,a1.ro,0,2,1,3,-0.6666666666666666,0.6666666666666666
doritor,www.luju.ro,0,0,1,1,0.0,0.0
Cristi Danilet,www.luju.ro,0,0,1,1,0.0,0.0
procesoman,www.luju.ro,0,1,0,1,-1.0,1.0
victimă,www.luju.ro,1,4,0,5,-0.6,0.6
Cosmin Prelipceanu,adevarul.ro,0,0,3,3,0.0,0.0
Liliana Ruse,adevarul.ro,0,0,2,2,0.0,0.0
Andrei Ciurcanu,snoop.ro,0,0,1,1,0.0,0.0
Arthur,snoop.ro,0,1,0,1,-1.0,1.0
Barna Tánczos,snoop.ro,0,1,2,3,-0.3333333333333333,0.3333333333333333
Berna,snoop.ro,0,0,2,2,0.0,0.0
Mihai Pop,snoop.ro,0,0,5,5,0.0,0.0
Cristina Lapis,snoop.ro,0,0,4,4,0.0,0.0
Cristina Pașca Palmer,snoop.ro,0,0,2,2,0.0,0.0
Estonia,snoop.ro,0,0,1,1,0.0,0.0
Finlanda,snoop.ro,0,0,1,1,0.0,0.0
Grigoraș,snoop.ro,0,0,1,1,0.0,0.0
Kastelic,snoop.ro,0,0,1,1,0.0,0.0
Maša Cerjak Kastelic,snoop.ro,0,0,1,1,0.0,0.0
Mihai Grigoraș,snoop.ro,0,0,3,3,0.0,0.0
Norvegia,snoop.ro,0,0,2,2,0.0,0.0
Ojdula,snoop.ro,0,1,0,1,-1.0,1.0
Ovidiu Ionescu,snoop.ro,0,0,1,1,0.0,0.0
Pașca Palmer,snoop.ro,0,0,1,1,0.0,0.0
Pop,snoop.ro,0,0,1,1,0.0,0.0
Slovenia,snoop.ro,0,0,1,1,0.0,0.0
Suedia,snoop.ro,0,0,1,1,0.0,0.0
Tánczos,snoop.ro,0,1,0,1,-1.0,1.0
vânător,snoop.ro,0,4,5,9,-0.4444444444444444,0.4444444444444444
Zărnești,snoop.ro,0,0,2,2,0.0,0.0
exemplar,snoop.ro,0,0,1,1,0.0,0.0
gestionar,snoop.ro,0,2,0,2,-1.0,1.0
jandarm,snoop.ro,0,2,4,6,-0.3333333333333333,0.3333333333333333
medic veterinar,snoop.ro,0,0,1,1,0.0,0.0
prinț,snoop.ro,0,0,1,1,0.0,0.0
salvamontist,snoop.ro,0,1,0,1,-1.0,1.0
urs,snoop.ro,0,3,3,6,-0.5,0.5
interimar,www.activenews.ro,0,2,0,2,-1.0,1.0
Ardern,www.mediafax.ro,0,0,1,1,0.0,0.0
Doamna Ardern,www.mediafax.ro,0,0,1,1,0.0,0.0
Jacinda Ardern,www.mediafax.ro,0,0,1,1,0.0,0.0
Noua Zeelandă,www.mediafax.ro,0,0,1,1,0.0,0.0
Zeelandă,www.mediafax.ro,0,0,1,1,0.0,0.0
Costică Canacheu,www.digi24.ro,0,1,0,1,-1.0,1.0
Octavian Petric,www.digi24.ro,0,0,2,2,0.0,0.0
Ionel Agrigoroaei,www.digi24.ro,0,1,4,5,-0.2,0.2
Marian Vanghelie,www.digi24.ro,0,2,0,2,-1.0,1.0
Mihăiță Calimente,www.digi24.ro,0,0,2,2,0.0,0.0
Gheorghe Coman,www.digi24.ro,0,1,0,1,-1.0,1.0
instalator,www.digi24.ro,0,0,1,1,0.0,0.0
lăcătuș mecanic,www.digi24.ro,0,1,0,1,-1.0,1.0
patron,www.digi24.ro,0,2,1,3,-0.6666666666666666,0.6666666666666666
Ahile,pressone.ro,0,0,1,1,0.0,0.0
Alin Seserman,pressone.ro,0,0,1,1,0.0,0.0
Andrzej Duda,pressone.ro,0,0,1,1,0.0,0.0
Arsenie Boca,pressone.ro,1,0,0,1,1.0,1.0
Baconschi,pressone.ro,0,1,0,1,-1.0,1.0
Belgrad,pressone.ro,0,1,1,2,-0.5,0.5
Bănescu,pressone.ro,0,1,0,1,-1.0,1.0
Cernăuți,pressone.ro,0,1,0,1,-1.0,1.0
Cioran,pressone.ro,0,0,1,1,0.0,0.0
Constantin Noica,pressone.ro,1,0,1,2,0.5,0.5
Corneliu Coposu,pressone.ro,0,0,2,2,0.0,0.0
Deveselu,pressone.ro,0,0,2,2,0.0,0.0
Elenă,pressone.ro,0,1,0,1,-1.0,1.0
Emil Cioran,pressone.ro,0,0,1,1,0.0,0.0
Florida,pressone.ro,0,0,1,1,0.0,0.0
Gabriel Liiceanu,pressone.ro,0,2,1,3,-0.6666666666666666,0.6666666666666666
Gaddafi,pressone.ro,0,1,0,1,-1.0,1.0
Gigi Becali,pressone.ro,0,0,1,1,0.0,0.0
Gorbaciov,pressone.ro,0,0,1,1,0.0,0.0
Ionatan,pressone.ro,0,0,1,1,0.0,0.0
JD Vance,pressone.ro,0,1,0,1,-1.0,1.0
Laconi,pressone.ro,0,1,0,1,-1.0,1.0
Libia,pressone.ro,0,1,0,1,-1.0,1.0
Lindsey Graham,pressone.ro,0,0,2,2,0.0,0.0
Luxemburg,pressone.ro,0,1,1,2,-0.5,0.5
Mihail Neamțu,pressone.ro,0,2,1,3,-0.6666666666666666,0.6666666666666666
Mircea Eliade,pressone.ro,0,1,1,2,-0.5,0.5
Mârșa,pressone.ro,0,1,0,1,-1.0,1.0
Nae Ionescu,pressone.ro,0,1,0,1,-1.0,1.0
Neamțu,pressone.ro,0,2,0,2,-1.0,1.0
Nicolae Bordașiu,pressone.ro,1,0,0,1,1.0,1.0
Patrocle,pressone.ro,0,0,1,1,0.0,0.0
Petre Țuțea,pressone.ro,0,1,0,1,-1.0,1.0
Robert Kennedy Jr,pressone.ro,0,0,1,1,0.0,0.0
Răzvan Sibii,pressone.ro,0,0,1,1,0.0,0.0
URSS,pressone.ro,0,1,0,1,-1.0,1.0
administrație,pressone.ro,0,1,0,1,-1.0,1.0
apolog,pressone.ro,0,1,0,1,-1.0,1.0
bihorenilor,pressone.ro,0,1,0,1,-1.0,1.0
combatant,pressone.ro,0,0,1,1,0.0,0.0
conațional,pressone.ro,0,1,0,1,-1.0,1.0
congresman,pressone.ro,0,1,0,1,-1.0,1.0
cunoscător,pressone.ro,0,1,0,1,-1.0,1.0
dlui Georgescu,pressone.ro,0,0,1,1,0.0,0.0
Anna Politkovskaia,pressone.ro,0,1,0,1,-1.0,1.0
Arlette Coposu,pressone.ro,1,0,0,1,1.0,1.0
Papahagi,pressone.ro,0,1,0,1,-1.0,1.0
Liiceanu,pressone.ro,0,1,0,1,-1.0,1.0
domnului Liiceanu,pressone.ro,0,1,0,1,-1.0,1.0
geniu,pressone.ro,1,0,0,1,1.0,1.0
lacheu,pressone.ro,0,1,0,1,-1.0,1.0
mamelă,pressone.ro,1,0,2,3,0.3333333333333333,0.3333333333333333
marinar,pressone.ro,0,1,0,1,-1.0,1.0
mujahed,pressone.ro,0,0,1,1,0.0,0.0
omorâtor,pressone.ro,0,1,0,1,-1.0,1.0
neomarxist,pressone.ro,0,1,0,1,-1.0,1.0
odraslet,pressone.ro,0,1,0,1,-1.0,1.0
Dominic Fritz,www.euronews.ro,0,0,1,1,0.0,0.0
semnatar,www.euronews.ro,0,0,1,1,0.0,0.0
Florentin Pandele,www.mediafax.ro,0,1,0,1,-1.0,1.0
Marius Budăi,www.mediafax.ro,0,0,1,1,0.0,0.0
Romașcanu,www.mediafax.ro,0,0,1,1,0.0,0.0
voluntar,www.mediafax.ro,0,1,0,1,-1.0,1.0
bătrân,www.mediafax.ro,0,2,1,3,-0.6666666666666666,0.6666666666666666
director general,www.mediafax.ro,0,1,0,1,-1.0,1.0
vârstnic,www.mediafax.ro,0,1,0,1,-1.0,1.0
Amandoi,adevarul.ro,0,0,1,1,0.0,0.0
Aurel Pricu,adevarul.ro,1,0,0,1,1.0,1.0
Buchet,adevarul.ro,0,1,0,1,-1.0,1.0
Constantin Buchet,adevarul.ro,0,0,1,1,0.0,0.0
Corneliu Vadim Tudor,adevarul.ro,0,0,1,1,0.0,0.0
Daniela Buruiană,adevarul.ro,0,0,1,1,0.0,0.0
Florian Chiritescu,adevarul.ro,1,0,0,1,1.0,1.0
Gheorghe,adevarul.ro,0,0,1,1,0.0,0.0
Gheorghe Onisoru,adevarul.ro,1,0,1,2,0.5,0.5
Mihai Gheorghe,adevarul.ro,1,0,1,2,0.5,0.5
Onisoru,adevarul.ro,0,0,1,1,0.0,0.0
Patapievici,adevarul.ro,0,1,0,1,-1.0,1.0
Plesu,adevarul.ro,0,1,0,1,-1.0,1.0
Viorel Nicolescu,adevarul.ro,1,0,0,1,1.0,1.0
peremist,adevarul.ro,0,1,0,1,-1.0,1.0
Ungarie,www.realitatea.net,0,1,0,1,-1.0,1.0
deștept,www.realitatea.net,0,1,0,1,-1.0,1.0
Gheorghe Călin,pressone.ro,0,0,2,2,0.0,0.0
Secretar General,pressone.ro,0,0,1,1,0.0,0.0
aspirant,pressone.ro,0,0,2,2,0.0,0.0
vedet,pressone.ro,0,1,0,1,-1.0,1.0
independent,primanews.ro,0,0,2,2,0.0,0.0
prezidențiabil,primanews.ro,0,0,1,1,0.0,0.0
Cristian Pirvulescu,www.aktual24.ro,0,0,2,2,0.0,0.0
Mihai Razvan Ungureanu,www.aktual24.ro,0,0,1,1,0.0,0.0
Mugur Isărescu,www.aktual24.ro,0,0,1,1,0.0,0.0
Alexandru Gîdiuță,www.g4media.ro,0,0,2,2,0.0,0.0
Apjok Norbert,www.g4media.ro,0,0,2,2,0.0,0.0
Florică Ică Calotă,www.g4media.ro,0,0,2,2,0.0,0.0
Gheba Daniel Sorin,www.g4media.ro,0,0,2,2,0.0,0.0
Gheorghe Pecingină,www.g4media.ro,0,0,2,2,0.0,0.0
Gâdiuță,www.g4media.ro,0,2,0,2,-1.0,1.0
Iulian Nămoloșanu,www.g4media.ro,0,0,2,2,0.0,0.0
Lazăr Ion Marian,www.g4media.ro,0,0,2,2,0.0,0.0
Liviu Ioan Balint,www.g4media.ro,0,0,2,2,0.0,0.0
Paul Cristian Ichim,www.g4media.ro,0,0,2,2,0.0,0.0
politică,www.g4media.ro,0,2,0,2,-1.0,1.0
Radu Ciornei,www.g4media.ro,0,0,3,3,0.0,0.0
Toda Daniel Liviu,www.g4media.ro,0,0,2,2,0.0,0.0
juriști,www.g4media.ro,0,0,2,2,0.0,0.0
Alexandru Gâdiuță,www.g4media.ro,0,0,2,2,0.0,0.0
erou militar,www.b1tv.ro,1,0,0,1,1.0,1.0
rezervist,www.b1tv.ro,0,1,0,1,-1.0,1.0
urmaș,www.b1tv.ro,1,0,0,1,1.0,1.0
Bayrou,primanews.ro,0,0,1,1,0.0,0.0
Cinca Republicii,primanews.ro,0,0,1,1,0.0,0.0
Francois Bayrou,primanews.ro,0,0,1,1,0.0,0.0
Jordan Bardella,primanews.ro,0,1,0,1,-1.0,1.0
Manuel Bompard,primanews.ro,0,1,0,1,-1.0,1.0
Mathilde Panot,primanews.ro,0,0,1,1,0.0,0.0
apropiat,primanews.ro,1,0,1,2,0.5,0.5
coordonator,primanews.ro,0,1,0,1,-1.0,1.0
succesor,primanews.ro,0,0,1,1,0.0,0.0
Alexandru Rafila,www.g4media.ro,0,1,1,2,-0.5,0.5
Angel Tîlvăr,www.g4media.ro,0,0,1,1,0.0,0.0
colegiu,www.g4media.ro,0,1,0,1,-1.0,1.0
Florin Barbu,www.g4media.ro,0,0,2,2,0.0,0.0
Mircea Fechet,www.g4media.ro,0,0,1,1,0.0,0.0
Mircia Chelaru,www.g4media.ro,0,0,2,2,0.0,0.0
Natalia Intotero,www.g4media.ro,0,0,1,1,0.0,0.0
Radu Marinescu,www.g4media.ro,0,0,1,1,0.0,0.0
Sebastian Burduja,www.g4media.ro,0,0,1,1,0.0,0.0
Tánczos Barna,www.g4media.ro,0,0,1,1,0.0,0.0
Varujan Pambuccian,www.g4media.ro,0,0,1,1,0.0,0.0
magistrat,www.g4media.ro,0,3,1,4,-0.75,0.75
Irlanda,recorder.ro,0,0,1,1,0.0,0.0
Norvegia,recorder.ro,0,0,1,1,0.0,0.0
Răzvan Băltărețu,recorder.ro,0,1,0,1,-1.0,1.0
ucigaș,recorder.ro,0,1,0,1,-1.0,1.0
violator,recorder.ro,0,2,0,2,-1.0,1.0
Moșteanu,www.news.ro,0,0,5,5,0.0,0.0
participant,www.news.ro,0,0,4,4,0.0,0.0
Statele Unite ale Americii,www.romaniatv.net,0,0,2,2,0.0,0.0
Răzvan Dumitrescu,www.romaniatv.net,0,0,1,1,0.0,0.0
mânat,www.gandul.ro,0,0,1,1,0.0,0.0
ar,www.gandul.ro,0,1,0,1,-1.0,1.0
nominalizat,www.gandul.ro,0,0,1,1,0.0,0.0
Bogdan Tiberiu Iacob,www.realitatea.net,0,0,1,1,0.0,0.0
Paris,www.realitatea.net,0,0,4,4,0.0,0.0
nepot,www.realitatea.net,1,2,0,3,-0.3333333333333333,0.3333333333333333
provocator,www.realitatea.net,0,1,0,1,-1.0,1.0
agent,snoop.ro,0,4,2,6,-0.6666666666666666,0.6666666666666666
Arefu,snoop.ro,0,1,0,1,-1.0,1.0
Cristian Papp,snoop.ro,0,0,2,2,0.0,0.0
Curtea de Argeș,snoop.ro,0,0,1,1,0.0,0.0
Fechet,snoop.ro,0,0,2,2,0.0,0.0
Gheorghe Stoican,snoop.ro,0,1,0,1,-1.0,1.0
Laszlo Gal,snoop.ro,0,0,1,1,0.0,0.0
Ministrul Fechet,snoop.ro,0,0,1,1,0.0,0.0
Papp,snoop.ro,0,0,1,1,0.0,0.0
Ranger,snoop.ro,1,0,0,1,1.0,1.0
Ursul,snoop.ro,0,0,1,1,0.0,0.0
urș,snoop.ro,0,0,1,1,0.0,0.0
animal,snoop.ro,0,1,0,1,-1.0,1.0
biolog,snoop.ro,0,0,1,1,0.0,0.0
eu,snoop.ro,0,2,0,2,-1.0,1.0
lector,snoop.ro,0,0,1,1,0.0,0.0
om de știință,snoop.ro,0,0,1,1,0.0,0.0
protagonist,snoop.ro,0,1,0,1,-1.0,1.0
ursoaică,snoop.ro,0,0,1,1,0.0,0.0
Fritz,www.b1tv.ro,0,1,0,1,-1.0,1.0
Timișoara,www.b1tv.ro,0,0,4,4,0.0,0.0
prieteni,www.b1tv.ro,1,0,2,3,0.3333333333333333,0.3333333333333333
Bill Clinton,observatornews.ro,0,0,1,1,0.0,0.0
George W. Bush,observatornews.ro,0,0,1,1,0.0,0.0
Mario Draghi,observatornews.ro,0,0,1,1,0.0,0.0
Mike Johnson,observatornews.ro,0,0,1,1,0.0,0.0
Tony Blair,observatornews.ro,0,0,1,1,0.0,0.0
pompier,www.euronews.ro,1,0,3,4,0.25,0.25
suspect,www.euronews.ro,0,2,0,2,-1.0,1.0
vizitator,www.euronews.ro,0,0,1,1,0.0,0.0
Dragoș Calin,www.luju.ro,0,0,1,1,0.0,0.0
Menini,www.luju.ro,0,0,1,1,0.0,0.0
Rampanelli,www.luju.ro,0,0,1,1,0.0,0.0
consumator,www.luju.ro,0,0,4,4,0.0,0.0
Constantin Toma,www.euronews.ro,0,0,2,2,0.0,0.0
Andrii Kovalenko,adevarul.ro,0,0,1,1,0.0,0.0
Kobzar,adevarul.ro,0,0,1,1,0.0,0.0
Kovalenko,adevarul.ro,0,0,1,1,0.0,0.0
rănit,adevarul.ro,0,1,0,1,-1.0,1.0
Balotesti,a1.ro,0,0,1,1,0.0,0.0
Liviu Negoita,a1.ro,0,0,2,2,0.0,0.0
Negoita,a1.ro,0,1,0,1,-1.0,1.0
Eckhard Cordes,stirileprotv.ro,0,0,2,2,0.0,0.0
Merkel,stirileprotv.ro,1,0,0,1,1.0,1.0
Radu Meric,stirileprotv.ro,0,0,1,1,0.0,0.0
Dan Sova,stirileprotv.ro,0,0,1,1,0.0,0.0
Brian Brown,www.comisarul.ro,0,1,2,3,-0.3333333333333333,0.3333333333333333
Brown,www.comisarul.ro,0,1,1,2,-0.5,0.5
Ciordescu,www.digi24.ro,0,1,0,1,-1.0,1.0
Dorel,www.digi24.ro,0,0,1,1,0.0,0.0
Dărăști,www.digi24.ro,0,0,1,1,0.0,0.0
reporter,www.digi24.ro,0,0,4,4,0.0,0.0
matale,www.digi24.ro,0,1,0,1,-1.0,1.0
păsărar,www.digi24.ro,0,0,1,1,0.0,0.0
sticleț,www.digi24.ro,0,1,0,1,-1.0,1.0
Andrii Sybiha,www.mediafax.ro,0,0,1,1,0.0,0.0
Israel,www.mediafax.ro,0,0,4,4,0.0,0.0
Luxemburg,www.mediafax.ro,0,0,1,1,0.0,0.0
Moscova,www.mediafax.ro,0,1,2,3,-0.3333333333333333,0.3333333333333333
Serbia,www.mediafax.ro,0,0,3,3,0.0,0.0
Slovacia,www.mediafax.ro,0,0,1,1,0.0,0.0
omolog,www.mediafax.ro,0,0,1,1,0.0,0.0
Florin Roman,stirileprotv.ro,0,0,1,1,0.0,0.0
Nicoale Ciucă,stirileprotv.ro,0,0,1,1,0.0,0.0
voluntar,www.euronews.ro,1,0,0,1,1.0,1.0
Miriță,www.g4media.ro,0,1,0,1,-1.0,1.0
Miruță,www.g4media.ro,0,0,1,1,0.0,0.0
Radu Miruță,www.g4media.ro,0,0,1,1,0.0,0.0
programator,www.g4media.ro,0,0,1,1,0.0,0.0
Pricopie,www.antena3.ro,0,0,1,1,0.0,0.0
Rector,www.antena3.ro,0,1,1,2,-0.5,0.5
amator,www.antena3.ro,0,1,0,1,-1.0,1.0
Auckland,www.euronews.ro,0,0,1,1,0.0,0.0
Carmen,www.euronews.ro,0,0,1,1,0.0,0.0
Corbi,www.euronews.ro,0,0,1,1,0.0,0.0
Predoiu,www.euronews.ro,0,0,2,2,0.0,0.0
bunică,www.euronews.ro,0,1,0,1,-1.0,1.0
fermier,www.euronews.ro,1,0,0,1,1.0,1.0
părinte,www.euronews.ro,0,2,1,3,-0.6666666666666666,0.6666666666666666
Vlad Gheorghe,www.b1tv.ro,0,2,2,4,-0.5,0.5
Steven Seagal,www.b1tv.ro,0,0,1,1,0.0,0.0
Aurelian Pavelescu,www.realitatea.net,0,0,1,1,0.0,0.0
Ramona Strugariu,www.realitatea.net,0,0,1,1,0.0,0.0
Cîțu,www.mediafax.ro,0,0,1,1,0.0,0.0
Octavian Marius Popa,www.antena3.ro,0,0,2,2,0.0,0.0
Popa,www.antena3.ro,0,0,1,1,0.0,0.0
deținut,www.antena3.ro,0,1,0,1,-1.0,1.0
prieteni,www.antena3.ro,2,1,4,7,0.14285714285714285,0.14285714285714285
securist,www.antena3.ro,0,2,0,2,-1.0,1.0
Ștefan,www.antena3.ro,0,0,2,2,0.0,0.0
Ștefan Costache,www.antena3.ro,0,0,2,2,0.0,0.0
Ivan,www.cotidianul.ro,0,0,1,1,0.0,0.0
Ruxandra Ivan,www.cotidianul.ro,0,0,1,1,0.0,0.0
Soacra,www.cotidianul.ro,0,1,0,1,-1.0,1.0
Victoria Stoiciu,www.cotidianul.ro,0,0,1,1,0.0,0.0
victorie,www.cotidianul.ro,0,0,1,1,0.0,0.0
Victoriei Stoiciu,www.cotidianul.ro,0,0,1,1,0.0,0.0
Antonia Niță,agerpres.ro,0,0,6,6,0.0,0.0
Oana Ghiță,agerpres.ro,0,0,3,3,0.0,0.0
Bacău,www.digi24.ro,0,0,2,2,0.0,0.0
Benke Károly,www.cotidianul.ro,0,0,1,1,0.0,0.0
Dungaciu,www.cotidianul.ro,0,0,1,1,0.0,0.0
Macron,www.cotidianul.ro,0,4,1,5,-0.8,0.8
Maia Sandu,www.cotidianul.ro,0,0,1,1,0.0,0.0
Napoleon,www.cotidianul.ro,0,1,0,1,-1.0,1.0
Ursulei,www.cotidianul.ro,0,1,0,1,-1.0,1.0
activist,www.cotidianul.ro,0,0,1,1,0.0,0.0
admirator,www.cotidianul.ro,0,1,2,3,-0.3333333333333333,0.3333333333333333
cei,www.cotidianul.ro,0,1,0,1,-1.0,1.0
donator,www.cotidianul.ro,0,1,0,1,-1.0,1.0
Vlad Gheorghe,www.cotidianul.ro,0,0,1,1,0.0,0.0
legionar,www.cotidianul.ro,0,1,0,1,-1.0,1.0
mască,www.cotidianul.ro,0,1,0,1,-1.0,1.0
masel,www.cotidianul.ro,0,1,0,1,-1.0,1.0
Ben Oni Ardelean,www.cotidianul.ro,0,0,1,1,0.0,0.0
profesor,www.cotidianul.ro,0,0,1,1,0.0,0.0
păcătos,www.cotidianul.ro,0,1,0,1,-1.0,1.0
trădător,www.cotidianul.ro,0,3,0,3,-1.0,1.0
Alexandra,recorder.ro,0,1,0,1,-1.0,1.0
Alexandra Bogaciu,recorder.ro,0,0,1,1,0.0,0.0
Alexandru Bogaciu,recorder.ro,0,1,0,1,-1.0,1.0
Bogaciu,recorder.ro,0,0,1,1,0.0,0.0
Florentin Pandele,recorder.ro,0,0,2,2,0.0,0.0
Ion Bogaciu,recorder.ro,0,0,1,1,0.0,0.0
bagaboantă,recorder.ro,0,1,0,1,-1.0,1.0
nevastă,recorder.ro,1,0,1,2,0.5,0.5
văr,recorder.ro,0,0,1,1,0.0,0.0
Belgrad,www.news.ro,0,0,2,2,0.0,0.0
Kiev,www.news.ro,0,0,1,1,0.0,0.0
cei,www.news.ro,0,0,2,2,0.0,0.0
Kovesi,www.news.ro,0,1,0,1,-1.0,1.0
Oprea,www.news.ro,0,1,2,3,-0.3333333333333333,0.3333333333333333
luptătoare,www.news.ro,1,0,0,1,1.0,1.0
motociclist,www.news.ro,0,1,0,1,-1.0,1.0
Iohannis,www.news.ro,0,1,0,1,-1.0,1.0
Gustavo Petro,primanews.ro,0,0,1,1,0.0,0.0
José Mujica,primanews.ro,0,0,1,1,0.0,0.0
Lula da Silva,primanews.ro,0,0,1,1,0.0,0.0
Montevideo,primanews.ro,0,0,1,1,0.0,0.0
Mujica,primanews.ro,1,0,0,1,1.0,1.0
Orsi,primanews.ro,0,0,1,1,0.0,0.0
Uruguay,primanews.ro,0,0,2,2,0.0,0.0
Yamandu Orsi,primanews.ro,0,0,1,1,0.0,0.0
concetățean,primanews.ro,1,0,0,1,1.0,1.0
luptător,primanews.ro,0,0,1,1,0.0,0.0
Berceanu,observatornews.ro,0,0,1,1,0.0,0.0
Iulian Bulai,observatornews.ro,0,0,1,1,0.0,0.0
Octavian Berceanu,observatornews.ro,0,0,1,1,0.0,0.0
Sinaia,observatornews.ro,0,0,1,1,0.0,0.0
Daniel Badea,agerpres.ro,0,0,1,1,0.0,0.0
Mariana Nica,agerpres.ro,0,0,3,3,0.0,0.0
băiat,agerpres.ro,0,1,0,1,-1.0,1.0
producător,agerpres.ro,0,0,2,2,0.0,0.0
Administrația Trump,www.luju.ro,0,2,0,2,-1.0,1.0
Federația Rusă,www.luju.ro,0,1,0,1,-1.0,1.0
Iran,www.luju.ro,0,0,1,1,0.0,0.0
Vladimir Putin,www.luju.ro,0,1,0,1,-1.0,1.0
Volodimir Zelenskiy,www.luju.ro,1,0,0,1,1.0,1.0
analișt,www.luju.ro,0,0,1,1,0.0,0.0
criminal,www.luju.ro,0,1,0,1,-1.0,1.0
dușman,www.luju.ro,0,1,0,1,-1.0,1.0
omenire,www.luju.ro,0,1,0,1,-1.0,1.0
Andrzej Domanski,www.mediafax.ro,0,0,1,1,0.0,0.0
Belgia,www.mediafax.ro,0,0,1,1,0.0,0.0
Canada,www.mediafax.ro,1,0,0,1,1.0,1.0
Germania,www.mediafax.ro,0,0,3,3,0.0,0.0
Norvegia,www.mediafax.ro,1,0,0,1,1.0,1.0
Domanski,www.mediafax.ro,1,0,0,1,1.0,1.0
Belarus,stirileprotv.ro,0,0,1,1,0.0,0.0
Ylva Johansson,stirileprotv.ro,1,0,0,1,1.0,1.0
Luis Lazarus,stirileprotv.ro,0,0,1,1,0.0,0.0
Nicu Ștefănuță,stirileprotv.ro,0,0,2,2,0.0,0.0
Siegfried Mureșan,stirileprotv.ro,1,0,2,3,0.3333333333333333,0.3333333333333333
negociator șef,stirileprotv.ro,0,0,1,1,0.0,0.0
nominalizat,stirileprotv.ro,0,0,1,1,0.0,0.0
șef de stat,www.realitatea.net,0,1,2,3,-0.3333333333333333,0.3333333333333333
Ambii,snoop.ro,0,0,1,1,0.0,0.0
Andronic,snoop.ro,0,0,1,1,0.0,0.0
Andy,snoop.ro,0,0,1,1,0.0,0.0
Andy Constantin Lupu,snoop.ro,0,0,1,1,0.0,0.0
Andy Lupu,snoop.ro,0,0,2,2,0.0,0.0
Boancă,snoop.ro,0,0,1,1,0.0,0.0
Bălți,snoop.ro,0,1,0,1,-1.0,1.0
Constantin Lupu,snoop.ro,0,0,2,2,0.0,0.0
Cosmin Marian Matache,snoop.ro,0,0,1,1,0.0,0.0
Cristian David,snoop.ro,0,0,1,1,0.0,0.0
Durleșteanu,snoop.ro,0,0,1,1,0.0,0.0
Igor Dodon,snoop.ro,0,1,0,1,-1.0,1.0
Ilan Șor,snoop.ro,0,1,0,1,-1.0,1.0
Izvorani,snoop.ro,0,0,1,1,0.0,0.0
Kennedy,snoop.ro,0,1,0,1,-1.0,1.0
Lupu,snoop.ro,0,0,3,3,0.0,0.0
Mariana Durleșteanu,snoop.ro,0,0,1,1,0.0,0.0
Nicolae Andronic,snoop.ro,0,0,1,1,0.0,0.0
Renato Usatîi,snoop.ro,0,1,0,1,-1.0,1.0
Rodica Boancă,snoop.ro,0,0,1,1,0.0,0.0
Roșca,snoop.ro,0,2,0,2,-1.0,1.0
Valeriu Cerba,snoop.ro,0,0,1,1,0.0,0.0
Vaslui,snoop.ro,0,0,4,4,0.0,0.0
abonat,snoop.ro,0,0,2,2,0.0,0.0
ambasadoare,snoop.ro,0,0,1,1,0.0,0.0
criminal,snoop.ro,0,1,0,1,-1.0,1.0
descendent,snoop.ro,0,0,1,1,0.0,0.0
prorector,snoop.ro,0,0,1,1,0.0,0.0
raportor,snoop.ro,0,0,1,1,0.0,0.0
Corneliu Tudor,www.g4media.ro,0,0,2,2,0.0,0.0
Viorica Dăncilă,www.g4media.ro,0,0,2,2,0.0,0.0
ministrul Boloș,agerpres.ro,0,0,1,1,0.0,0.0
politică,agerpres.ro,0,1,0,1,-1.0,1.0
Belgia,www.aktual24.ro,0,0,2,2,0.0,0.0
Piatra Neamț,www.aktual24.ro,0,0,1,1,0.0,0.0
Țările de Jos,www.aktual24.ro,0,0,1,1,0.0,0.0
Beijingul,adevarul.ro,0,0,1,1,0.0,0.0
Europa,adevarul.ro,1,0,0,1,1.0,1.0
Jean Monnet,adevarul.ro,1,0,0,1,1.0,1.0
Jonas Gahr Støre,adevarul.ro,0,0,1,1,0.0,0.0
ambasadoare,adevarul.ro,0,0,1,1,0.0,0.0
Matei,adevarul.ro,0,0,1,1,0.0,0.0
Ivan,adevarul.ro,0,0,1,1,0.0,0.0
Berdin,www.euronews.ro,0,0,1,1,0.0,0.0
Kursk,www.euronews.ro,0,1,0,1,-1.0,1.0
muncitor,www.euronews.ro,0,0,2,2,0.0,0.0
curier,www.euronews.ro,0,0,1,1,0.0,0.0
Sorin Faur,www.activenews.ro,0,0,1,1,0.0,0.0
milog,www.activenews.ro,0,1,0,1,-1.0,1.0
neicusor,www.activenews.ro,0,1,0,1,-1.0,1.0
pesediști,www.activenews.ro,0,1,0,1,-1.0,1.0
pescar,www.activenews.ro,0,1,0,1,-1.0,1.0
Adina Vălean,www.news.ro,0,0,4,4,0.0,0.0
Belgia,www.news.ro,0,0,2,2,0.0,0.0
comisar,www.news.ro,1,0,2,3,0.3333333333333333,0.3333333333333333
Dolj,www.gandul.ro,0,0,2,2,0.0,0.0
Liei Olguța Vasilescu,www.gandul.ro,0,0,1,1,0.0,0.0
redactor,www.gandul.ro,0,0,2,2,0.0,0.0
redactor șef,www.gandul.ro,0,0,1,1,0.0,0.0
Bihor,www.antena3.ro,0,0,1,1,0.0,0.0
California,www.antena3.ro,0,0,1,1,0.0,0.0
Carmen,www.antena3.ro,0,0,1,1,0.0,0.0
Carmen Ramona Terheș,www.antena3.ro,0,0,1,1,0.0,0.0
Sălaj,www.antena3.ro,0,0,1,1,0.0,0.0
Terheș,www.antena3.ro,0,0,1,1,0.0,0.0
administrator,www.antena3.ro,0,0,2,2,0.0,0.0
Dan Voiculescu,adevarul.ro,0,1,4,5,-0.2,0.2
Darius Vâlcov,adevarul.ro,0,1,0,1,-1.0,1.0
Chișinău,www.cotidianul.ro,0,1,0,1,-1.0,1.0
Marius Ostaficiuc,www.cotidianul.ro,0,0,2,2,0.0,0.0
Tudor Ciuhodaru,www.cotidianul.ro,0,0,2,2,0.0,0.0
Cynthia Păun,www.cotidianul.ro,0,0,1,1,0.0,0.0
Irineu Darău,www.cotidianul.ro,1,0,0,1,1.0,1.0
Marius Humelnicu,www.cotidianul.ro,0,0,1,1,0.0,0.0
guvernator,www.cotidianul.ro,0,1,2,3,-0.3333333333333333,0.3333333333333333
Ștefan Pălărie,www.cotidianul.ro,0,0,1,1,0.0,0.0
Goțiu,pressone.ro,0,0,1,1,0.0,0.0
Lavinia Abu Amra,pressone.ro,0,0,1,1,0.0,0.0
Lucian Romașcanu,pressone.ro,1,0,3,4,0.25,0.25
Romașcanu,pressone.ro,0,1,1,2,-0.5,0.5
Roșia Montană,pressone.ro,0,5,0,5,-1.0,1.0
amica,pressone.ro,0,1,0,1,-1.0,1.0
bunic,pressone.ro,4,2,3,9,0.2222222222222222,0.2222222222222222
câțivă,pressone.ro,1,0,0,1,1.0,1.0
Mihai Funeriu,pressone.ro,0,1,0,1,-1.0,1.0
Alexandrescu,pressone.ro,0,0,2,2,0.0,0.0
donator,pressone.ro,0,1,0,1,-1.0,1.0
Pavel Năstase,pressone.ro,0,0,1,1,0.0,0.0
Brad Parscale,adevarul.ro,0,0,1,1,0.0,0.0
Bratislava,adevarul.ro,0,0,1,1,0.0,0.0
Cehia,adevarul.ro,0,0,2,2,0.0,0.0
Donald Trump Jr,adevarul.ro,0,0,2,2,0.0,0.0
Donald Trump Jr.,adevarul.ro,0,0,2,2,0.0,0.0
Parscale,adevarul.ro,0,0,1,1,0.0,0.0
Praga,adevarul.ro,0,0,2,2,0.0,0.0
Lulea,www.euronews.ro,0,1,1,2,-0.5,0.5
Marius Lulea,www.euronews.ro,0,0,2,2,0.0,0.0
Gabriel Leș,www.mediafax.ro,0,0,1,1,0.0,0.0
Lia Olguța Vasilescu,www.mediafax.ro,0,0,1,1,0.0,0.0
Mircea Drăghici,www.mediafax.ro,0,0,1,1,0.0,0.0
locțiitor,www.mediafax.ro,0,0,1,1,0.0,0.0
George Tuță,www.euronews.ro,0,0,1,1,0.0,0.0
Dan Puric,www.digi24.ro,0,0,1,1,0.0,0.0
Doritor,www.digi24.ro,0,0,1,1,0.0,0.0
Marian Munteanu,www.digi24.ro,0,0,1,1,0.0,0.0
Munteanu,www.digi24.ro,0,0,1,1,0.0,0.0
Neptun,www.digi24.ro,0,0,2,2,0.0,0.0
Sorin Constantinescu,www.digi24.ro,0,0,1,1,0.0,0.0
cretin,www.digi24.ro,0,1,0,1,-1.0,1.0
cursant,www.digi24.ro,0,0,2,2,0.0,0.0
hacker,www.digi24.ro,0,1,0,1,-1.0,1.0
lector,www.digi24.ro,0,0,1,1,0.0,0.0
ocupant,www.digi24.ro,0,0,2,2,0.0,0.0
Focșani,stirileprotv.ro,0,0,1,1,0.0,0.0
dezertor,stirileprotv.ro,0,1,0,1,-1.0,1.0
om de știință,primanews.ro,2,0,0,2,1.0,1.0
Uliana Dmitrieva,primanews.ro,0,0,1,1,0.0,0.0
cercetător,primanews.ro,1,0,0,1,1.0,1.0
Daniel Ghiță,www.antena3.ro,0,1,0,1,-1.0,1.0
Tanczos Barna,www.antena3.ro,0,1,1,2,-0.5,0.5
secretar de stat,www.antena3.ro,0,1,2,3,-0.3333333333333333,0.3333333333333333
Nelu Tătaru,www.euronews.ro,0,1,2,3,-0.3333333333333333,0.3333333333333333
Tătaru,www.euronews.ro,0,1,1,2,-0.5,0.5
cunoștință,www.euronews.ro,0,0,1,1,0.0,0.0
Alin Mituța,www.euronews.ro,0,0,1,1,0.0,0.0
Dan Barna,www.euronews.ro,0,0,2,2,0.0,0.0
Dragoș Tudorache,www.euronews.ro,0,0,1,1,0.0,0.0
Ramona Strugariu,www.euronews.ro,0,0,1,1,0.0,0.0
Timișoara,agerpres.ro,1,0,1,2,0.5,0.5
Alfred Simonis,www.aktual24.ro,0,1,1,2,-0.5,0.5
Ardealul,www.aktual24.ro,0,0,1,1,0.0,0.0
Braila,www.aktual24.ro,0,0,1,1,0.0,0.0
Constantin Radulescu,www.aktual24.ro,0,0,1,1,0.0,0.0
Corneliu Stefan,www.aktual24.ro,0,0,1,1,0.0,0.0
Galati,www.aktual24.ro,0,0,1,1,0.0,0.0
Ionuț Pucheanu,www.aktual24.ro,0,0,1,1,0.0,0.0
Ivan,www.aktual24.ro,0,0,2,2,0.0,0.0
Radu Moldovan,www.aktual24.ro,0,0,1,1,0.0,0.0
alt,www.aktual24.ro,0,0,1,1,0.0,0.0
Cătălin Carstoiu,www.aktual24.ro,0,0,1,1,0.0,0.0
Alina Gorghiu,www.romaniatv.net,0,0,1,1,0.0,0.0
Gorghiu,www.romaniatv.net,0,0,2,2,0.0,0.0
Parlmanet,www.romaniatv.net,0,1,0,1,-1.0,1.0
Vlad Pascu,www.romaniatv.net,0,1,0,1,-1.0,1.0
agent rutier,www.romaniatv.net,0,1,0,1,-1.0,1.0
drog,www.romaniatv.net,0,1,0,1,-1.0,1.0
generație,www.romaniatv.net,1,0,0,1,1.0,1.0
traficant,www.romaniatv.net,0,3,0,3,-1.0,1.0
Adrian George Axinia,www.g4media.ro,0,0,1,1,0.0,0.0
Alina Simona,www.g4media.ro,0,0,1,1,0.0,0.0
Andrei Romică Ohaci,www.g4media.ro,0,0,1,1,0.0,0.0
Antonio Andrușceac,www.g4media.ro,0,1,1,2,-0.5,0.5
Botoșani,www.g4media.ro,0,0,1,1,0.0,0.0
Carol Cristina,www.g4media.ro,0,1,0,1,-1.0,1.0
Cezar Victor Năstase,www.g4media.ro,0,0,1,1,0.0,0.0
Cristan Ghinea,www.g4media.ro,0,0,1,1,0.0,0.0
Cristina Carol Gomboș,www.g4media.ro,0,0,1,1,0.0,0.0
Călin Mătieș,www.g4media.ro,0,1,1,2,-0.5,0.5
Dan Tanasă,www.g4media.ro,0,0,2,2,0.0,0.0
Diana,www.g4media.ro,0,1,0,1,-1.0,1.0
Diana Enache,www.g4media.ro,0,0,1,1,0.0,0.0
Dragomirești,www.g4media.ro,0,0,1,1,0.0,0.0
Dragoș Vlădulescu,www.g4media.ro,0,0,1,1,0.0,0.0
Dumitru Spătaru,www.g4media.ro,0,0,1,1,0.0,0.0
Dănuț,www.g4media.ro,0,0,1,1,0.0,0.0
Enache,www.g4media.ro,0,1,0,1,-1.0,1.0
Evdochia Aelenei,www.g4media.ro,0,0,1,1,0.0,0.0
Finii,www.g4media.ro,0,1,0,1,-1.0,1.0
George Cezar Petre,www.g4media.ro,0,0,1,1,0.0,0.0
Georgel Badiu,www.g4media.ro,0,0,1,1,0.0,0.0
Gomboș,www.g4media.ro,0,1,0,1,-1.0,1.0
Gura Humorului,www.g4media.ro,0,0,1,1,0.0,0.0
Marius Lulea Faza,www.g4media.ro,0,0,1,1,0.0,0.0
Marius Ostaficiuc,www.g4media.ro,0,1,0,1,-1.0,1.0
Mihai Adrian Enache,www.g4media.ro,0,0,2,2,0.0,0.0
Mircea Ionuț Sandu,www.g4media.ro,0,0,1,1,0.0,0.0
Măndica Badiu,www.g4media.ro,0,0,1,1,0.0,0.0
Măndicăi Badiu,www.g4media.ro,0,0,1,1,0.0,0.0
Mătieș,www.g4media.ro,0,1,0,1,-1.0,1.0
Nașa,www.g4media.ro,0,1,0,1,-1.0,1.0
Nașul,www.g4media.ro,0,1,0,1,-1.0,1.0
Negrea,www.g4media.ro,0,1,0,1,-1.0,1.0
Niculina Stelea,www.g4media.ro,0,0,1,1,0.0,0.0
Ostaficiuc,www.g4media.ro,0,1,0,1,-1.0,1.0
Petru Gabriel Negrea,www.g4media.ro,0,0,1,1,0.0,0.0
Silviu Oancea,www.g4media.ro,0,0,1,1,0.0,0.0
Svetlana Gomboș,www.g4media.ro,0,0,1,1,0.0,0.0
unchi,www.g4media.ro,0,4,0,4,-1.0,1.0
vinovat,www.g4media.ro,0,2,0,2,-1.0,1.0
Vlădulescu,www.g4media.ro,0,1,0,1,-1.0,1.0
Vrancea,www.g4media.ro,0,0,3,3,0.0,0.0
amic,www.g4media.ro,0,0,1,1,0.0,0.0
clientelă,www.g4media.ro,0,1,0,1,-1.0,1.0
cumnat,www.g4media.ro,0,1,0,1,-1.0,1.0
cumătru,www.g4media.ro,0,0,1,1,0.0,0.0
electrician,www.g4media.ro,0,0,1,1,0.0,0.0
eu,www.g4media.ro,0,2,0,2,-1.0,1.0
mame,www.g4media.ro,0,0,1,1,0.0,0.0
manager,www.g4media.ro,0,0,3,3,0.0,0.0
mătușă,www.g4media.ro,0,0,1,1,0.0,0.0
Geanina,www.g4media.ro,0,1,0,1,-1.0,1.0
nașă,www.g4media.ro,0,1,0,1,-1.0,1.0
naș,www.g4media.ro,0,1,1,2,-0.5,0.5
ospătar,www.g4media.ro,0,0,3,3,0.0,0.0
referent,www.g4media.ro,0,1,0,1,-1.0,1.0
rudă,www.g4media.ro,0,1,0,1,-1.0,1.0
Mihai Adrian,www.g4media.ro,0,1,0,1,-1.0,1.0
traseiștilor,www.g4media.ro,0,1,0,1,-1.0,1.0
Ștefan Oprea,www.g4media.ro,0,0,1,1,0.0,0.0
Chirita,adevarul.ro,0,1,1,2,-0.5,0.5
Ioan Mureșan,adevarul.ro,0,0,2,2,0.0,0.0
Ion Diaconescu,adevarul.ro,0,1,2,3,-0.3333333333333333,0.3333333333333333
Lupu,adevarul.ro,0,2,0,2,-1.0,1.0
Marga,adevarul.ro,0,1,1,2,-0.5,0.5
Muresan,adevarul.ro,0,0,1,1,0.0,0.0
Radu Sarbu,adevarul.ro,0,0,1,1,0.0,0.0
mutant,adevarul.ro,0,1,0,1,-1.0,1.0
taranist,adevarul.ro,0,3,0,3,-1.0,1.0
Dan Nica,www.comisarul.ro,0,2,0,2,-1.0,1.0
Vasile Blaga,www.comisarul.ro,0,0,1,1,0.0,0.0
Oameni,www.g4media.ro,0,0,1,1,0.0,0.0
vorbitor,www.gandul.ro,0,0,1,1,0.0,0.0
Vasile Marcu,www.antena3.ro,0,0,2,2,0.0,0.0
Cătălin Zamfir,www.comisarul.ro,0,0,1,1,0.0,0.0
Stănescu,www.comisarul.ro,0,1,1,2,-0.5,0.5
Toma,www.comisarul.ro,0,1,0,1,-1.0,1.0
Giurgiu,observatornews.ro,0,0,3,3,0.0,0.0
Lavinia Șandru,observatornews.ro,0,0,1,1,0.0,0.0
Simona Allice Man,observatornews.ro,0,0,1,1,0.0,0.0
Șandru,observatornews.ro,0,0,1,1,0.0,0.0
Eisenhower,a1.ro,0,0,1,1,0.0,0.0
Herbert Hoover,a1.ro,0,0,1,1,0.0,0.0
Herman Cain,a1.ro,0,1,0,1,-1.0,1.0
Libia,a1.ro,0,0,1,1,0.0,0.0
Michelle Bachman,a1.ro,0,0,1,1,0.0,0.0
Mitt Romney,a1.ro,0,1,0,1,-1.0,1.0
Newt Gingrich,a1.ro,0,0,1,1,0.0,0.0
Ronald Reagan,a1.ro,0,0,2,2,0.0,0.0
Teddy Roosevelt,a1.ro,0,0,1,1,0.0,0.0
Warren Harding,a1.ro,0,0,1,1,0.0,0.0
Will Ferrell,a1.ro,0,0,1,1,0.0,0.0
actor,a1.ro,0,0,1,1,0.0,0.0
proprietar,adevarul.ro,0,5,1,6,-0.8333333333333334,0.8333333333333334
străin,adevarul.ro,0,1,1,2,-0.5,0.5
Szabo Jozsef Andor,adevarul.ro,0,0,1,1,0.0,0.0
Rosen Jeliazkov,www.aktual24.ro,0,0,1,1,0.0,0.0
Bacău,www.luju.ro,0,0,2,2,0.0,0.0
Cerasela Cocalea,www.luju.ro,0,1,0,1,-1.0,1.0
Daniel Lucian Viziteu,www.luju.ro,0,1,0,1,-1.0,1.0
Viziteu,www.luju.ro,0,1,0,1,-1.0,1.0
semnatar,www.comisarul.ro,0,2,0,2,-1.0,1.0
Simona Bucura-Oprescu,www.comisarul.ro,0,0,2,2,0.0,0.0
erou,www.comisarul.ro,1,1,0,2,0.0,0.0
Bogdan Pintileasa,recorder.ro,0,0,1,1,0.0,0.0
Cristian Ghinea,recorder.ro,0,0,1,1,0.0,0.0
Gabriela Szabo,recorder.ro,0,1,0,1,-1.0,1.0
Ionel Pirpiliu,recorder.ro,0,1,0,1,-1.0,1.0
Mihaela Ștefan,recorder.ro,0,0,1,1,0.0,0.0
Monica Iagăr,recorder.ro,0,1,0,1,-1.0,1.0
Monica Macovei,recorder.ro,0,0,2,2,0.0,0.0
atlet,recorder.ro,0,0,1,1,0.0,0.0
Sorin Oprescu,recorder.ro,0,1,0,1,-1.0,1.0
,www.aktual24.ro,0,3,0,3,-1.0,1.0
Malin Bot,www.aktual24.ro,0,1,0,1,-1.0,1.0
corupt,www.aktual24.ro,0,2,0,2,-1.0,1.0
dvs,www.aktual24.ro,0,3,0,3,-1.0,1.0
ploz,www.aktual24.ro,0,1,0,1,-1.0,1.0
prietene,www.aktual24.ro,0,2,0,2,-1.0,1.0
Bahmut,recorder.ro,0,1,0,1,-1.0,1.0
Becali,recorder.ro,0,0,2,2,0.0,0.0
Ben Horowitz,recorder.ro,0,0,1,1,0.0,0.0
Diana Meseșan,recorder.ro,0,0,3,3,0.0,0.0
Dansa,recorder.ro,0,1,0,1,-1.0,1.0
Grindeanu,recorder.ro,0,2,0,2,-1.0,1.0
Ierusalim,recorder.ro,0,0,2,2,0.0,0.0
Laura Crișan,recorder.ro,0,0,1,1,0.0,0.0
Mihai Ciolacu,recorder.ro,0,1,0,1,-1.0,1.0
Sebastian Ghiță,recorder.ro,0,5,0,5,-1.0,1.0
afacere,recorder.ro,0,1,0,1,-1.0,1.0
analișt,recorder.ro,0,2,1,3,-0.6666666666666666,0.6666666666666666
contabilă,recorder.ro,0,3,0,3,-1.0,1.0
criminolog,recorder.ro,0,0,1,1,0.0,0.0
drogat,recorder.ro,0,1,0,1,-1.0,1.0
frizer,recorder.ro,0,1,0,1,-1.0,1.0
cuplu,adevarul.ro,2,0,2,4,0.5,0.5
Roman,stirileprotv.ro,0,0,1,1,0.0,0.0
Secuiescu,stirileprotv.ro,0,0,1,1,0.0,0.0
Ținut Secuiesc,stirileprotv.ro,0,0,1,1,0.0,0.0
Apostolache,a1.ro,0,0,1,1,0.0,0.0
Cristian Burlacu,a1.ro,0,0,1,1,0.0,0.0
Mihai Apostolache,a1.ro,0,0,1,1,0.0,0.0
Ploiești,a1.ro,0,0,1,1,0.0,0.0
Victor Apostolache,a1.ro,0,0,1,1,0.0,0.0
migrator,a1.ro,0,0,1,1,0.0,0.0
Hugo Boss,recorder.ro,0,1,0,1,-1.0,1.0
noi,recorder.ro,0,1,0,1,-1.0,1.0
supuș,recorder.ro,0,1,0,1,-1.0,1.0
viețuitoare,recorder.ro,0,1,0,1,-1.0,1.0
Intotero,www.euronews.ro,0,0,1,1,0.0,0.0
Alinei Gorghiu,adevarul.ro,0,0,1,1,0.0,0.0
Covid,adevarul.ro,0,0,1,1,0.0,0.0
Iowa,adevarul.ro,0,0,1,1,0.0,0.0
Luxemburg,adevarul.ro,0,0,1,1,0.0,0.0
lector,adevarul.ro,0,0,1,1,0.0,0.0
Argeș,www.activenews.ro,0,0,1,1,0.0,0.0
Câmpulung,www.activenews.ro,0,0,1,1,0.0,0.0
Câmpulung Muscel,www.activenews.ro,0,0,1,1,0.0,0.0
Donald Trump Jr.,www.activenews.ro,0,0,1,1,0.0,0.0
Elena Valerica,www.activenews.ro,0,0,1,1,0.0,0.0
Elena Valerica Lăsconi,www.activenews.ro,0,1,0,1,-1.0,1.0
Elenă,www.activenews.ro,0,0,1,1,0.0,0.0
Hațeg,www.activenews.ro,0,0,1,1,0.0,0.0
Hunedoara,www.activenews.ro,0,0,1,1,0.0,0.0
Ioan Timiș,www.activenews.ro,0,0,1,1,0.0,0.0
Lagos,www.activenews.ro,0,1,0,1,-1.0,1.0
Lerești,www.activenews.ro,0,0,1,1,0.0,0.0
Lui Pahonțu,www.activenews.ro,0,0,1,1,0.0,0.0
Lui Timofte,www.activenews.ro,0,0,1,1,0.0,0.0
Lăsconi,www.activenews.ro,0,0,1,1,0.0,0.0
Magda Bistriceanu,www.activenews.ro,0,0,1,1,0.0,0.0
Marcel Opriș,www.activenews.ro,0,0,1,1,0.0,0.0
Monica Macovei,www.activenews.ro,0,1,0,1,-1.0,1.0
Moș Nicolae,www.activenews.ro,0,0,1,1,0.0,0.0
Munchen,www.activenews.ro,0,0,1,1,0.0,0.0
Nea Lucică,www.activenews.ro,0,1,0,1,-1.0,1.0
Nigeria,www.activenews.ro,0,1,0,1,-1.0,1.0
Pahonțu,www.activenews.ro,0,2,1,3,-0.6666666666666666,0.6666666666666666
Radu Timofte,www.activenews.ro,0,0,1,1,0.0,0.0
Rucăr,www.activenews.ro,0,1,0,1,-1.0,1.0
Sibiu,www.activenews.ro,0,1,0,1,-1.0,1.0
Sălaj,www.activenews.ro,0,1,0,1,-1.0,1.0
Vicepreședintele,www.activenews.ro,0,0,1,1,0.0,0.0
amica,www.activenews.ro,0,0,1,1,0.0,0.0
analfabet,www.activenews.ro,0,1,0,1,-1.0,1.0
broker,www.activenews.ro,0,1,0,1,-1.0,1.0
condeier,www.activenews.ro,0,1,0,1,-1.0,1.0
Lucian Predoiu,www.activenews.ro,0,1,0,1,-1.0,1.0
cursant,www.activenews.ro,0,1,0,1,-1.0,1.0
declarant,www.activenews.ro,0,0,1,1,0.0,0.0
derbedeu,www.activenews.ro,0,1,0,1,-1.0,1.0
divă,www.activenews.ro,0,1,0,1,-1.0,1.0
Lucian Pahonțu,www.activenews.ro,0,2,1,3,-0.6666666666666666,0.6666666666666666
Opriș,www.activenews.ro,0,1,0,1,-1.0,1.0
Vasile Milea,www.activenews.ro,0,1,1,2,-0.5,0.5
ipochimen,www.activenews.ro,0,1,0,1,-1.0,1.0
luptătoare,www.activenews.ro,0,1,0,1,-1.0,1.0
mamă,www.activenews.ro,1,0,1,2,0.5,0.5
Lucica Nea,www.activenews.ro,0,1,0,1,-1.0,1.0
neociocoi,www.activenews.ro,0,1,0,1,-1.0,1.0
nepotul Pahonțu,www.activenews.ro,0,1,0,1,-1.0,1.0
portar,www.activenews.ro,0,1,0,1,-1.0,1.0
reclamant,www.activenews.ro,0,1,0,1,-1.0,1.0
repetent,www.activenews.ro,0,1,0,1,-1.0,1.0
rudenie,www.activenews.ro,0,0,1,1,0.0,0.0
rănit,www.activenews.ro,0,1,0,1,-1.0,1.0
soț,www.activenews.ro,0,3,4,7,-0.42857142857142855,0.42857142857142855
spion,www.activenews.ro,0,2,0,2,-1.0,1.0
subaltern,www.activenews.ro,0,1,0,1,-1.0,1.0
subofițer,www.activenews.ro,0,1,0,1,-1.0,1.0
tineret,www.activenews.ro,0,1,1,2,-0.5,0.5
Nicolae Predoiu,www.activenews.ro,0,0,1,1,0.0,0.0
unchi,www.activenews.ro,0,0,1,1,0.0,0.0
vinovat,www.activenews.ro,0,1,0,1,-1.0,1.0
șefă,www.activenews.ro,0,0,1,1,0.0,0.0
țigan,www.activenews.ro,0,0,1,1,0.0,0.0
țărancă,www.activenews.ro,0,0,1,1,0.0,0.0
Mark Rutte,agerpres.ro,0,0,1,1,0.0,0.0
Arad,www.comisarul.ro,0,0,2,2,0.0,0.0
Bistrița Năsăud,www.comisarul.ro,0,0,1,1,0.0,0.0
Căianu Mic,www.comisarul.ro,0,0,1,1,0.0,0.0
Timișoara,www.comisarul.ro,0,0,2,2,0.0,0.0
Robert Sighiartău,www.g4media.ro,0,0,5,5,0.0,0.0
Sighiartău,www.g4media.ro,0,0,3,3,0.0,0.0
Adrian Cozma,www.g4media.ro,0,1,0,1,-1.0,1.0
eurodeputat,www.aktual24.ro,0,0,1,1,0.0,0.0
Muresan,www.aktual24.ro,0,0,1,1,0.0,0.0
Adrian Porumboiu,snoop.ro,0,0,3,3,0.0,0.0
Alexandr Lușakenko,snoop.ro,0,0,1,1,0.0,0.0
Andrei Grinkevich,snoop.ro,0,0,1,1,0.0,0.0
Becali,snoop.ro,0,0,1,1,0.0,0.0
Belarus,snoop.ro,0,0,2,2,0.0,0.0
C,snoop.ro,0,1,0,1,-1.0,1.0
Constantinescu,snoop.ro,0,0,1,1,0.0,0.0
Dan Duca,snoop.ro,0,0,1,1,0.0,0.0
Elon Musk,snoop.ro,0,0,1,1,0.0,0.0
Fuad Kokaly,snoop.ro,0,0,1,1,0.0,0.0
Gage Skidmore,snoop.ro,0,0,1,1,0.0,0.0
Grinkievici,snoop.ro,0,0,1,1,0.0,0.0
interlocutor,snoop.ro,0,1,0,1,-1.0,1.0
Joan Miró,snoop.ro,0,0,1,1,0.0,0.0
Lucrețiu Pătrășcanu,snoop.ro,0,0,1,1,0.0,0.0
Musk,snoop.ro,0,0,1,1,0.0,0.0
Ovidiu Marian Stănică,snoop.ro,0,0,1,1,0.0,0.0
Ovidiu Stănică,snoop.ro,0,0,2,2,0.0,0.0
Palestina,snoop.ro,0,0,1,1,0.0,0.0
Porumboiu,snoop.ro,0,0,1,1,0.0,0.0
Romanov,snoop.ro,0,0,1,1,0.0,0.0
Sorin Ovidiu Vântu,snoop.ro,0,0,1,1,0.0,0.0
Statele Unite,snoop.ro,0,1,2,3,-0.3333333333333333,0.3333333333333333
Stănică,snoop.ro,0,1,0,1,-1.0,1.0
Tucker Carlson,snoop.ro,0,0,1,1,0.0,0.0
ist,snoop.ro,0,1,0,1,-1.0,1.0
pictor,snoop.ro,0,0,1,1,0.0,0.0
sculptor,snoop.ro,0,0,1,1,0.0,0.0
vedet,snoop.ro,0,1,0,1,-1.0,1.0
Alina Gorghiu,www.mediafax.ro,0,0,3,3,0.0,0.0
Gorghiu,www.mediafax.ro,0,0,2,2,0.0,0.0
Ionuț Marcel Păcuraru,www.g4media.ro,0,0,1,1,0.0,0.0
Maricel Păcuraru,www.g4media.ro,0,1,0,1,-1.0,1.0
Victor Pontal,agerpres.ro,0,1,0,1,-1.0,1.0
actor politic,agerpres.ro,0,1,0,1,-1.0,1.0
simpatizant,agerpres.ro,1,1,0,2,0.0,0.0
Cseke,www.aktual24.ro,0,0,2,2,0.0,0.0
Csoma,www.aktual24.ro,0,0,2,2,0.0,0.0
Fritz,www.aktual24.ro,0,0,2,2,0.0,0.0
Hunor,www.aktual24.ro,0,0,3,3,0.0,0.0
Mosteanu,www.aktual24.ro,0,0,2,2,0.0,0.0
Vestea,www.aktual24.ro,0,0,2,2,0.0,0.0
Aurelian Pavelescu,a1.ro,0,0,1,1,0.0,0.0
Gheorghe Ciuhandu,a1.ro,0,0,2,2,0.0,0.0
Marian Milut,a1.ro,0,0,1,1,0.0,0.0
Pricopie,www.cotidianul.ro,0,1,0,1,-1.0,1.0
Băsescu,www.antena3.ro,0,1,1,2,-0.5,0.5
Hunedoara,www.antena3.ro,1,0,0,1,1.0,1.0
umaniști,www.antena3.ro,0,0,1,1,0.0,0.0
Africa de Sud,pressone.ro,0,0,1,1,0.0,0.0
Amândoi,pressone.ro,1,2,1,4,-0.25,0.25
Brazilia,pressone.ro,0,1,3,4,-0.25,0.25
Cosmin Vătafu,pressone.ro,0,0,2,2,0.0,0.0
Emil Călin,pressone.ro,0,0,1,1,0.0,0.0
Francisc Tobă,pressone.ro,0,0,1,1,0.0,0.0
Gică Hagi,pressone.ro,0,1,0,1,-1.0,1.0
India,pressone.ro,0,0,1,1,0.0,0.0
Monaco,pressone.ro,0,0,1,1,0.0,0.0
Năvodari,pressone.ro,0,0,2,2,0.0,0.0
Pîrvulescu,pressone.ro,0,1,1,2,-0.5,0.5
Sfântul Andrei,pressone.ro,0,0,1,1,0.0,0.0
Vătafu,pressone.ro,0,0,1,1,0.0,0.0
conspiraționist,pressone.ro,0,1,0,1,-1.0,1.0
director adjunct,pressone.ro,0,1,0,1,-1.0,1.0
Cătălin,pressone.ro,0,0,1,1,0.0,0.0
fost,pressone.ro,0,1,0,1,-1.0,1.0
Nicolae Rotaru,pressone.ro,0,0,1,1,0.0,0.0
nebun,pressone.ro,0,1,0,1,-1.0,1.0
olimpic,pressone.ro,0,0,2,2,0.0,0.0
Natanael Savu,www.romaniatv.net,0,0,2,2,0.0,0.0
agresor,www.romaniatv.net,0,2,0,2,-1.0,1.0
localnic,www.romaniatv.net,0,1,0,1,-1.0,1.0
socrul,www.romaniatv.net,0,1,0,1,-1.0,1.0
Șandra,www.romaniatv.net,0,0,1,1,0.0,0.0
Dobrițoiu,recorder.ro,0,1,0,1,-1.0,1.0
Maricel Dobrițoiu,recorder.ro,0,1,0,1,-1.0,1.0
trăgător,recorder.ro,0,0,1,1,0.0,0.0
Victor Roman,recorder.ro,0,0,1,1,0.0,0.0
elev,www.gandul.ro,0,0,2,2,0.0,0.0
Dan Vîlceanu,www.romaniatv.net,0,3,0,3,-1.0,1.0
Florin Roman,www.romaniatv.net,0,1,3,4,-0.25,0.25
Dumitru,www.romaniatv.net,0,0,1,1,0.0,0.0
Florian Dumitru,www.romaniatv.net,0,0,2,2,0.0,0.0
Florian Emil Dumitru,www.romaniatv.net,0,0,1,1,0.0,0.0
Iulian Dumitrescu,www.romaniatv.net,0,0,1,1,0.0,0.0
Lamborghini,www.romaniatv.net,0,1,0,1,-1.0,1.0
Roman,www.romaniatv.net,0,0,2,2,0.0,0.0
Vîlceanu,www.romaniatv.net,0,1,0,1,-1.0,1.0
baron,www.romaniatv.net,0,1,0,1,-1.0,1.0
Dan Diaconescu,www.realitatea.net,0,1,0,1,-1.0,1.0
Diaconescu,www.realitatea.net,0,1,0,1,-1.0,1.0
Sorin Voinea,www.realitatea.net,0,0,1,1,0.0,0.0
Vedeta,www.realitatea.net,0,1,0,1,-1.0,1.0
martor,www.realitatea.net,0,1,2,3,-0.3333333333333333,0.3333333333333333
minor,www.realitatea.net,0,1,0,1,-1.0,1.0
vedet,www.realitatea.net,0,0,1,1,0.0,0.0
bunic,primanews.ro,3,0,0,3,1.0,1.0
Emil Constantinescu,primanews.ro,1,0,0,1,1.0,1.0
Funeriu,primanews.ro,0,0,1,1,0.0,0.0
Ghiță,primanews.ro,0,1,0,1,-1.0,1.0
Prometeu,primanews.ro,0,1,0,1,-1.0,1.0
Serb,primanews.ro,0,0,1,1,0.0,0.0
Snagov,primanews.ro,0,0,1,1,0.0,0.0
camaraz,primanews.ro,0,1,0,1,-1.0,1.0
colonel,primanews.ro,0,1,1,2,-0.5,0.5
individ,primanews.ro,0,1,0,1,-1.0,1.0
om politic,primanews.ro,0,1,0,1,-1.0,1.0
puciște,primanews.ro,0,1,0,1,-1.0,1.0
păpușar,primanews.ro,0,1,0,1,-1.0,1.0
tip,primanews.ro,0,1,0,1,-1.0,1.0
ul,primanews.ro,0,0,1,1,0.0,0.0
Dragoș Benea,www.g4media.ro,0,0,1,1,0.0,0.0
Dragoș Ștefan,www.g4media.ro,0,0,1,1,0.0,0.0
Raffaele Fitto,www.g4media.ro,0,0,1,1,0.0,0.0
Lucian Stanciu Viziteu,www.g4media.ro,0,0,1,1,0.0,0.0
Doduț,adevarul.ro,0,1,0,1,-1.0,1.0
Poe,adevarul.ro,0,0,2,2,0.0,0.0
rapper,adevarul.ro,0,1,0,1,-1.0,1.0
Adrian Hatos,recorder.ro,0,0,1,1,0.0,0.0
Albert Camus,recorder.ro,0,0,1,1,0.0,0.0
Aleșd,recorder.ro,0,0,1,1,0.0,0.0
Beiuș,recorder.ro,1,0,1,2,0.5,0.5
Brătianu,recorder.ro,0,0,1,1,0.0,0.0
Cristian Marin Buzlea,recorder.ro,0,0,1,1,0.0,0.0
Attila Cseke,recorder.ro,0,0,1,1,0.0,0.0
Florian Bodog,recorder.ro,0,0,1,1,0.0,0.0
Florica Cherecheș,recorder.ro,0,0,1,1,0.0,0.0
Frans de Waal,recorder.ro,0,0,1,1,0.0,0.0
Gheorghe Carp,recorder.ro,0,0,1,1,0.0,0.0
Gustave Le Bon,recorder.ro,0,0,1,1,0.0,0.0
Ioan Cupșa,recorder.ro,0,0,1,1,0.0,0.0
Ioan Mang,recorder.ro,0,0,1,1,0.0,0.0
Irving Stone,recorder.ro,0,0,1,1,0.0,0.0
Janos Kiss,recorder.ro,0,0,1,1,0.0,0.0
John C. Maxwell,recorder.ro,1,0,0,1,1.0,1.0
John Maxwell,recorder.ro,1,0,1,2,0.5,0.5
Kiss Janos,recorder.ro,0,0,1,1,0.0,0.0
László Kormányos,recorder.ro,0,0,1,1,0.0,0.0
Mediaș,recorder.ro,0,0,4,4,0.0,0.0
Misha Glenny,recorder.ro,0,0,1,1,0.0,0.0
Odon Szabo,recorder.ro,0,0,1,1,0.0,0.0
Og Mandino,recorder.ro,0,0,1,1,0.0,0.0
Patricia Arina,recorder.ro,0,0,1,1,0.0,0.0
Rozalia Biro,recorder.ro,0,0,1,1,0.0,0.0
Silviu Dehelean,recorder.ro,0,1,1,2,-0.5,0.5
Steluța Cătăniciu,recorder.ro,0,0,1,1,0.0,0.0
Vasi Rădulescu,recorder.ro,0,0,1,1,0.0,0.0
Vasile Aurel Căuș,recorder.ro,0,0,1,1,0.0,0.0
cadru universitar,recorder.ro,0,0,1,1,0.0,0.0
epidemiolog,recorder.ro,0,1,0,1,-1.0,1.0
muzeograf,recorder.ro,0,0,1,1,0.0,0.0
mămică,recorder.ro,1,1,0,2,0.0,0.0
traseiști,recorder.ro,0,3,0,3,-1.0,1.0
Adrian Mihalcea,www.comisarul.ro,0,0,1,1,0.0,0.0
Clinceni,www.comisarul.ro,0,0,1,1,0.0,0.0
Copou,www.comisarul.ro,0,1,0,1,-1.0,1.0
covăsnean,www.comisarul.ro,0,2,0,2,-1.0,1.0
Dorinel Munteanu,www.comisarul.ro,0,0,1,1,0.0,0.0
Grozav,www.comisarul.ro,0,0,1,1,0.0,0.0
Gică Hagi,www.comisarul.ro,0,1,0,1,-1.0,1.0
Gică Mihali,www.comisarul.ro,0,1,0,1,-1.0,1.0
I. Stoica,www.comisarul.ro,0,0,1,1,0.0,0.0
Mitrov,www.comisarul.ro,0,0,1,1,0.0,0.0
Niczuly,www.comisarul.ro,0,1,0,1,-1.0,1.0
component,www.comisarul.ro,0,0,1,1,0.0,0.0
gazdă,www.comisarul.ro,0,1,1,2,-0.5,0.5
ploiește,www.comisarul.ro,0,0,1,1,0.0,0.0
Radu Carp,www.gandul.ro,0,0,2,2,0.0,0.0
analist politic,www.gandul.ro,0,0,1,1,0.0,0.0
Beniamin Netanyahu,www.luju.ro,0,0,1,1,0.0,0.0
Dan,www.luju.ro,0,3,0,3,-1.0,1.0
Israel,www.luju.ro,0,0,1,1,0.0,0.0
Netanyahu,www.luju.ro,0,0,1,1,0.0,0.0
protejat,www.luju.ro,1,0,0,1,1.0,1.0
Nicusor Dan,www.luju.ro,0,1,0,1,-1.0,1.0
Ionuț Moșteanu,www.cotidianul.ro,0,0,1,1,0.0,0.0
Dorel Șandor,www.comisarul.ro,0,0,1,1,0.0,0.0
Stolojan,www.comisarul.ro,0,0,1,1,0.0,0.0
consultant politic,www.comisarul.ro,0,0,1,1,0.0,0.0
Șandor,www.comisarul.ro,0,0,1,1,0.0,0.0
Călin Gorgescu,www.realitatea.net,0,1,0,1,-1.0,1.0
"Washington, D.C.",www.antena3.ro,0,0,1,1,0.0,0.0
Marcel Bolos,www.aktual24.ro,0,0,2,2,0.0,0.0
criminal,a1.ro,0,1,0,1,-1.0,1.0
Intotero,www.antena3.ro,0,0,1,1,0.0,0.0
Natalia Intotero,www.antena3.ro,0,0,2,2,0.0,0.0
cu,www.antena3.ro,0,0,1,1,0.0,0.0
profesoară,www.antena3.ro,0,0,2,2,0.0,0.0
Hațeg,recorder.ro,0,0,1,1,0.0,0.0
Lucian Viziteu,recorder.ro,0,1,0,1,-1.0,1.0
moderator,recorder.ro,0,0,1,1,0.0,0.0
Câmpulung Muscel,a1.ro,0,0,3,3,0.0,0.0
Bacău,www.b1tv.ro,0,0,1,1,0.0,0.0
Robert Alecu,www.b1tv.ro,0,0,2,2,0.0,0.0
George Becali,www.b1tv.ro,0,0,1,1,0.0,0.0
Șerban Dimitrie Sturdza,www.b1tv.ro,0,0,1,1,0.0,0.0
Oprea,www.euronews.ro,0,0,1,1,0.0,0.0
Zaharova,www.comisarul.ro,0,1,0,1,-1.0,1.0
Baia Mare,www.activenews.ro,0,0,1,1,0.0,0.0
Cristian Pantazi,www.activenews.ro,0,1,0,1,-1.0,1.0
Justin Pârvu,www.activenews.ro,1,0,0,1,1.0,1.0
Rodica Pantazi,www.activenews.ro,0,1,0,1,-1.0,1.0
România Mare,www.activenews.ro,0,0,1,1,0.0,0.0
stat,www.activenews.ro,0,1,0,1,-1.0,1.0
văzător,www.activenews.ro,0,1,0,1,-1.0,1.0
Marius Vulpe,www.euronews.ro,0,1,3,4,-0.25,0.25
stat,www.euronews.ro,0,1,1,2,-0.5,0.5
subprefect,www.euronews.ro,0,1,0,1,-1.0,1.0
Lucian Romașcanu,www.b1tv.ro,0,0,2,2,0.0,0.0
purtător de cuvânt,www.b1tv.ro,0,0,1,1,0.0,0.0
Pambuccian,www.mediafax.ro,0,0,1,1,0.0,0.0
Corina Cretu,www.antena3.ro,0,0,1,1,0.0,0.0
Dubrovnik,www.antena3.ro,0,0,1,1,0.0,0.0
Mihaela Toader,www.antena3.ro,0,0,1,1,0.0,0.0
comisar,www.antena3.ro,0,0,1,1,0.0,0.0
Mar,www.realitatea.net,0,1,0,1,-1.0,1.0
Alfred Simons,www.comisarul.ro,0,0,1,1,0.0,0.0
baron,www.comisarul.ro,0,1,0,1,-1.0,1.0
altor,www.comisarul.ro,0,1,0,1,-1.0,1.0
finalist,www.comisarul.ro,0,0,2,2,0.0,0.0
șef de stat,www.comisarul.ro,0,0,3,3,0.0,0.0
Paul,recorder.ro,0,0,2,2,0.0,0.0
Paul Ispas,recorder.ro,0,0,2,2,0.0,0.0
Luminița Odobescu,adevarul.ro,0,0,3,3,0.0,0.0
șef interimar,adevarul.ro,0,0,1,1,0.0,0.0
bandit,www.gandul.ro,0,1,0,1,-1.0,1.0
Tatulici,www.comisarul.ro,0,0,2,2,0.0,0.0
Mihai Tatulici,www.comisarul.ro,0,1,1,2,-0.5,0.5
Ionuț Mareș,agerpres.ro,0,0,1,1,0.0,0.0
Manfred Weber,agerpres.ro,0,0,1,1,0.0,0.0
Mureșan,agerpres.ro,0,0,2,2,0.0,0.0
Siegfried Mureșan,agerpres.ro,0,0,1,1,0.0,0.0
trimis,agerpres.ro,0,0,1,1,0.0,0.0
Weber,agerpres.ro,0,0,1,1,0.0,0.0
sibian,www.g4media.ro,0,0,1,1,0.0,0.0
Quintus,www.mediafax.ro,1,0,0,1,1.0,1.0
trădător,www.mediafax.ro,0,2,0,2,-1.0,1.0
Alba Iulia,stirileprotv.ro,1,0,0,1,1.0,1.0
custode,stirileprotv.ro,0,0,1,1,0.0,0.0
familie regală,stirileprotv.ro,0,0,2,2,0.0,0.0
Margareta,stirileprotv.ro,0,0,1,1,0.0,0.0
Mihai Viteazul,stirileprotv.ro,1,0,0,1,1.0,1.0
Daniel,stirileprotv.ro,0,0,1,1,0.0,0.0
Regele Ferdinand,stirileprotv.ro,1,0,1,2,0.5,0.5
Ferdinand I,stirileprotv.ro,1,0,0,1,1.0,1.0
Regina Maria,stirileprotv.ro,1,0,1,2,0.5,0.5
România Mare,stirileprotv.ro,1,0,0,1,1.0,1.0
suveran,stirileprotv.ro,2,0,0,2,1.0,1.0
Suveranii României Mari,stirileprotv.ro,1,0,0,1,1.0,1.0
cler,stirileprotv.ro,0,0,1,1,0.0,0.0
inamic,stirileprotv.ro,0,1,0,1,-1.0,1.0
Radu,stirileprotv.ro,0,0,1,1,0.0,0.0
regi,stirileprotv.ro,1,0,0,1,1.0,1.0
suită regală,stirileprotv.ro,0,0,1,1,0.0,0.0
trimis,stirileprotv.ro,1,0,1,2,0.5,0.5
înaintaș,stirileprotv.ro,1,0,0,1,1.0,1.0
Iulia,primanews.ro,0,1,0,1,-1.0,1.0
Nea Paul,primanews.ro,0,0,1,1,0.0,0.0
Brian Marly,agerpres.ro,0,0,1,1,0.0,0.0
Constantin Balaban,agerpres.ro,0,0,1,1,0.0,0.0
economișt,agerpres.ro,0,0,1,1,0.0,0.0
František Taborský,agerpres.ro,0,0,1,1,0.0,0.0
economist,agerpres.ro,0,1,1,2,-0.5,0.5
Marea Britanie,stirileprotv.ro,0,0,5,5,0.0,0.0
Mark Rutte,stirileprotv.ro,0,0,2,2,0.0,0.0
doritor,stirileprotv.ro,0,1,0,1,-1.0,1.0
e,stirileprotv.ro,0,1,0,1,-1.0,1.0
Don Lothrop,pressone.ro,1,0,1,2,0.5,0.5
Voicu Bojan,pressone.ro,0,0,2,2,0.0,0.0
finanțator,pressone.ro,0,0,1,1,0.0,0.0
Beianu,pressone.ro,0,0,1,1,0.0,0.0
Daniela Cîmpean,pressone.ro,0,0,1,1,0.0,0.0
Dumitru Beianu,pressone.ro,0,0,1,1,0.0,0.0
Iustin Cionca,pressone.ro,0,1,0,1,-1.0,1.0
giurgiuvener,pressone.ro,0,0,1,1,0.0,0.0
giurgiuveni,pressone.ro,0,0,1,1,0.0,0.0
Ion Dumitrel,pressone.ro,0,0,1,1,0.0,0.0
pasager,pressone.ro,0,2,1,3,-0.6666666666666666,0.6666666666666666
dubios,pressone.ro,0,1,0,1,-1.0,1.0
motociclist,pressone.ro,0,1,0,1,-1.0,1.0
plebeu,pressone.ro,0,1,0,1,-1.0,1.0
scandalagiu,pressone.ro,0,1,0,1,-1.0,1.0
traseiști,pressone.ro,0,1,0,1,-1.0,1.0
vătaf,pressone.ro,0,1,0,1,-1.0,1.0
Andi Cristea,adevarul.ro,0,0,1,1,0.0,0.0
Ionuț Stroe,adevarul.ro,0,0,1,1,0.0,0.0
Stroe,adevarul.ro,0,1,2,3,-0.3333333333333333,0.3333333333333333
Radu Mihail,adevarul.ro,0,0,1,1,0.0,0.0
Patriciu,www.mediafax.ro,0,0,1,1,0.0,0.0
Vântu,www.mediafax.ro,0,1,0,1,-1.0,1.0
Magda Catone,www.romaniatv.net,0,0,2,2,0.0,0.0
Adrian Costache,www.romaniatv.net,0,0,2,2,0.0,0.0
Zalău,www.gandul.ro,0,0,1,1,0.0,0.0
suveranist,www.gandul.ro,0,1,0,1,-1.0,1.0
suveran,www.gandul.ro,0,1,0,1,-1.0,1.0
Radu Preda,www.romaniatv.net,0,0,2,2,0.0,0.0
adresant,www.romaniatv.net,0,0,1,1,0.0,0.0
Mihai Enache,www.romaniatv.net,0,0,1,1,0.0,0.0
Petrișor Puiu,www.romaniatv.net,0,0,1,1,0.0,0.0
teolog,www.romaniatv.net,0,0,2,2,0.0,0.0
Venus,www.digi24.ro,0,0,1,1,0.0,0.0
Lucian Judele,www.news.ro,0,0,1,1,0.0,0.0
viceprimar,www.news.ro,0,0,1,1,0.0,0.0
Căutiș,adevarul.ro,0,0,1,1,0.0,0.0
Alexandru Căutiș,adevarul.ro,0,0,1,1,0.0,0.0
adjunct,www.luju.ro,0,0,1,1,0.0,0.0
Bogdan Apetroae,www.luju.ro,0,0,2,2,0.0,0.0
Focica,www.luju.ro,0,0,1,1,0.0,0.0
Marta Daniela Chis,www.luju.ro,0,0,1,1,0.0,0.0
Mihaela Focica,www.luju.ro,0,0,1,1,0.0,0.0
Alexandra,pressone.ro,1,1,0,2,0.0,0.0
Andreea,pressone.ro,0,0,2,2,0.0,0.0
Cei,pressone.ro,0,0,1,1,0.0,0.0
Cristina,pressone.ro,0,1,1,2,-0.5,0.5
iubit,pressone.ro,0,1,1,2,-0.5,0.5
Larisa,pressone.ro,0,1,1,2,-0.5,0.5
Laura,pressone.ro,0,0,1,1,0.0,0.0
Marian,pressone.ro,0,0,1,1,0.0,0.0
Ovidiu,pressone.ro,0,0,1,1,0.0,0.0
cunoștință,pressone.ro,0,0,1,1,0.0,0.0
economistă,pressone.ro,1,0,0,1,1.0,1.0
pensionară,pressone.ro,0,1,0,1,-1.0,1.0
actor,www.euronews.ro,0,2,3,5,-0.4,0.4
sponsor,www.euronews.ro,0,0,1,1,0.0,0.0
Hunor Klemen,adevarul.ro,0,0,1,1,0.0,0.0
Ludovic,adevarul.ro,0,0,1,1,0.0,0.0
finanțator,adevarul.ro,0,1,2,3,-0.3333333333333333,0.3333333333333333
Sinaia,www.cotidianul.ro,0,0,1,1,0.0,0.0
Igor Grosu,www.gandul.ro,0,0,2,2,0.0,0.0
Barack Obama,stirileprotv.ro,0,0,1,1,0.0,0.0
Florentin Pandele,www.gandul.ro,0,0,1,1,0.0,0.0
Pandele,www.gandul.ro,0,2,1,3,-0.6666666666666666,0.6666666666666666
Victor Ciuctacu,www.gandul.ro,0,0,1,1,0.0,0.0
familia Pandele,www.gandul.ro,0,0,1,1,0.0,0.0
nevastă,www.gandul.ro,0,1,1,2,-0.5,0.5
Nicu Ștefănuță,www.news.ro,0,0,4,4,0.0,0.0
votant,www.news.ro,0,1,0,1,-1.0,1.0
salvator,www.news.ro,0,1,0,1,-1.0,1.0
Teodosie,a1.ro,0,1,0,1,-1.0,1.0
mediator,www.mediafax.ro,0,1,1,2,-0.5,0.5
Lumința Jivan,www.digi24.ro,1,0,0,1,1.0,1.0
Reșița,www.digi24.ro,0,1,0,1,-1.0,1.0
Ion Mocioalcă,www.digi24.ro,0,1,0,1,-1.0,1.0
Gorghiu,stirileprotv.ro,0,0,1,1,0.0,0.0
aripă,www.aktual24.ro,0,1,0,1,-1.0,1.0
pucist,www.aktual24.ro,0,1,0,1,-1.0,1.0
urmăritor,www.antena3.ro,0,1,0,1,-1.0,1.0
Farage,www.aktual24.ro,0,0,1,1,0.0,0.0
Gelbsey,www.aktual24.ro,0,0,1,1,0.0,0.0
Manchester,www.aktual24.ro,0,0,1,1,0.0,0.0
Sarah Pouchin,www.aktual24.ro,0,0,1,1,0.0,0.0
Gheorghe,www.b1tv.ro,0,0,1,1,0.0,0.0
extremist,www.b1tv.ro,0,1,0,1,-1.0,1.0
masă,adevarul.ro,0,2,1,3,-0.6666666666666666,0.6666666666666666
Ecaterina,www.romaniatv.net,0,1,0,1,-1.0,1.0
Ion,www.romaniatv.net,0,0,1,1,0.0,0.0
bătrân,a1.ro,0,1,1,2,-0.5,0.5
polițist,a1.ro,0,1,4,5,-0.2,0.2
individ,a1.ro,0,1,0,1,-1.0,1.0
locatar,primanews.ro,0,0,1,1,0.0,0.0
Dragoș Pătraru,www.gandul.ro,0,0,1,1,0.0,0.0
Tănase Stamule,www.gandul.ro,0,1,0,1,-1.0,1.0
realizator,www.gandul.ro,0,1,0,1,-1.0,1.0
Ervin Molnar,observatornews.ro,0,1,0,1,-1.0,1.0
Ovidiu Ianculescu,observatornews.ro,0,0,1,1,0.0,0.0
Ovidiu,observatornews.ro,0,1,0,1,-1.0,1.0
impostor,observatornews.ro,0,1,0,1,-1.0,1.0
profesionist,observatornews.ro,1,0,0,1,1.0,1.0
Lavinia Șandru,www.mediafax.ro,0,0,1,1,0.0,0.0
Radu Moldovan,www.mediafax.ro,0,0,1,1,0.0,0.0
Anamaria,www.romaniatv.net,0,1,0,1,-1.0,1.0
Hunor,www.euronews.ro,1,0,2,3,0.3333333333333333,0.3333333333333333
Horațiu Potra,adevarul.ro,0,1,2,3,-0.3333333333333333,0.3333333333333333
Potra,adevarul.ro,0,2,0,2,-1.0,1.0
Gâdea,adevarul.ro,0,1,0,1,-1.0,1.0
Lucian Bode,agerpres.ro,0,0,2,2,0.0,0.0
Codruța Kovesi,www.activenews.ro,0,1,0,1,-1.0,1.0
Kövesi,www.activenews.ro,0,1,0,1,-1.0,1.0
Laura Codruța Kövesi,www.activenews.ro,0,0,1,1,0.0,0.0
controlor,www.activenews.ro,0,1,0,1,-1.0,1.0
exponent,www.activenews.ro,0,1,0,1,-1.0,1.0
garant,www.activenews.ro,0,1,0,1,-1.0,1.0
om politic,www.activenews.ro,0,1,0,1,-1.0,1.0
Nicola,adevarul.ro,0,0,1,1,0.0,0.0
Slobodan Milošević,adevarul.ro,0,0,1,1,0.0,0.0
Iurie Roșca,pressone.ro,0,1,0,1,-1.0,1.0
Zelea Codreanu,pressone.ro,0,0,1,1,0.0,0.0
agitator,pressone.ro,0,1,0,1,-1.0,1.0
camarad,pressone.ro,1,0,0,1,1.0,1.0
neolegionar,pressone.ro,0,1,0,1,-1.0,1.0
Nicolae Ceaușescu,www.digi24.ro,0,0,1,1,0.0,0.0
Aleș,adevarul.ro,0,0,1,1,0.0,0.0
Eugen Durbacă,adevarul.ro,0,0,1,1,0.0,0.0
Ion Mocioalcă,adevarul.ro,0,0,1,1,0.0,0.0
Marian Oprișan,adevarul.ro,0,1,0,1,-1.0,1.0
Nini Săpunaru,adevarul.ro,0,1,0,1,-1.0,1.0
Reșița,adevarul.ro,0,0,1,1,0.0,0.0
Săpunaru,adevarul.ro,0,1,0,1,-1.0,1.0
Tania Bogdan,adevarul.ro,0,0,1,1,0.0,0.0
Dmitri Peskov,primanews.ro,0,0,2,2,0.0,0.0
Pavel Durov,primanews.ro,0,0,1,1,0.0,0.0
Mircea Fechet,www.mediafax.ro,0,0,1,1,0.0,0.0
Sighiartău,www.euronews.ro,0,0,1,1,0.0,0.0
favorit,www.euronews.ro,0,1,1,2,-0.5,0.5
vicepreședintele Robert Sighiartău,www.euronews.ro,0,0,2,2,0.0,0.0
Ioan Liviu Balint,www.mediafax.ro,0,0,2,2,0.0,0.0
Viktor Orbán,www.mediafax.ro,0,0,1,1,0.0,0.0
George Nicolae Simion,adevarul.ro,0,0,1,1,0.0,0.0
Victor Viorel Ponta,adevarul.ro,0,0,1,1,0.0,0.0
Lidia Tudor,adevarul.ro,0,0,2,2,0.0,0.0
Porumbacu,www.activenews.ro,0,1,0,1,-1.0,1.0
Marius Gheorghe Surgent,recorder.ro,0,0,1,1,0.0,0.0
Antonio Giordano,www.aktual24.ro,0,2,0,2,-1.0,1.0
Mugur Mihaescu,www.aktual24.ro,0,3,0,3,-1.0,1.0
cei,www.aktual24.ro,0,0,1,1,0.0,0.0
colegiu,www.aktual24.ro,0,1,0,1,-1.0,1.0
trumpist,www.aktual24.ro,0,1,0,1,-1.0,1.0
etic,www.euronews.ro,0,1,0,1,-1.0,1.0
Barna,stirileprotv.ro,0,0,1,1,0.0,0.0
Alexander Stubb,adevarul.ro,1,0,0,1,1.0,1.0
Miami,adevarul.ro,0,0,3,3,0.0,0.0
Miami Beach,adevarul.ro,0,0,2,2,0.0,0.0
Miami Bici,adevarul.ro,0,0,1,1,0.0,0.0
trimis,adevarul.ro,0,1,2,3,-0.3333333333333333,0.3333333333333333
Alfred Bulai,www.digi24.ro,0,0,1,1,0.0,0.0
Daniel Chițoiu,www.digi24.ro,0,1,0,1,-1.0,1.0
Gigel Știrbu,www.digi24.ro,1,0,0,1,1.0,1.0
Liviu Pop,www.digi24.ro,0,0,2,2,0.0,0.0
Maria Grapini,www.digi24.ro,0,2,1,3,-0.6666666666666666,0.6666666666666666
Remus Pricopie,www.digi24.ro,1,0,0,1,1.0,1.0
Traian Igaș,www.digi24.ro,0,1,1,2,-0.5,0.5
părinte,www.digi24.ro,2,0,1,3,0.6666666666666666,0.6666666666666666
Dorin Recean,www.euronews.ro,0,0,4,4,0.0,0.0
X,www.euronews.ro,0,0,1,1,0.0,0.0
Kelemen,www.g4media.ro,0,0,1,1,0.0,0.0
Andrii Yermak,www.aktual24.ro,0,0,1,1,0.0,0.0
Iugoslavia,www.aktual24.ro,0,0,1,1,0.0,0.0
Murmansk,www.aktual24.ro,0,0,1,1,0.0,0.0
Bulgaria,www.mediafax.ro,0,0,4,4,0.0,0.0
Marian Tutilescu,www.mediafax.ro,0,0,1,1,0.0,0.0
Tutilescu,www.mediafax.ro,0,0,1,1,0.0,0.0
secretar de stat,www.mediafax.ro,0,0,1,1,0.0,0.0
Alin Teodorescu,www.realitatea.net,0,0,1,1,0.0,0.0
Alina Mungiu,www.realitatea.net,0,0,1,1,0.0,0.0
Barack Obama,www.realitatea.net,0,0,1,1,0.0,0.0
Cristian Preda,www.realitatea.net,1,0,0,1,1.0,1.0
Renatte Webber,www.realitatea.net,0,0,1,1,0.0,0.0
aliat,www.realitatea.net,1,0,0,1,1.0,1.0
Florian Claudiu Neaga,recorder.ro,0,0,1,1,0.0,0.0
Florin Colgeag,recorder.ro,1,0,0,1,1.0,1.0
George Ilea,recorder.ro,0,0,1,1,0.0,0.0
Gheorghe Pop,recorder.ro,0,1,0,1,-1.0,1.0
Irina Kovacs,recorder.ro,0,0,1,1,0.0,0.0
Marius Șerban,recorder.ro,0,0,1,1,0.0,0.0
Seres Denes,recorder.ro,0,0,1,1,0.0,0.0
Seres Deneș,recorder.ro,0,0,1,1,0.0,0.0
Vasile Gheorghe Bulgărean,recorder.ro,0,0,1,1,0.0,0.0
Zală,recorder.ro,0,0,1,1,0.0,0.0
Constantin,www.mediafax.ro,0,0,5,5,0.0,0.0
Mihai Constantin,www.mediafax.ro,0,0,1,1,0.0,0.0
Israel,observatornews.ro,0,0,1,1,0.0,0.0
Mike Pompeo,observatornews.ro,0,1,1,2,-0.5,0.5
domnul Muraru,observatornews.ro,0,0,1,1,0.0,0.0
Trump,observatornews.ro,0,0,1,1,0.0,0.0
Muraru,observatornews.ro,0,1,0,1,-1.0,1.0
Elenei Lasconi,www.luju.ro,0,1,0,1,-1.0,1.0
OM,www.luju.ro,0,1,0,1,-1.0,1.0
procuror-șef,www.luju.ro,0,0,1,1,0.0,0.0
amândoi,observatornews.ro,0,1,1,2,-0.5,0.5
Robert Sighiartău,www.aktual24.ro,0,0,1,1,0.0,0.0
Eduard Șevardnadze,www.antena3.ro,0,0,1,1,0.0,0.0
Adolf Hitler,www.antena3.ro,0,1,0,1,-1.0,1.0
Jimmy Carter,www.antena3.ro,1,0,1,2,0.5,0.5
Stalin,www.antena3.ro,0,1,0,1,-1.0,1.0
criminal,www.antena3.ro,0,2,0,2,-1.0,1.0
dictator,www.antena3.ro,0,2,0,2,-1.0,1.0
român,www.aktual24.ro,1,0,1,2,0.5,0.5
contestatar,www.aktual24.ro,0,1,0,1,-1.0,1.0
exponent,www.aktual24.ro,0,2,0,2,-1.0,1.0
indecis,www.aktual24.ro,0,1,0,1,-1.0,1.0
Valentin Naumescu,www.aktual24.ro,0,0,1,1,0.0,0.0
populist,www.aktual24.ro,0,1,0,1,-1.0,1.0
Ana Hermina Iancu,www.comisarul.ro,0,0,1,1,0.0,0.0
Ana Maria Gavrilă,www.comisarul.ro,0,1,1,2,-0.5,0.5
Cristinel Grosu,www.comisarul.ro,0,0,1,1,0.0,0.0
Maricel Nechita,www.comisarul.ro,0,0,1,1,0.0,0.0
Mihaela Mîneran,www.comisarul.ro,0,0,1,1,0.0,0.0
Mihnea Tănase,www.comisarul.ro,0,0,1,1,0.0,0.0
Rector,www.comisarul.ro,0,0,1,1,0.0,0.0
Remus Pricopie,www.comisarul.ro,0,0,1,1,0.0,0.0
competitor,www.comisarul.ro,0,0,1,1,0.0,0.0
Cristi Danileț,www.comisarul.ro,0,1,2,3,-0.3333333333333333,0.3333333333333333
Mihai Gâdea,agerpres.ro,0,1,0,1,-1.0,1.0
Ariel Chiș,www.b1tv.ro,0,0,1,1,0.0,0.0
Peschir,www.luju.ro,0,0,1,1,0.0,0.0
polițist,www.luju.ro,0,1,0,1,-1.0,1.0
stegar,www.luju.ro,0,1,0,1,-1.0,1.0
jandarm,www.luju.ro,0,3,0,3,-1.0,1.0
protestatar,www.luju.ro,0,1,0,1,-1.0,1.0
Marcel,www.aktual24.ro,0,1,0,1,-1.0,1.0
Marcel de,www.aktual24.ro,0,1,0,1,-1.0,1.0
Paul Stănescu,www.aktual24.ro,0,1,1,2,-0.5,0.5
bolșevic,www.aktual24.ro,0,1,0,1,-1.0,1.0
ciolac,www.aktual24.ro,0,1,0,1,-1.0,1.0
Hunedoara,agerpres.ro,0,0,2,2,0.0,0.0
Iuliu Winkler,agerpres.ro,2,0,0,2,1.0,1.0
Petroșani,agerpres.ro,0,0,1,1,0.0,0.0
Sorin Blada,agerpres.ro,0,0,2,2,0.0,0.0
Alfred Simonis,snoop.ro,0,0,1,1,0.0,0.0
Bucium,snoop.ro,0,0,1,1,0.0,0.0
Buzău,snoop.ro,0,0,3,3,0.0,0.0
Caransebeș,snoop.ro,0,0,1,1,0.0,0.0
Constantin Toma,snoop.ro,0,0,1,1,0.0,0.0
Dacia,snoop.ro,0,0,1,1,0.0,0.0
Eminescu,snoop.ro,1,0,1,2,0.5,0.5
Felix Borcean,snoop.ro,0,0,1,1,0.0,0.0
Florin Salam,snoop.ro,0,1,0,1,-1.0,1.0
Gheorghe Colcear,snoop.ro,0,0,1,1,0.0,0.0
Guță,snoop.ro,0,1,0,1,-1.0,1.0
Hunedoara,snoop.ro,0,0,4,4,0.0,0.0
Ion Stepanescu,snoop.ro,0,0,2,2,0.0,0.0
Lia Lungu,snoop.ro,0,0,1,1,0.0,0.0
Nepal,snoop.ro,0,0,1,1,0.0,0.0
Nicoale Guță,snoop.ro,0,1,0,1,-1.0,1.0
Nicolae Guță,snoop.ro,0,0,1,1,0.0,0.0
Sarmizegetusa,snoop.ro,0,0,1,1,0.0,0.0
Sarmizegetusa Regia,snoop.ro,0,0,1,1,0.0,0.0
Stana Stepanescu,snoop.ro,0,1,0,1,-1.0,1.0
Stepanescu,snoop.ro,0,0,1,1,0.0,0.0
Ulpia,snoop.ro,0,0,1,1,0.0,0.0
Ulpia Traiana Sarmizegetusa,snoop.ro,0,0,1,1,0.0,0.0
Zamolxis,snoop.ro,0,0,1,1,0.0,0.0
artistă,snoop.ro,0,1,0,1,-1.0,1.0
camaraz,snoop.ro,0,1,0,1,-1.0,1.0
chelner,snoop.ro,0,1,0,1,-1.0,1.0
cântăreț,snoop.ro,0,1,0,1,-1.0,1.0
fan,snoop.ro,0,1,2,3,-0.3333333333333333,0.3333333333333333
interpret,snoop.ro,0,0,2,2,0.0,0.0
poliție,snoop.ro,0,1,0,1,-1.0,1.0
pro,snoop.ro,0,1,0,1,-1.0,1.0
Iancu cel Mare,www.b1tv.ro,0,0,1,1,0.0,0.0
Sprînceană,www.b1tv.ro,0,0,2,2,0.0,0.0
Vitor Ponta,www.b1tv.ro,0,1,0,1,-1.0,1.0
hobbit,www.romaniatv.net,1,0,0,1,1.0,1.0
Mordor,www.romaniatv.net,0,1,0,1,-1.0,1.0
Roșia Montana,www.romaniatv.net,0,1,0,1,-1.0,1.0
adept,www.romaniatv.net,0,0,1,1,0.0,0.0
ocupant,www.romaniatv.net,0,1,0,1,-1.0,1.0
Vasile Moise,a1.ro,0,1,0,1,-1.0,1.0
Aiud,stirileprotv.ro,0,1,0,1,-1.0,1.0
Augustin Lazăr,stirileprotv.ro,0,2,0,2,-1.0,1.0
Eugen Nicolicea,stirileprotv.ro,0,0,3,3,0.0,0.0
Ioan Muntean,stirileprotv.ro,0,0,2,2,0.0,0.0
Marin Iancu,stirileprotv.ro,0,1,2,3,-0.3333333333333333,0.3333333333333333
Lazar,stirileprotv.ro,0,0,1,1,0.0,0.0
Lazăr,stirileprotv.ro,0,1,0,1,-1.0,1.0
deținut politic,stirileprotv.ro,0,0,1,1,0.0,0.0
deținut,stirileprotv.ro,0,2,1,3,-0.6666666666666666,0.6666666666666666
dvs,stirileprotv.ro,0,1,0,1,-1.0,1.0
erou,stirileprotv.ro,2,0,0,2,1.0,1.0
procuror general,stirileprotv.ro,0,0,1,1,0.0,0.0
torționar,stirileprotv.ro,0,1,0,1,-1.0,1.0
Florin Cîțu,a1.ro,0,1,0,1,-1.0,1.0
Orban,a1.ro,0,0,3,3,0.0,0.0
miniștri,a1.ro,0,1,2,3,-0.3333333333333333,0.3333333333333333
abonat,recorder.ro,0,0,1,1,0.0,0.0
Anglia,www.aktual24.ro,0,1,0,1,-1.0,1.0
Carney,www.aktual24.ro,0,0,3,3,0.0,0.0
Draghi,www.aktual24.ro,0,0,1,1,0.0,0.0
George Osborne,www.aktual24.ro,0,0,1,1,0.0,0.0
Justin Trudeau,www.aktual24.ro,0,1,4,5,-0.2,0.2
Lescure,www.aktual24.ro,0,0,1,1,0.0,0.0
Marius,www.aktual24.ro,0,0,1,1,0.0,0.0
Mark Carney,www.aktual24.ro,0,0,3,3,0.0,0.0
Osborne,www.aktual24.ro,0,0,1,1,0.0,0.0
Pierre Poilievre,www.aktual24.ro,0,0,1,1,0.0,0.0
Roland Lescure,www.aktual24.ro,0,0,1,1,0.0,0.0
bancher,www.aktual24.ro,0,0,2,2,0.0,0.0
guvernator,www.aktual24.ro,0,0,3,3,0.0,0.0
outsider,www.aktual24.ro,0,0,1,1,0.0,0.0
străin,www.aktual24.ro,0,0,1,1,0.0,0.0
Dumbravă,www.cotidianul.ro,0,2,0,2,-1.0,1.0
NOI,www.cotidianul.ro,1,0,0,1,1.0,1.0
frate,www.cotidianul.ro,1,1,1,3,0.0,0.0
jefuitor,www.cotidianul.ro,0,1,0,1,-1.0,1.0
prieteni,www.cotidianul.ro,1,1,0,2,0.0,0.0
vânzător,www.cotidianul.ro,0,1,0,1,-1.0,1.0
Germania de Est,www.euronews.ro,0,0,1,1,0.0,0.0
Houthi,www.euronews.ro,0,1,0,1,-1.0,1.0
Lin Jian,www.euronews.ro,0,0,1,1,0.0,0.0
RDG,www.euronews.ro,0,0,1,1,0.0,0.0
Sanaa,www.euronews.ro,0,1,0,1,-1.0,1.0
Yemen,www.euronews.ro,0,2,0,2,-1.0,1.0
rebel,www.euronews.ro,0,1,0,1,-1.0,1.0
Codrin Ștefanescu,www.luju.ro,0,1,0,1,-1.0,1.0
incompetent,www.luju.ro,0,1,0,1,-1.0,1.0
L,www.luju.ro,0,2,0,2,-1.0,1.0
negociator,www.luju.ro,1,0,0,1,1.0,1.0
secretar general,www.luju.ro,0,1,2,3,-0.3333333333333333,0.3333333333333333
emisar,www.gandul.ro,0,1,0,1,-1.0,1.0
Alina Vasiliu,stirileprotv.ro,0,0,1,1,0.0,0.0
Felicia Ovanesian,stirileprotv.ro,0,0,1,1,0.0,0.0
Lazaroiu,stirileprotv.ro,0,1,0,1,-1.0,1.0
Marian Preda,stirileprotv.ro,0,0,1,1,0.0,0.0
Mihai Gartu,stirileprotv.ro,0,0,1,1,0.0,0.0
Sorin Popescu,stirileprotv.ro,0,0,1,1,0.0,0.0
domnie,stirileprotv.ro,0,0,1,1,0.0,0.0
fost,stirileprotv.ro,0,1,0,1,-1.0,1.0
Bragadiru,a1.ro,0,0,1,1,0.0,0.0
Camelia Opris,a1.ro,0,0,1,1,0.0,0.0
Dambovitei,a1.ro,0,0,1,1,0.0,0.0
Daniel Morar,a1.ro,0,1,0,1,-1.0,1.0
Eforie,a1.ro,0,0,1,1,0.0,0.0
Marcel Opris,a1.ro,0,1,2,3,-0.3333333333333333,0.3333333333333333
Nevasta,a1.ro,0,0,1,1,0.0,0.0
Opris,a1.ro,0,1,0,1,-1.0,1.0
Podu,a1.ro,0,0,1,1,0.0,0.0
familia Opris,a1.ro,0,1,0,1,-1.0,1.0
jurnalistă,a1.ro,0,0,2,2,0.0,0.0
mascat,a1.ro,0,1,0,1,-1.0,1.0
nevastă,a1.ro,0,0,1,1,0.0,0.0
salariat,a1.ro,0,0,1,1,0.0,0.0
Elene,adevarul.ro,0,2,0,2,-1.0,1.0
Oana Lasconi,adevarul.ro,0,1,2,3,-0.3333333333333333,0.3333333333333333
familia Lasconi,adevarul.ro,0,0,1,1,0.0,0.0
mame,adevarul.ro,0,1,1,2,-0.5,0.5
Adrian Baicu,snoop.ro,0,0,1,1,0.0,0.0
Adrian Cocoș,snoop.ro,0,0,1,1,0.0,0.0
Adrian Marian Cocoș,snoop.ro,0,0,1,1,0.0,0.0
Cocoș,snoop.ro,0,1,0,1,-1.0,1.0
Constantin Baicu,snoop.ro,0,0,1,1,0.0,0.0
Ioana Moldoveanu,snoop.ro,0,0,1,1,0.0,0.0
Ionuț Gabriel Crețoiu,snoop.ro,0,0,1,1,0.0,0.0
Negoiță,snoop.ro,0,0,1,1,0.0,0.0
tehnician,snoop.ro,0,0,2,2,0.0,0.0
Dumitru Buzatu,www.gandul.ro,0,0,1,1,0.0,0.0
Șerban Valeca,www.gandul.ro,0,0,2,2,0.0,0.0
Andy Ogles,www.gandul.ro,0,0,3,3,0.0,0.0
Anna Paulina Luna,www.gandul.ro,0,0,2,2,0.0,0.0
California,www.gandul.ro,0,0,3,3,0.0,0.0
Dina Titus,www.gandul.ro,0,0,3,3,0.0,0.0
Ilhan Omar,www.gandul.ro,0,0,3,3,0.0,0.0
Lloyd Doggett,www.gandul.ro,0,0,3,3,0.0,0.0
Minnesota,www.gandul.ro,0,0,3,3,0.0,0.0
Neal Dunn,www.gandul.ro,0,0,3,3,0.0,0.0
Nevada,www.gandul.ro,0,0,3,3,0.0,0.0
Ted Lieu,www.gandul.ro,0,0,3,3,0.0,0.0
Tennessee,www.gandul.ro,0,0,3,3,0.0,0.0
Texas,www.gandul.ro,0,0,3,3,0.0,0.0
Vern Buchanan,www.gandul.ro,1,0,2,3,0.3333333333333333,0.3333333333333333
Răzvan Ungureanu,adevarul.ro,0,0,1,1,0.0,0.0
Zelea Codreanu,adevarul.ro,0,2,0,2,-1.0,1.0
mareșal,adevarul.ro,0,0,1,1,0.0,0.0
Alexandrescu,adevarul.ro,0,0,1,1,0.0,0.0
Anca Alexandrescu,adevarul.ro,0,0,2,2,0.0,0.0
Ancăi Alexandrescu,adevarul.ro,0,0,1,1,0.0,0.0
Victor Ciutacu,adevarul.ro,0,0,1,1,0.0,0.0
jurnalistă,adevarul.ro,0,0,2,2,0.0,0.0
Alexandru Muraru,www.euronews.ro,1,0,2,3,0.3333333333333333,0.3333333333333333
Muraru,www.euronews.ro,0,0,1,1,0.0,0.0
extremist,www.euronews.ro,0,1,0,1,-1.0,1.0
Ciucu,www.digi24.ro,0,0,3,3,0.0,0.0
Aleksandar Vucic,www.antena3.ro,0,0,1,1,0.0,0.0
Cynthia Păun,www.comisarul.ro,0,0,1,1,0.0,0.0
Dumitru Dobrică,adevarul.ro,0,0,1,1,0.0,0.0
Hayssam,adevarul.ro,0,1,0,1,-1.0,1.0
Omar Hayssam,adevarul.ro,0,1,0,1,-1.0,1.0
Revoluționarul Ciolacu,adevarul.ro,0,1,0,1,-1.0,1.0
comandor,adevarul.ro,0,0,1,1,0.0,0.0
reformator,adevarul.ro,1,0,0,1,1.0,1.0
viceprimar,adevarul.ro,0,0,2,2,0.0,0.0
bisexual,www.realitatea.net,1,0,0,1,1.0,1.0
fiică,www.realitatea.net,0,0,2,2,0.0,0.0
Hexagon,www.realitatea.net,0,0,1,1,0.0,0.0
Jean-Luc Mélenchon,www.realitatea.net,0,0,1,1,0.0,0.0
Oana,www.realitatea.net,0,0,1,1,0.0,0.0
Oana Lasconi,www.realitatea.net,0,0,1,1,0.0,0.0
bunic,www.realitatea.net,1,0,1,2,0.5,0.5
mamă,www.realitatea.net,0,1,1,2,-0.5,0.5
susținătoare,www.realitatea.net,0,0,1,1,0.0,0.0
Dragoș Stanca,observatornews.ro,0,0,2,2,0.0,0.0
Septimius Pârvu,observatornews.ro,0,0,2,2,0.0,0.0
Cristian Danileț,observatornews.ro,0,0,1,1,0.0,0.0
Adrian Papahagi,observatornews.ro,0,0,1,1,0.0,0.0
Tăriceanu,www.b1tv.ro,0,0,1,1,0.0,0.0
președintă,www.b1tv.ro,0,0,1,1,0.0,0.0
nene,www.b1tv.ro,0,0,1,1,0.0,0.0
Baneasa,a1.ro,0,0,1,1,0.0,0.0
Brazilia,a1.ro,0,0,1,1,0.0,0.0
Indonezia,a1.ro,0,0,1,1,0.0,0.0
Ioana,a1.ro,0,0,1,1,0.0,0.0
Mihaileanu,a1.ro,0,1,0,1,-1.0,1.0
Diana Buzoianu,adevarul.ro,0,0,1,1,0.0,0.0
Andrei Rus,www.luju.ro,0,0,1,1,0.0,0.0
Banicioiu,www.luju.ro,0,0,1,1,0.0,0.0
Dorin Cocos,www.luju.ro,0,0,1,1,0.0,0.0
Marian Dragulescu,www.luju.ro,0,1,0,1,-1.0,1.0
Nicolae Banicioiu,www.luju.ro,0,1,0,1,-1.0,1.0
director,www.luju.ro,0,1,3,4,-0.25,0.25
manager,www.luju.ro,0,0,1,1,0.0,0.0
Leontin Horațiu Iuhas,www.digi24.ro,0,1,0,1,-1.0,1.0
regi,www.digi24.ro,1,0,0,1,1.0,1.0
Cristi Dănileț,adevarul.ro,0,0,2,2,0.0,0.0
Hari Bucur Marcu,adevarul.ro,0,0,1,1,0.0,0.0
Ariadna Cîrligeanu,recorder.ro,0,1,0,1,-1.0,1.0
Buzatu,recorder.ro,0,2,1,3,-0.6666666666666666,0.6666666666666666
Dumitru Buzatu,recorder.ro,0,0,2,2,0.0,0.0
Dumitru Manea,recorder.ro,0,0,1,1,0.0,0.0
extremist,recorder.ro,0,1,0,1,-1.0,1.0
Miron Manega,recorder.ro,0,0,1,1,0.0,0.0
Nae Ionescu,recorder.ro,0,1,0,1,-1.0,1.0
Radu Judele,recorder.ro,0,0,1,1,0.0,0.0
criminal,recorder.ro,0,2,0,2,-1.0,1.0
Tăriceanu,www.gandul.ro,0,1,1,2,-0.5,0.5
urmaș,www.gandul.ro,0,1,0,1,-1.0,1.0
Ăștia,www.gandul.ro,0,1,0,1,-1.0,1.0
Piatra Neamț,www.b1tv.ro,0,0,1,1,0.0,0.0
contribuabil,agerpres.ro,0,0,1,1,0.0,0.0
Peiu,agerpres.ro,0,0,2,2,0.0,0.0
Traian Timiș,pressone.ro,0,0,1,1,0.0,0.0
Camelia Bogdan,www.gandul.ro,0,1,0,1,-1.0,1.0
Daniel Constantin,www.gandul.ro,0,1,0,1,-1.0,1.0
Emilian Eva,www.gandul.ro,0,1,0,1,-1.0,1.0
Clement Sava,adevarul.ro,0,0,1,1,0.0,0.0
Ștefănuță,www.news.ro,0,0,1,1,0.0,0.0
Andy Ogles,www.mediafax.ro,0,0,1,1,0.0,0.0
Anna Paulina Luna,www.mediafax.ro,0,0,1,1,0.0,0.0
Ilhan Omar,www.mediafax.ro,0,0,1,1,0.0,0.0
Lloyd Doggett,www.mediafax.ro,0,0,1,1,0.0,0.0
Neal Dunn,www.mediafax.ro,0,0,1,1,0.0,0.0
Ted Lieu,www.mediafax.ro,0,0,1,1,0.0,0.0
Vern Buchanan,www.mediafax.ro,0,0,2,2,0.0,0.0
Mihai Gâdea,adevarul.ro,0,0,1,1,0.0,0.0
Mirabela,adevarul.ro,0,0,1,1,0.0,0.0
Soacra,adevarul.ro,0,1,0,1,-1.0,1.0
ginere,adevarul.ro,0,0,1,1,0.0,0.0
soacră,adevarul.ro,0,1,0,1,-1.0,1.0
Antonio Andrusceac,www.cotidianul.ro,0,0,1,1,0.0,0.0
Bistrița,www.cotidianul.ro,0,0,1,1,0.0,0.0
Dan Diaconescu,www.cotidianul.ro,0,1,0,1,-1.0,1.0
artizan,www.cotidianul.ro,0,2,0,2,-1.0,1.0
interlop,www.cotidianul.ro,0,1,0,1,-1.0,1.0
ultras,www.cotidianul.ro,0,1,0,1,-1.0,1.0
țepări,www.cotidianul.ro,0,1,0,1,-1.0,1.0
Viorel Morărescu,agerpres.ro,0,0,2,2,0.0,0.0
generație,agerpres.ro,1,0,1,2,0.5,0.5
operator,agerpres.ro,0,0,2,2,0.0,0.0
student,agerpres.ro,0,0,1,1,0.0,0.0
capitală,www.aktual24.ro,0,3,2,5,-0.6,0.6
Liviu Spataru,www.aktual24.ro,0,0,1,1,0.0,0.0
Sorin Frunzaverde,www.aktual24.ro,0,0,1,1,0.0,0.0
Spataru,www.aktual24.ro,0,0,1,1,0.0,0.0
Viktor Orbán,www.news.ro,0,0,1,1,0.0,0.0
Ungarie,www.news.ro,0,0,2,2,0.0,0.0
Viktor Orban,www.news.ro,1,0,1,2,0.5,0.5
Mircia Muntean,adevarul.ro,0,0,1,1,0.0,0.0
Moș Nicolae,adevarul.ro,1,0,0,1,1.0,1.0
locatar,adevarul.ro,0,1,0,1,-1.0,1.0
Toader,www.mediafax.ro,0,0,1,1,0.0,0.0
Cracovia,www.g4media.ro,0,0,1,1,0.0,0.0
Gavrilă,www.g4media.ro,0,0,1,1,0.0,0.0
Regensburg,www.g4media.ro,0,0,1,1,0.0,0.0
Sydney,www.g4media.ro,0,0,1,1,0.0,0.0
Ursula von der Leyen,www.g4media.ro,0,0,1,1,0.0,0.0
aței,www.g4media.ro,0,1,0,1,-1.0,1.0
suporter,www.g4media.ro,0,1,0,1,-1.0,1.0
campioană,www.luju.ro,1,0,1,2,0.5,0.5
Ciungan,www.luju.ro,0,1,0,1,-1.0,1.0
Georgeta Ciungan,www.luju.ro,0,3,0,3,-1.0,1.0
Seul,www.luju.ro,0,0,1,1,0.0,0.0
vicecampioană,www.luju.ro,0,0,1,1,0.0,0.0
Eugen Terente,agerpres.ro,0,0,1,1,0.0,0.0
Luisiana Bîgea,agerpres.ro,0,0,1,1,0.0,0.0
Tulcea,agerpres.ro,0,0,1,1,0.0,0.0
urmăritor,www.luju.ro,0,1,0,1,-1.0,1.0
evazioniști,www.gandul.ro,0,3,0,3,-1.0,1.0
traficant,www.gandul.ro,0,2,0,2,-1.0,1.0
Carmen,www.romaniatv.net,0,0,1,1,0.0,0.0
Carmen Iohannis,www.romaniatv.net,0,0,1,1,0.0,0.0
Balotești,adevarul.ro,0,0,1,1,0.0,0.0
Bihor,adevarul.ro,0,0,5,5,0.0,0.0
Bolduț,adevarul.ro,0,1,0,1,-1.0,1.0
Ciprian Ciubuc,adevarul.ro,0,1,0,1,-1.0,1.0
Dan Motreanu,adevarul.ro,0,0,5,5,0.0,0.0
David Popovici,adevarul.ro,0,0,1,1,0.0,0.0
Elena Lansconi,adevarul.ro,0,0,1,1,0.0,0.0
Florian Coldea,adevarul.ro,0,2,0,2,-1.0,1.0
Harghita,adevarul.ro,0,1,1,2,-0.5,0.5
Lucian Bode,adevarul.ro,0,0,2,2,0.0,0.0
Mischii,adevarul.ro,0,0,1,1,0.0,0.0
Nicoale Ciucă,adevarul.ro,0,0,2,2,0.0,0.0
Patriarh Daniel,adevarul.ro,0,0,1,1,0.0,0.0
Rogova,adevarul.ro,0,0,1,1,0.0,0.0
Răcăciuni,adevarul.ro,0,1,0,1,-1.0,1.0
sportiv,adevarul.ro,0,0,2,2,0.0,0.0
Timiș,adevarul.ro,0,0,4,4,0.0,0.0
Torino,adevarul.ro,0,1,0,1,-1.0,1.0
alien,adevarul.ro,0,1,0,1,-1.0,1.0
cadru militar,adevarul.ro,0,0,1,1,0.0,0.0
campion,adevarul.ro,1,0,0,1,1.0,1.0
conațional,adevarul.ro,1,0,0,1,1.0,1.0
debil,adevarul.ro,0,1,0,1,-1.0,1.0
însoțitor,adevarul.ro,0,1,3,4,-0.25,0.25
Italia,primanews.ro,0,0,5,5,0.0,0.0
Matteo Salvini,primanews.ro,0,0,1,1,0.0,0.0
Meloni,primanews.ro,0,0,2,2,0.0,0.0
Alberto Papuzzi,snoop.ro,0,0,1,1,0.0,0.0
Brazilia,snoop.ro,0,0,1,1,0.0,0.0
Coda,snoop.ro,0,1,0,1,-1.0,1.0
Giorgio Coda,snoop.ro,0,0,1,1,0.0,0.0
Olanda de Nord,snoop.ro,0,0,1,1,0.0,0.0
Rene Keet,snoop.ro,0,0,1,1,0.0,0.0
Scoția,snoop.ro,1,0,0,1,1.0,1.0
Trieste,snoop.ro,1,0,0,1,1.0,1.0
adolescent,snoop.ro,0,1,7,8,-0.125,0.125
dr. Keet,snoop.ro,1,0,0,1,1.0,1.0
medic specialist,snoop.ro,0,0,1,1,0.0,0.0
minor,snoop.ro,0,3,6,9,-0.3333333333333333,0.3333333333333333
tuturor,snoop.ro,1,0,0,1,1.0,1.0
David,agerpres.ro,0,0,2,2,0.0,0.0
Mircea Coșea,www.antena3.ro,0,1,0,1,-1.0,1.0
dansator,www.antena3.ro,0,1,1,2,-0.5,0.5
Ana Ciceală,recorder.ro,0,1,1,2,-0.5,0.5
Ionuț Negoiță,recorder.ro,0,1,0,1,-1.0,1.0
Lucian Judele,recorder.ro,0,1,0,1,-1.0,1.0
Marius Ciobîcă,recorder.ro,0,1,0,1,-1.0,1.0
Mugur Ciuvică,recorder.ro,0,1,1,2,-0.5,0.5
Negoiță,recorder.ro,0,2,0,2,-1.0,1.0
primar general,recorder.ro,0,2,0,2,-1.0,1.0
Sorina Docuz,recorder.ro,0,1,0,1,-1.0,1.0
stăpân,recorder.ro,0,4,0,4,-1.0,1.0
frații Negoiță,recorder.ro,0,1,0,1,-1.0,1.0
Adrian Moraru,recorder.ro,0,0,1,1,0.0,0.0
Anca Alexandrescu,stirileprotv.ro,1,0,1,2,0.5,0.5
Dan Puric,stirileprotv.ro,0,0,1,1,0.0,0.0
Hunor,stirileprotv.ro,0,0,1,1,0.0,0.0
public,stirileprotv.ro,1,0,1,2,0.5,0.5
suveranist,stirileprotv.ro,0,1,0,1,-1.0,1.0
Attila Cseke,a1.ro,0,0,1,1,0.0,0.0
Ladislau,a1.ro,0,1,0,1,-1.0,1.0
Ritli Ladislau,a1.ro,1,0,3,4,0.25,0.25
Ridli Ladislau,a1.ro,0,0,1,1,0.0,0.0
băiat,a1.ro,0,0,2,2,0.0,0.0
bebeluș,a1.ro,0,0,1,1,0.0,0.0
bolnav,a1.ro,0,0,1,1,0.0,0.0
Cseke Attila,a1.ro,0,0,1,1,0.0,0.0
predecesor,a1.ro,0,0,1,1,0.0,0.0
tatăl,a1.ro,0,0,1,1,0.0,0.0
Câmpulung,www.euronews.ro,0,0,2,2,0.0,0.0
eurodeputat,www.euronews.ro,0,1,2,3,-0.3333333333333333,0.3333333333333333
prezentator,primanews.ro,0,0,3,3,0.0,0.0
Agrigoroae,pressone.ro,0,1,0,1,-1.0,1.0
Anton Marin,pressone.ro,0,0,1,1,0.0,0.0
Dinu Pescariu,pressone.ro,0,1,0,1,-1.0,1.0
Gabriel Berca,pressone.ro,0,1,0,1,-1.0,1.0
Ionel Agrigoroaei,pressone.ro,0,2,0,2,-1.0,1.0
Lucian Iliescu,pressone.ro,0,2,0,2,-1.0,1.0
Mario Caloianu,pressone.ro,0,0,1,1,0.0,0.0
Marius Isăilă,pressone.ro,0,1,0,1,-1.0,1.0
Onești,pressone.ro,1,0,0,1,1.0,1.0
Cristian Pârvulescu,pressone.ro,0,0,1,1,0.0,0.0
Pârvulescu,pressone.ro,0,0,1,1,0.0,0.0
sport,pressone.ro,0,0,1,1,0.0,0.0
Titi Holban,pressone.ro,0,1,1,2,-0.5,0.5
Valerian Vreme,pressone.ro,0,1,0,1,-1.0,1.0
Monica Iacob Ridzi,pressone.ro,0,1,0,1,-1.0,1.0
turnător,pressone.ro,0,2,0,2,-1.0,1.0
Viktor Orbán,www.euronews.ro,0,0,7,7,0.0,0.0
emisar,www.euronews.ro,0,1,2,3,-0.3333333333333333,0.3333333333333333
Alba,adevarul.ro,0,0,2,2,0.0,0.0
Brazi,adevarul.ro,0,1,0,1,-1.0,1.0
Coteana,adevarul.ro,0,0,1,1,0.0,0.0
Cugir,adevarul.ro,0,0,1,1,0.0,0.0
Făget,adevarul.ro,0,0,1,1,0.0,0.0
Mihăești,adevarul.ro,0,0,1,1,0.0,0.0
Vâlcea,adevarul.ro,0,0,2,2,0.0,0.0
cumpărător,adevarul.ro,0,0,1,1,0.0,0.0
vânzătoare,adevarul.ro,0,1,0,1,-1.0,1.0
Șibot,adevarul.ro,0,0,1,1,0.0,0.0
solicitant,www.aktual24.ro,0,0,1,1,0.0,0.0
Vlad Gheorghe,www.aktual24.ro,0,0,5,5,0.0,0.0
Aheea,www.comisarul.ro,0,1,1,2,-0.5,0.5
Antim,www.comisarul.ro,0,0,1,1,0.0,0.0
Mirabela Grădinaru,www.comisarul.ro,0,0,2,2,0.0,0.0
agent,www.comisarul.ro,0,2,2,4,-0.5,0.5
fetiță,www.comisarul.ro,0,1,2,3,-0.3333333333333333,0.3333333333333333
Andreea Esca,www.luju.ro,0,0,1,1,0.0,0.0
Ben-Oni Ardelean,www.luju.ro,0,0,1,1,0.0,0.0
Ben Oni Ardelean,www.luju.ro,0,0,1,1,0.0,0.0
Lucian Davidescu,www.luju.ro,0,1,1,2,-0.5,0.5
Durham,www.comisarul.ro,0,0,1,1,0.0,0.0
Farage,www.comisarul.ro,0,0,1,1,0.0,0.0
Keir Starmer,www.comisarul.ro,0,0,1,1,0.0,0.0
Kemi Badenoch,www.comisarul.ro,0,0,1,1,0.0,0.0
Luke Tryl,www.comisarul.ro,0,0,1,1,0.0,0.0
Midlands,www.comisarul.ro,0,0,1,1,0.0,0.0
Nigel Farage,www.comisarul.ro,0,1,0,1,-1.0,1.0
laburist,www.comisarul.ro,0,1,0,1,-1.0,1.0
Anita Anand,www.cotidianul.ro,0,0,1,1,0.0,0.0
Canada,www.cotidianul.ro,0,1,0,1,-1.0,1.0
Canadei,www.cotidianul.ro,0,1,0,1,-1.0,1.0
Carney,www.cotidianul.ro,0,0,1,1,0.0,0.0
Dominic LeBlanc,www.cotidianul.ro,0,0,1,1,0.0,0.0
Justin Trudeau,www.cotidianul.ro,0,1,0,1,-1.0,1.0
Mark Carney,www.cotidianul.ro,0,0,1,1,0.0,0.0
Melanie Joly,www.cotidianul.ro,0,0,1,1,0.0,0.0
Ottawa,www.cotidianul.ro,0,0,1,1,0.0,0.0
Washington,www.cotidianul.ro,0,1,1,2,-0.5,0.5
bancher,www.cotidianul.ro,0,0,2,2,0.0,0.0
Tim Hodgson,www.cotidianul.ro,0,0,1,1,0.0,0.0
Dancila,www.aktual24.ro,0,1,2,3,-0.3333333333333333,0.3333333333333333
Carmen Dan,recorder.ro,1,1,0,2,0.0,0.0
Dumbrăveni,recorder.ro,0,0,1,1,0.0,0.0
Gheorghe Hagi,recorder.ro,0,0,1,1,0.0,0.0
Moga,recorder.ro,0,2,0,2,-1.0,1.0
Nicolae Moga,recorder.ro,0,1,0,1,-1.0,1.0
Urlaia,recorder.ro,0,1,0,1,-1.0,1.0
constănțean,recorder.ro,0,0,1,1,0.0,0.0
fotbalist,recorder.ro,1,0,1,2,0.5,0.5
Adrian Bogdan,www.g4media.ro,0,0,1,1,0.0,0.0
Amândoi,www.g4media.ro,0,1,0,1,-1.0,1.0
Beniamin Todosiu,www.g4media.ro,0,0,1,1,0.0,0.0
Breaz,www.g4media.ro,0,0,1,1,0.0,0.0
Călin Matieș,www.g4media.ro,0,0,3,3,0.0,0.0
Dana Nanu,www.g4media.ro,0,0,1,1,0.0,0.0
Alin Ignat,www.g4media.ro,0,1,1,2,-0.5,0.5
Matieș,www.g4media.ro,0,0,1,1,0.0,0.0
Pleșa,www.g4media.ro,0,0,1,1,0.0,0.0
Gabriel Pleșa,www.g4media.ro,0,0,1,1,0.0,0.0
Todosiu,www.g4media.ro,0,1,0,1,-1.0,1.0
cadru,www.g4media.ro,0,1,0,1,-1.0,1.0
fundaș,pressone.ro,0,0,1,1,0.0,0.0
rabin,pressone.ro,0,1,0,1,-1.0,1.0
urs,pressone.ro,0,1,0,1,-1.0,1.0
Dan Nica,agerpres.ro,0,0,2,2,0.0,0.0
Ecaterina Ignat,agerpres.ro,0,0,2,2,0.0,0.0
Anatol Șalaru,www.euronews.ro,0,0,1,1,0.0,0.0
Cernăuți,www.euronews.ro,0,0,1,1,0.0,0.0
Francisc Tobă,www.euronews.ro,0,1,0,1,-1.0,1.0
Fălticeni,www.euronews.ro,0,0,1,1,0.0,0.0
Gheorghe Piperea,www.euronews.ro,0,0,2,2,0.0,0.0
Marian Enache,www.euronews.ro,0,0,1,1,0.0,0.0
Nicolae Roman,www.euronews.ro,0,1,0,1,-1.0,1.0
Piperea,www.euronews.ro,0,0,1,1,0.0,0.0
Târziu,www.euronews.ro,0,0,1,1,0.0,0.0
Valea Uzului,www.euronews.ro,0,0,1,1,0.0,0.0
Viktor Ianukovici,www.euronews.ro,0,1,0,1,-1.0,1.0
activist,www.euronews.ro,0,1,0,1,-1.0,1.0
cofondator,www.euronews.ro,0,0,1,1,0.0,0.0
militar,www.euronews.ro,0,1,0,1,-1.0,1.0
ofițer,www.euronews.ro,0,1,1,2,-0.5,0.5
profesor universitar,www.euronews.ro,0,0,1,1,0.0,0.0
Adina Valean,pressone.ro,0,0,1,1,0.0,0.0
Costea,pressone.ro,0,0,1,1,0.0,0.0
Daniel Buda,pressone.ro,0,0,8,8,0.0,0.0
Daniel Motreanu,pressone.ro,0,0,1,1,0.0,0.0
George Horia Szabo,pressone.ro,0,0,1,1,0.0,0.0
Gheorghe Florin Cârciu,pressone.ro,0,0,1,1,0.0,0.0
Gunther Krichbaum,pressone.ro,0,0,1,1,0.0,0.0
Petru Costea,pressone.ro,0,1,0,1,-1.0,1.0
Peter Costea,pressone.ro,0,1,0,1,-1.0,1.0
Simion Sebastian Tataru,pressone.ro,0,0,2,2,0.0,0.0
Soții Buda,pressone.ro,0,0,1,1,0.0,0.0
Sturdza,pressone.ro,0,0,1,1,0.0,0.0
colegiu,pressone.ro,0,1,2,3,-0.3333333333333333,0.3333333333333333
necredincios,pressone.ro,0,1,0,1,-1.0,1.0
pionier,pressone.ro,0,1,0,1,-1.0,1.0
secularist,pressone.ro,0,1,0,1,-1.0,1.0
Șerban Sturdza,pressone.ro,0,0,1,1,0.0,0.0
Bogdan Gavrilescu,recorder.ro,0,0,1,1,0.0,0.0
Bogdan Olteanu,recorder.ro,0,0,1,1,0.0,0.0
Bogdan Tohăneanu,recorder.ro,0,0,1,1,0.0,0.0
Capul Verde,recorder.ro,0,0,1,1,0.0,0.0
Creangă,recorder.ro,1,0,0,1,1.0,1.0
Cristina Năsoi,recorder.ro,0,0,1,1,0.0,0.0
Daniel Popa,recorder.ro,0,0,1,1,0.0,0.0
Eforie,recorder.ro,0,0,1,1,0.0,0.0
Eugen Țapu Nazare,recorder.ro,0,0,1,1,0.0,0.0
Ionel Arsene,recorder.ro,1,0,0,1,1.0,1.0
Islanda,recorder.ro,0,0,1,1,0.0,0.0
Iulian Bulai,recorder.ro,0,0,1,1,0.0,0.0
Mara Calista,recorder.ro,0,0,1,1,0.0,0.0
Mihai Precup,recorder.ro,0,0,1,1,0.0,0.0
Mihail Manoilescu,recorder.ro,0,0,1,1,0.0,0.0
Miron Costin,recorder.ro,0,0,1,1,0.0,0.0
Oana Bulai,recorder.ro,0,0,1,1,0.0,0.0
Pașcani,recorder.ro,0,0,1,1,0.0,0.0
Ploiești,recorder.ro,0,0,3,3,0.0,0.0
Răzvan Cuc,recorder.ro,0,0,1,1,0.0,0.0
Siret,recorder.ro,0,0,1,1,0.0,0.0
Săvinești,recorder.ro,1,0,1,2,0.5,0.5
Târgu Neamț,recorder.ro,0,1,0,1,-1.0,1.0
colegiu,recorder.ro,1,0,0,1,1.0,1.0
Ciprian Constantin Șerban,recorder.ro,0,0,1,1,0.0,0.0
ființă umană,recorder.ro,0,1,0,1,-1.0,1.0
lor,recorder.ro,0,2,0,2,-1.0,1.0
el,recorder.ro,1,0,0,1,1.0,1.0
masterandă,recorder.ro,0,0,1,1,0.0,0.0
nemțean,recorder.ro,0,6,0,6,-1.0,1.0
Cirstoiu,www.aktual24.ro,0,0,2,2,0.0,0.0
Iran,www.aktual24.ro,0,1,2,3,-0.3333333333333333,0.3333333333333333
Nehoiu,www.aktual24.ro,0,1,0,1,-1.0,1.0
Tianu Burduja,www.aktual24.ro,0,0,1,1,0.0,0.0
bucureștean,www.aktual24.ro,0,1,0,1,-1.0,1.0
Albania,www.euronews.ro,0,0,1,1,0.0,0.0
Coreea de Nord,www.euronews.ro,0,1,0,1,-1.0,1.0
Seul,www.euronews.ro,0,0,1,1,0.0,0.0
Thailanda,www.euronews.ro,0,0,1,1,0.0,0.0
Zanzibar,www.euronews.ro,0,0,1,1,0.0,0.0
soldat,www.euronews.ro,0,1,1,2,-0.5,0.5
X,primanews.ro,0,0,1,1,0.0,0.0
Ciprian Paraschiv,www.g4media.ro,0,0,1,1,0.0,0.0
Cristian Ivănuță,www.g4media.ro,0,0,1,1,0.0,0.0
Mihai Albișteanu,www.g4media.ro,0,0,1,1,0.0,0.0
Paraschiv,www.g4media.ro,0,0,1,1,0.0,0.0
căpitan,www.g4media.ro,0,0,1,1,0.0,0.0
Silviu Gurlui,www.g4media.ro,0,0,1,1,0.0,0.0
Aleșd,snoop.ro,0,1,0,1,-1.0,1.0
apropiați,snoop.ro,0,0,1,1,0.0,0.0
Babiuc,snoop.ro,0,0,1,1,0.0,0.0
Băneasa,snoop.ro,0,0,2,2,0.0,0.0
Cătălin Zisu,snoop.ro,0,1,2,3,-0.3333333333333333,0.3333333333333333
Ion Iliescu,snoop.ro,0,0,4,4,0.0,0.0
Ion Olteanu,snoop.ro,0,1,0,1,-1.0,1.0
Iosif Robi Urs,snoop.ro,0,1,0,1,-1.0,1.0
Iosif Urs,snoop.ro,0,0,1,1,0.0,0.0
Katia Cicală,snoop.ro,0,0,1,1,0.0,0.0
Maiorescu,snoop.ro,0,0,1,1,0.0,0.0
Mihai Olaru,snoop.ro,0,0,2,2,0.0,0.0
Mircea Drăgoi,snoop.ro,0,0,1,1,0.0,0.0
ofițer superior,snoop.ro,0,1,0,1,-1.0,1.0
Olteanu,snoop.ro,0,1,0,1,-1.0,1.0
Pipera,snoop.ro,0,0,1,1,0.0,0.0
Roberta Vornicu,snoop.ro,0,0,1,1,0.0,0.0
Roxana,snoop.ro,0,1,1,2,-0.5,0.5
Sorin Frunzăverde,snoop.ro,0,0,4,4,0.0,0.0
Venus,snoop.ro,0,0,1,1,0.0,0.0
Victor Babiuc,snoop.ro,0,0,1,1,0.0,0.0
Zisu,snoop.ro,0,1,1,2,-0.5,0.5
Zisu Jr,snoop.ro,0,1,0,1,-1.0,1.0
cadru militar,snoop.ro,0,0,1,1,0.0,0.0
comandat,snoop.ro,0,1,0,1,-1.0,1.0
căpitan,snoop.ro,0,0,1,1,0.0,0.0
funcționar,snoop.ro,0,3,0,3,-1.0,1.0
funcționar public,snoop.ro,0,1,0,1,-1.0,1.0
gastroenterolog,snoop.ro,0,0,1,1,0.0,0.0
general,snoop.ro,0,2,3,5,-0.4,0.4
Cătălin Ștefăniță Zisu,snoop.ro,0,0,1,1,0.0,0.0
general Zisu,snoop.ro,0,0,1,1,0.0,0.0
grefier,snoop.ro,0,1,0,1,-1.0,1.0
Alina Grigore,snoop.ro,0,0,1,1,0.0,0.0
locotenent,snoop.ro,0,0,1,1,0.0,0.0
locotenent-colonel,snoop.ro,0,0,1,1,0.0,0.0
locotenent major,snoop.ro,0,0,1,1,0.0,0.0
maior,snoop.ro,0,0,1,1,0.0,0.0
militar,snoop.ro,0,2,1,3,-0.6666666666666666,0.6666666666666666
Ștefan,snoop.ro,0,0,1,1,0.0,0.0
Ștefan Olteanu,snoop.ro,0,0,1,1,0.0,0.0
Ștefan Zisu,snoop.ro,0,0,2,2,0.0,0.0
Belarus,www.mediafax.ro,0,0,2,2,0.0,0.0
Evan Neumann,www.mediafax.ro,0,0,1,1,0.0,0.0
Neumann,www.mediafax.ro,0,0,1,1,0.0,0.0
om al legii,www.mediafax.ro,0,1,0,1,-1.0,1.0
Firea,recorder.ro,0,1,2,3,-0.3333333333333333,0.3333333333333333
Godei,recorder.ro,0,1,0,1,-1.0,1.0
Ligia Gheorghe,recorder.ro,0,1,0,1,-1.0,1.0
Mugur Isărescu,recorder.ro,0,1,0,1,-1.0,1.0
Simona Halep,recorder.ro,0,1,0,1,-1.0,1.0
familia Voiculescu,recorder.ro,0,1,1,2,-0.5,0.5
Ștefan,recorder.ro,0,1,1,2,-0.5,0.5
analist politic,stirileprotv.ro,0,0,1,1,0.0,0.0
Chirilă,www.aktual24.ro,0,0,1,1,0.0,0.0
Mordor,www.aktual24.ro,0,1,0,1,-1.0,1.0
Tudor Chirila,www.aktual24.ro,0,0,1,1,0.0,0.0
adept,www.aktual24.ro,0,1,0,1,-1.0,1.0
cantautor,www.aktual24.ro,0,0,1,1,0.0,0.0
etic,www.g4media.ro,0,0,1,1,0.0,0.0
juriști,www.news.ro,0,1,0,1,-1.0,1.0
Moise Guran,www.gandul.ro,0,0,1,1,0.0,0.0
Vlad Petreanu,www.gandul.ro,0,0,1,1,0.0,0.0
funcționar,agerpres.ro,0,1,0,1,-1.0,1.0
medic,agerpres.ro,0,1,2,3,-0.3333333333333333,0.3333333333333333
Ana Birchall,www.news.ro,0,0,3,3,0.0,0.0
Anei Birchall,www.news.ro,0,0,1,1,0.0,0.0
Birchall,www.news.ro,0,0,1,1,0.0,0.0
Hong Kong,www.news.ro,0,0,1,1,0.0,0.0
Prahova,www.news.ro,0,0,1,1,0.0,0.0
proprietar,www.news.ro,0,0,1,1,0.0,0.0
Sfântul Andrei,www.digi24.ro,0,0,1,1,0.0,0.0
amândoi,www.digi24.ro,1,0,1,2,0.5,0.5
Austria,stirileprotv.ro,0,2,2,4,-0.5,0.5
Alexandr Stoianoglo,adevarul.ro,0,0,1,1,0.0,0.0
Maia Sandu,adevarul.ro,0,2,4,6,-0.3333333333333333,0.3333333333333333
Argeș,www.antena3.ro,0,0,1,1,0.0,0.0
bunic,www.antena3.ro,1,0,0,1,1.0,1.0
Carolina de Sud,www.antena3.ro,0,0,1,1,0.0,0.0
McCormick,www.antena3.ro,0,0,1,1,0.0,0.0
Roman,www.antena3.ro,0,0,1,1,0.0,0.0
antreprenor,www.antena3.ro,0,0,3,3,0.0,0.0
mame,www.antena3.ro,1,0,0,1,1.0,1.0
proprietar,www.antena3.ro,0,0,1,1,0.0,0.0
Sebastian Lăzăroiu,recorder.ro,0,0,2,2,0.0,0.0
sociolog,recorder.ro,0,1,3,4,-0.25,0.25
Dvs,www.news.ro,0,0,1,1,0.0,0.0
populație,www.news.ro,0,0,2,2,0.0,0.0
Emi Boc,www.digi24.ro,0,0,1,1,0.0,0.0
prim-vicepreședinte,www.digi24.ro,0,1,0,1,-1.0,1.0
Gigel Știrbu,www.cotidianul.ro,0,0,2,2,0.0,0.0
Olt,www.cotidianul.ro,0,1,1,2,-0.5,0.5
Mario De Mezzo,www.cotidianul.ro,0,0,1,1,0.0,0.0
Ana Predescu,recorder.ro,0,0,1,1,0.0,0.0
Attila Kovacs,recorder.ro,0,0,1,1,0.0,0.0
Camil Petrescu,recorder.ro,0,0,1,1,0.0,0.0
Charles King,recorder.ro,0,0,1,1,0.0,0.0
Ciprian Sterpu,recorder.ro,0,0,1,1,0.0,0.0
Colentina,recorder.ro,0,0,1,1,0.0,0.0
Comarnic,recorder.ro,0,0,1,1,0.0,0.0
Constantin Dulcan,recorder.ro,0,0,1,1,0.0,0.0
Dumitru Flucuș,recorder.ro,0,0,1,1,0.0,0.0
Eduard Huidu,recorder.ro,0,0,1,1,0.0,0.0
Elena Ferante,recorder.ro,0,0,1,1,0.0,0.0
Emil Străinu,recorder.ro,0,0,1,1,0.0,0.0
Gabriel Andronache,recorder.ro,0,0,1,1,0.0,0.0
Horezu,recorder.ro,1,0,0,1,1.0,1.0
Ionuț Sorin Banciu,recorder.ro,0,0,1,1,0.0,0.0
Irineu Darău,recorder.ro,0,0,2,2,0.0,0.0
Irvin Yalom,recorder.ro,0,0,1,1,0.0,0.0
Istanbul,recorder.ro,0,0,2,2,0.0,0.0
Marian Rasaliu,recorder.ro,0,0,1,1,0.0,0.0
Marius Dunca,recorder.ro,0,0,2,2,0.0,0.0
Mihai Mohaci,recorder.ro,0,0,1,1,0.0,0.0
Mihail Veștea,recorder.ro,0,0,1,1,0.0,0.0
Parinoush Saniee,recorder.ro,0,0,1,1,0.0,0.0
Predeal,recorder.ro,1,0,0,1,1.0,1.0
Robert Turcescu,recorder.ro,0,0,2,2,0.0,0.0
Sibiul,recorder.ro,0,1,1,2,-0.5,0.5
telefon,recorder.ro,0,0,1,1,0.0,0.0
Tudor Benga,recorder.ro,0,0,1,1,0.0,0.0
Vincent van Gogh,recorder.ro,0,0,1,1,0.0,0.0
Vladimir Volkoff,recorder.ro,0,0,1,1,0.0,0.0
broker,recorder.ro,0,0,1,1,0.0,0.0
băiețel,recorder.ro,0,0,1,1,0.0,0.0
fetită,recorder.ro,0,1,0,1,-1.0,1.0
grădinar,recorder.ro,0,0,1,1,0.0,0.0
ii,recorder.ro,0,0,1,1,0.0,0.0
penal,recorder.ro,0,2,0,2,-1.0,1.0
programator,recorder.ro,0,0,2,2,0.0,0.0
înaintaș,recorder.ro,1,0,0,1,1.0,1.0
Șinca Nouă,recorder.ro,0,0,1,1,0.0,0.0
om de știință,adevarul.ro,0,0,1,1,0.0,0.0
participanț,adevarul.ro,0,0,1,1,0.0,0.0
Arhiepiscop,www.g4media.ro,0,0,1,1,0.0,0.0
Londra,www.g4media.ro,0,0,2,2,0.0,0.0
arhiepiscop,www.g4media.ro,0,0,1,1,0.0,0.0
prelat,www.g4media.ro,0,0,1,1,0.0,0.0
AUR,www.aktual24.ro,1,1,1,3,0.0,0.0
Afganistan,www.aktual24.ro,0,0,1,1,0.0,0.0
Alba Iulia,www.aktual24.ro,0,0,1,1,0.0,0.0
Aristotel,www.aktual24.ro,0,0,1,1,0.0,0.0
Azerbaidjan,www.aktual24.ro,0,0,1,1,0.0,0.0
Boc,www.aktual24.ro,1,0,0,1,1.0,1.0
Budapestei,www.aktual24.ro,0,0,1,1,0.0,0.0
Cehia,www.aktual24.ro,0,0,2,2,0.0,0.0
Citu,www.aktual24.ro,0,1,1,2,-0.5,0.5
David Grossman,www.aktual24.ro,1,0,0,1,1.0,1.0
Domnule Hunor,www.aktual24.ro,0,0,1,1,0.0,0.0
Dubcek,www.aktual24.ro,0,0,1,1,0.0,0.0
Alexander Dubček,www.aktual24.ro,0,0,1,1,0.0,0.0
Frankopan,www.aktual24.ro,0,0,1,1,0.0,0.0
Gdansk,www.aktual24.ro,0,0,1,1,0.0,0.0
Grossman,www.aktual24.ro,1,0,0,1,1.0,1.0
Harari,www.aktual24.ro,0,0,1,1,0.0,0.0
Harghita,www.aktual24.ro,0,0,1,1,0.0,0.0
Harrari,www.aktual24.ro,0,0,1,1,0.0,0.0
Hegel,www.aktual24.ro,0,0,1,1,0.0,0.0
Heller,www.aktual24.ro,0,0,1,1,0.0,0.0
Israel,www.aktual24.ro,0,5,2,7,-0.7142857142857143,0.7142857142857143
Japonia,www.aktual24.ro,2,0,1,3,0.6666666666666666,0.6666666666666666
Immanuel Kant,www.aktual24.ro,1,0,0,1,1.0,1.0
Lunca de Jos,www.aktual24.ro,0,0,1,1,0.0,0.0
Maia Sandu,www.aktual24.ro,2,1,2,5,0.2,0.2
Marshall,www.aktual24.ro,0,0,1,1,0.0,0.0
Max Scheler,www.aktual24.ro,0,0,1,1,0.0,0.0
Miercurea Ciuc,www.aktual24.ro,0,0,1,1,0.0,0.0
Nagy Imre,www.aktual24.ro,0,0,1,1,0.0,0.0
Paleologu,www.aktual24.ro,1,0,0,1,1.0,1.0
Persia,www.aktual24.ro,0,0,1,1,0.0,0.0
Praga,www.aktual24.ro,0,0,1,1,0.0,0.0
Sfântul Gheorghe,www.aktual24.ro,0,0,1,1,0.0,0.0
Sibiul,www.aktual24.ro,0,0,1,1,0.0,0.0
Tariceanu,www.aktual24.ro,1,0,0,1,1.0,1.0
Ungureanu,www.aktual24.ro,1,0,0,1,1.0,1.0
autor,www.aktual24.ro,0,0,1,1,0.0,0.0
Annamaria Bodoczi,www.aktual24.ro,0,0,1,1,0.0,0.0
favorit,www.aktual24.ro,0,1,1,2,-0.5,0.5
filozof,www.aktual24.ro,0,0,2,2,0.0,0.0
fotograf,www.aktual24.ro,0,0,2,2,0.0,0.0
gânditor,www.aktual24.ro,0,0,1,1,0.0,0.0
generație,www.aktual24.ro,0,0,1,1,0.0,0.0
intelectual,www.aktual24.ro,2,0,1,3,0.6666666666666666,0.6666666666666666
Dobrincu,www.aktual24.ro,0,0,1,1,0.0,0.0
jandarm,www.aktual24.ro,0,4,0,4,-1.0,1.0
meseriaș,www.aktual24.ro,0,1,0,1,-1.0,1.0
motociclist,www.aktual24.ro,1,0,0,1,1.0,1.0
parvenit,www.aktual24.ro,0,1,0,1,-1.0,1.0
prezidentiabil,www.aktual24.ro,0,2,0,2,-1.0,1.0
prozator,www.aktual24.ro,1,0,0,1,1.0,1.0
reporter,www.aktual24.ro,0,1,0,1,-1.0,1.0
sofer,www.aktual24.ro,0,1,1,2,-0.5,0.5
tată,www.aktual24.ro,1,1,0,2,0.0,0.0
toți,www.aktual24.ro,0,0,2,2,0.0,0.0
translator,www.aktual24.ro,0,0,2,2,0.0,0.0
Adrian Solomon,recorder.ro,0,0,1,1,0.0,0.0
Daniel Gordis,recorder.ro,0,0,1,1,0.0,0.0
Eduard Popică,recorder.ro,0,0,1,1,0.0,0.0
Gabriela Crețu,recorder.ro,0,1,1,2,-0.5,0.5
Gelu Diaconu,recorder.ro,0,0,2,2,0.0,0.0
Ioan Irinel Stativă,recorder.ro,0,0,1,1,0.0,0.0
Iulian Mihail Bîcă,recorder.ro,0,0,1,1,0.0,0.0
Maurice Druon,recorder.ro,0,0,1,1,0.0,0.0
Mihai Cătălin Botez,recorder.ro,0,0,1,1,0.0,0.0
Nelu Tătaru,recorder.ro,0,1,4,5,-0.2,0.2
Radu Bobârnat,recorder.ro,0,0,1,1,0.0,0.0
Shoshana Zuboff,recorder.ro,0,0,1,1,0.0,0.0
Simon Sinek,recorder.ro,0,0,2,2,0.0,0.0
Tudor Polak,recorder.ro,0,0,1,1,0.0,0.0
Dan Lungu,recorder.ro,0,0,1,1,0.0,0.0
director executiv,recorder.ro,0,0,1,1,0.0,0.0
examinator,recorder.ro,0,0,1,1,0.0,0.0
mamelor,recorder.ro,0,1,1,2,-0.5,0.5
prodecan,recorder.ro,0,0,1,1,0.0,0.0
reporter,primanews.ro,0,1,1,2,-0.5,0.5
soldat,primanews.ro,0,1,0,1,-1.0,1.0
Dan Tanasă,www.news.ro,0,0,1,1,0.0,0.0
Petrișor Peiu,www.news.ro,0,0,1,1,0.0,0.0
Adrian Țuțuianu,recorder.ro,0,0,3,3,0.0,0.0
Costin Barbu,recorder.ro,0,1,1,2,-0.5,0.5
Crevedia,recorder.ro,0,0,1,1,0.0,0.0
Crânguri,recorder.ro,0,0,1,1,0.0,0.0
Crângură,recorder.ro,0,1,0,1,-1.0,1.0
Dâmbovița,recorder.ro,0,3,4,7,-0.42857142857142855,0.42857142857142855
Dărmănești,recorder.ro,0,0,1,1,0.0,0.0
Gabriel Grozavu,recorder.ro,0,0,2,2,0.0,0.0
Marius Caravețeanu,recorder.ro,0,1,0,1,-1.0,1.0
Mija,recorder.ro,0,0,1,1,0.0,0.0
Moțăieni,recorder.ro,0,0,1,1,0.0,0.0
Uliești,recorder.ro,0,0,1,1,0.0,0.0
Ulmi,recorder.ro,0,0,1,1,0.0,0.0
Țuțuianu,recorder.ro,0,1,1,2,-0.5,0.5
Iulian Costache,recorder.ro,0,0,1,1,0.0,0.0
Adriana Bahmuțeanu,recorder.ro,0,0,1,1,0.0,0.0
Carmen Avram,recorder.ro,0,0,1,1,0.0,0.0
Dan Andronic,recorder.ro,0,0,2,2,0.0,0.0
Rovana Plumb,recorder.ro,0,1,2,3,-0.3333333333333333,0.3333333333333333
Terheș,recorder.ro,0,1,0,1,-1.0,1.0
Geoană,observatornews.ro,0,0,1,1,0.0,0.0
Lia Olguța Vasilescu,observatornews.ro,0,0,2,2,0.0,0.0
Mihaela Neagu,observatornews.ro,0,0,1,1,0.0,0.0
Tal Hanan,observatornews.ro,0,1,0,1,-1.0,1.0
mercenar,observatornews.ro,0,1,0,1,-1.0,1.0
"Ludovic Orban, candidatul",adevarul.ro,0,1,0,1,-1.0,1.0
Popescu Piedone,www.gandul.ro,0,1,1,2,-0.5,0.5
Abuja,a1.ro,0,0,1,1,0.0,0.0
Ashgabat,a1.ro,0,0,1,1,0.0,0.0
Brasilia,a1.ro,0,0,1,1,0.0,0.0
Buzău,a1.ro,0,0,1,1,0.0,0.0
Cuba,a1.ro,0,0,1,1,0.0,0.0
Dieppe,a1.ro,0,0,1,1,0.0,0.0
Giurgiu,a1.ro,0,0,3,3,0.0,0.0
Havana,a1.ro,0,0,1,1,0.0,0.0
Mehedinți,a1.ro,0,0,1,1,0.0,0.0
Monica Dajbog,a1.ro,0,0,1,1,0.0,0.0
Principatul Monaco,a1.ro,0,0,1,1,0.0,0.0
Regatul Unit,a1.ro,0,0,1,1,0.0,0.0
Nigeria,a1.ro,0,0,1,1,0.0,0.0
Teleorman,a1.ro,0,0,1,1,0.0,0.0
Turkmenistan,a1.ro,0,0,1,1,0.0,0.0
Vaslui,a1.ro,0,0,1,1,0.0,0.0
operator,a1.ro,0,0,1,1,0.0,0.0
Țările de Jos,a1.ro,0,0,1,1,0.0,0.0
Adrian Codirlașu,www.aktual24.ro,0,0,1,1,0.0,0.0
Christian Nasulea,www.aktual24.ro,0,0,1,1,0.0,0.0
Stefan Musgociu,www.aktual24.ro,0,0,1,1,0.0,0.0
Stroe,primanews.ro,0,0,2,2,0.0,0.0
Austria,www.antena3.ro,0,0,3,3,0.0,0.0
Iugoslavia,www.antena3.ro,0,0,3,3,0.0,0.0
Mihai Demetriade,www.antena3.ro,0,0,2,2,0.0,0.0
Tulcea,www.antena3.ro,0,0,4,4,0.0,0.0
aceea,www.antena3.ro,0,1,0,1,-1.0,1.0
acelă,www.antena3.ro,0,1,0,1,-1.0,1.0
informator,www.antena3.ro,0,3,0,3,-1.0,1.0
urmărit,www.antena3.ro,0,2,0,2,-1.0,1.0
același,www.romaniatv.net,0,1,0,1,-1.0,1.0
Bistrița,www.romaniatv.net,0,1,1,2,-0.5,0.5
coordonator,www.romaniatv.net,0,1,0,1,-1.0,1.0
Slănic Moldova,www.romaniatv.net,0,0,2,2,0.0,0.0
călăuz,www.romaniatv.net,0,1,0,1,-1.0,1.0
dlui Georgescu,www.romaniatv.net,0,0,1,1,0.0,0.0
figuranț,www.romaniatv.net,0,1,0,1,-1.0,1.0
vinovat,www.romaniatv.net,0,2,0,2,-1.0,1.0
voievoz,www.romaniatv.net,0,1,0,1,-1.0,1.0
Andrei,www.romaniatv.net,1,0,0,1,1.0,1.0
Coreea de Nord,www.romaniatv.net,0,1,0,1,-1.0,1.0
Geoană,www.romaniatv.net,0,2,2,4,-0.5,0.5
Irina,www.romaniatv.net,1,0,0,1,1.0,1.0
anturaj,www.romaniatv.net,0,1,0,1,-1.0,1.0
coechipier,www.romaniatv.net,0,1,0,1,-1.0,1.0
consultant,www.romaniatv.net,0,1,0,1,-1.0,1.0
Netanyahu,www.romaniatv.net,0,1,0,1,-1.0,1.0
sfătuitor,www.romaniatv.net,0,0,1,1,0.0,0.0
suporter,www.romaniatv.net,0,1,0,1,-1.0,1.0
Henrik Dahl,snoop.ro,0,0,1,1,0.0,0.0
Manfred Weber,snoop.ro,0,0,1,1,0.0,0.0
mânat,snoop.ro,0,2,0,2,-1.0,1.0
Pedro Lopez de Pablo,snoop.ro,0,0,1,1,0.0,0.0
Sabine Verheyen,snoop.ro,0,0,1,1,0.0,0.0
Manea,snoop.ro,0,0,1,1,0.0,0.0
Mînzatu,snoop.ro,0,1,1,2,-0.5,0.5
subprefect,snoop.ro,0,0,2,2,0.0,0.0
Costel Fotea,agerpres.ro,0,0,1,1,0.0,0.0
Fotea,agerpres.ro,0,0,1,1,0.0,0.0
Chișinău,www.digi24.ro,0,1,1,2,-0.5,0.5
Federica Mogherini,www.digi24.ro,0,0,1,1,0.0,0.0
Igor Dodon,www.digi24.ro,0,0,2,2,0.0,0.0
Johannes Hahn,www.digi24.ro,0,0,1,1,0.0,0.0
Pavel Filip,www.digi24.ro,0,0,1,1,0.0,0.0
Plahotniuc,www.digi24.ro,0,1,0,1,-1.0,1.0
Vladimir Plahotniuc,www.digi24.ro,0,2,0,2,-1.0,1.0
Zinaida Greceanâi,www.digi24.ro,0,0,1,1,0.0,0.0
funcționar,www.digi24.ro,0,2,1,3,-0.6666666666666666,0.6666666666666666
Remus Pricopie,stirileprotv.ro,0,0,1,1,0.0,0.0
rector,stirileprotv.ro,0,0,2,2,0.0,0.0
apropiați,www.gandul.ro,0,0,1,1,0.0,0.0
Corneliu Tudor,www.gandul.ro,0,2,0,2,-1.0,1.0
Lidia Tudor,www.gandul.ro,0,0,1,1,0.0,0.0
Lidia Vadim Tudor,www.gandul.ro,0,1,0,1,-1.0,1.0
Vadim Tudor,www.gandul.ro,0,1,0,1,-1.0,1.0
poet,www.gandul.ro,0,0,1,1,0.0,0.0
Corneliu Vadim Tudor,www.gandul.ro,0,0,1,1,0.0,0.0
muncitor,www.romaniatv.net,0,1,1,2,-0.5,0.5
Ioan Aurel Pop,adevarul.ro,1,0,2,3,0.3333333333333333,0.3333333333333333
Constantin Gherghe,a1.ro,0,1,0,1,-1.0,1.0
Drobeta-Turnu Severin,a1.ro,0,1,0,1,-1.0,1.0
Ion Matu,a1.ro,0,1,0,1,-1.0,1.0
Medehinti,a1.ro,0,1,0,1,-1.0,1.0
Victor Ciutacu,a1.ro,0,0,1,1,0.0,0.0
Baciu,primanews.ro,0,1,0,1,-1.0,1.0
Diana Păun,primanews.ro,0,0,1,1,0.0,0.0
Ligia Deca,primanews.ro,0,0,2,2,0.0,0.0
Vâlcea,primanews.ro,0,0,1,1,0.0,0.0
Ana Aslan,www.luju.ro,0,1,0,1,-1.0,1.0
Balcescu,www.luju.ro,0,0,1,1,0.0,0.0
Cuza,www.luju.ro,0,1,0,1,-1.0,1.0
Elodia,www.luju.ro,0,0,1,1,0.0,0.0
Theodoru,www.luju.ro,0,1,0,1,-1.0,1.0
Giurgiu,www.luju.ro,0,0,1,1,0.0,0.0
Horatiu Potra,www.luju.ro,0,0,1,1,0.0,0.0
Maramureș,www.luju.ro,0,0,1,1,0.0,0.0
Moscova,www.luju.ro,0,0,1,1,0.0,0.0
adept,www.luju.ro,0,0,1,1,0.0,0.0
anchetator,www.luju.ro,0,1,0,1,-1.0,1.0
bătrân,www.luju.ro,0,2,0,2,-1.0,1.0
diplomat,www.luju.ro,0,1,0,1,-1.0,1.0
gardian,www.luju.ro,0,1,0,1,-1.0,1.0
mercenar,www.luju.ro,0,1,0,1,-1.0,1.0
mos,www.luju.ro,0,1,0,1,-1.0,1.0
Boia,adevarul.ro,0,0,1,1,0.0,0.0
Liechtenstein,adevarul.ro,0,0,1,1,0.0,0.0
Niculițel,adevarul.ro,0,0,1,1,0.0,0.0
Solești,adevarul.ro,0,0,1,1,0.0,0.0
Stiobăreni,adevarul.ro,0,0,1,1,0.0,0.0
Tulcea,adevarul.ro,0,0,1,1,0.0,0.0
Ioan T. Morar,adevarul.ro,0,0,1,1,0.0,0.0
Ankara,agerpres.ro,0,0,1,1,0.0,0.0
Turciei,agerpres.ro,0,0,1,1,0.0,0.0
călător,agerpres.ro,0,0,1,1,0.0,0.0
ieșean,www.mediafax.ro,0,0,1,1,0.0,0.0
Isus Hristos,agerpres.ro,0,0,1,1,0.0,0.0
erou,agerpres.ro,0,0,1,1,0.0,0.0
prefect,agerpres.ro,0,0,2,2,0.0,0.0
secretar,agerpres.ro,0,0,5,5,0.0,0.0
Adrian Negrea,pressone.ro,0,0,1,1,0.0,0.0
Andrei Valer Bențe,pressone.ro,0,0,1,1,0.0,0.0
Beiuș,pressone.ro,0,0,1,1,0.0,0.0
Cătălina Ștefănescu,pressone.ro,0,0,2,2,0.0,0.0
Emilian Pavel,pressone.ro,0,1,1,2,-0.5,0.5
Florian Pavel,pressone.ro,0,0,1,1,0.0,0.0
Ioan Mang,pressone.ro,0,1,0,1,-1.0,1.0
Negrea,pressone.ro,0,0,1,1,0.0,0.0
Pavel,pressone.ro,0,1,0,1,-1.0,1.0
economist,pressone.ro,0,0,2,2,0.0,0.0
prestator,pressone.ro,0,2,2,4,-0.5,0.5
Andrei Caramitru,adevarul.ro,0,1,1,2,-0.5,0.5
borfaș,adevarul.ro,0,1,0,1,-1.0,1.0
criminal,adevarul.ro,0,1,0,1,-1.0,1.0
gunoier,adevarul.ro,0,1,0,1,-1.0,1.0
pedofil,adevarul.ro,0,1,0,1,-1.0,1.0
violator,adevarul.ro,0,1,0,1,-1.0,1.0
realizator,www.mediafax.ro,0,1,0,1,-1.0,1.0
victimă,www.mediafax.ro,0,1,0,1,-1.0,1.0
Haga,www.digi24.ro,0,0,2,2,0.0,0.0
ambasadoare,www.digi24.ro,0,0,1,1,0.0,0.0
Călin Popescu Tăriceanu,observatornews.ro,0,0,1,1,0.0,0.0
Grațiela Gavrilescu,observatornews.ro,0,0,1,1,0.0,0.0
Tăriceanu,observatornews.ro,0,0,1,1,0.0,0.0
Viorel Ilie,observatornews.ro,0,0,1,1,0.0,0.0
Diana,www.aktual24.ro,0,1,0,1,-1.0,1.0
salariaț,agerpres.ro,0,0,1,1,0.0,0.0
Roger Stone,www.mediafax.ro,0,0,1,1,0.0,0.0
Stone,www.mediafax.ro,0,1,0,1,-1.0,1.0
asociație,www.mediafax.ro,0,0,1,1,0.0,0.0
rival,www.mediafax.ro,0,1,0,1,-1.0,1.0
contestatar,recorder.ro,0,2,0,2,-1.0,1.0
Daniel Ene,recorder.ro,0,0,1,1,0.0,0.0
Kiril Dimitriev,recorder.ro,0,0,1,1,0.0,0.0
Macedonia de Nord,recorder.ro,0,0,1,1,0.0,0.0
Pechea,recorder.ro,0,1,0,1,-1.0,1.0
Raed Arafat,recorder.ro,0,1,1,2,-0.5,0.5
amândoi,recorder.ro,0,0,2,2,0.0,0.0
colonel,recorder.ro,0,0,1,1,0.0,0.0
prizonier,recorder.ro,0,1,1,2,-0.5,0.5
Cornel Ivanciuc,www.aktual24.ro,0,0,1,1,0.0,0.0
Ion Tiriac,www.aktual24.ro,0,0,1,1,0.0,0.0
Ivanciuc,www.aktual24.ro,0,0,1,1,0.0,0.0
Niculescu Starostescu,www.aktual24.ro,0,1,0,1,-1.0,1.0
Sorina Docuz,www.aktual24.ro,0,2,1,3,-0.6666666666666666,0.6666666666666666
Sorina Stan Docuz,www.aktual24.ro,0,0,1,1,0.0,0.0
catel,www.aktual24.ro,0,0,1,1,0.0,0.0
concubin,www.aktual24.ro,0,1,0,1,-1.0,1.0
hot,www.aktual24.ro,0,3,0,3,-1.0,1.0
interpus,www.aktual24.ro,0,1,0,1,-1.0,1.0
paparazzi,www.aktual24.ro,0,2,0,2,-1.0,1.0
paznic,www.aktual24.ro,0,1,0,1,-1.0,1.0
protejată,www.aktual24.ro,0,1,0,1,-1.0,1.0
robot,www.aktual24.ro,0,0,1,1,0.0,0.0
subofițer,www.aktual24.ro,0,1,0,1,-1.0,1.0
Alina Ioana Ilie,www.luju.ro,0,0,2,2,0.0,0.0
deținut,www.luju.ro,0,4,0,4,-1.0,1.0
Gherla,www.luju.ro,0,1,0,1,-1.0,1.0
Oana Bu,www.luju.ro,0,0,1,1,0.0,0.0
Roman,www.luju.ro,0,1,0,1,-1.0,1.0
Adrian Severin,www.luju.ro,0,2,0,2,-1.0,1.0
Andrej Plenković,recorder.ro,0,0,1,1,0.0,0.0
Croația,recorder.ro,0,0,1,1,0.0,0.0
JD Vance,recorder.ro,0,1,2,3,-0.3333333333333333,0.3333333333333333
Ancuței Irimia,www.news.ro,0,0,1,1,0.0,0.0
Bogdan Cojocaru,www.news.ro,0,0,1,1,0.0,0.0
Ciprian Paraschiv,www.news.ro,0,0,1,1,0.0,0.0
Cristina Dascălu,www.news.ro,0,0,1,1,0.0,0.0
Dan Cașcaval,www.news.ro,0,0,1,1,0.0,0.0
Dumitru Manea,www.news.ro,0,0,1,1,0.0,0.0
Lucian Rusu,www.news.ro,0,0,1,1,0.0,0.0
Maricel Popa,www.news.ro,0,0,1,1,0.0,0.0
Marius Bodea,www.news.ro,0,0,1,1,0.0,0.0
Monica Berescu,www.news.ro,0,0,1,1,0.0,0.0
Silviu Gurlui,www.news.ro,0,0,1,1,0.0,0.0
Simona Macovei,www.news.ro,0,0,1,1,0.0,0.0
Sorin Afloarei,www.news.ro,0,0,1,1,0.0,0.0
rector,www.news.ro,0,0,3,3,0.0,0.0
Ștefan Tanasă,www.news.ro,0,0,1,1,0.0,0.0
analist politic,observatornews.ro,0,0,1,1,0.0,0.0
Pîrvulescu,observatornews.ro,0,0,1,1,0.0,0.0
mediator,observatornews.ro,0,0,1,1,0.0,0.0
Preda,www.mediafax.ro,0,0,1,1,0.0,0.0
Frunzăverde,www.mediafax.ro,0,1,0,1,-1.0,1.0
escroc,www.mediafax.ro,0,1,0,1,-1.0,1.0
interlocutor,www.mediafax.ro,0,0,1,1,0.0,0.0
om de afaceri,www.mediafax.ro,0,1,0,1,-1.0,1.0
responsabil politic,www.mediafax.ro,0,1,0,1,-1.0,1.0
Mona Pivniceru,a1.ro,0,1,0,1,-1.0,1.0
Pivniceru,a1.ro,0,1,0,1,-1.0,1.0
Ursula,www.cotidianul.ro,0,1,0,1,-1.0,1.0
ambasador,www.cotidianul.ro,0,2,0,2,-1.0,1.0
bolnav,www.cotidianul.ro,0,1,0,1,-1.0,1.0
globalist,www.cotidianul.ro,0,1,0,1,-1.0,1.0
individ,www.cotidianul.ro,0,1,0,1,-1.0,1.0
matematician,www.cotidianul.ro,0,1,0,1,-1.0,1.0
prost,www.cotidianul.ro,0,1,0,1,-1.0,1.0
sorosist,www.cotidianul.ro,0,2,0,2,-1.0,1.0
România Mare,observatornews.ro,1,0,0,1,1.0,1.0
conducător,observatornews.ro,0,1,0,1,-1.0,1.0
popor,observatornews.ro,1,0,1,2,0.5,0.5
Cervenia,recorder.ro,0,0,1,1,0.0,0.0
Poeni,recorder.ro,0,0,1,1,0.0,0.0
Salcia,recorder.ro,0,0,1,1,0.0,0.0
Dumitru Sfântu,recorder.ro,0,0,1,1,0.0,0.0
teleormănean,recorder.ro,0,1,0,1,-1.0,1.0
Leonov,www.gandul.ro,0,0,1,1,0.0,0.0
Marius Tucă,www.gandul.ro,0,0,3,3,0.0,0.0
Turcan,www.gandul.ro,0,0,1,1,0.0,0.0
chirurg,www.gandul.ro,0,0,1,1,0.0,0.0
cosmonaut,www.gandul.ro,0,0,1,1,0.0,0.0
Alexei Leonov,www.gandul.ro,0,0,1,1,0.0,0.0
Cotofești,www.comisarul.ro,0,1,0,1,-1.0,1.0
infractor,www.comisarul.ro,0,1,0,1,-1.0,1.0
Dâmbovița,www.comisarul.ro,0,0,3,3,0.0,0.0
Marius Ghincea,www.comisarul.ro,0,0,1,1,0.0,0.0
Marcel Colacu,www.comisarul.ro,0,0,1,1,0.0,0.0
Cutare,a1.ro,0,1,0,1,-1.0,1.0
Cristian Antonescu,a1.ro,0,0,1,1,0.0,0.0
Abbas Araghchi,agerpres.ro,0,0,1,1,0.0,0.0
Beniamin Netanyahu,agerpres.ro,0,1,0,1,-1.0,1.0
Iran,agerpres.ro,0,1,1,2,-0.5,0.5
Mihaela Moise,agerpres.ro,0,0,1,1,0.0,0.0
Netanyahu,agerpres.ro,0,1,0,1,-1.0,1.0
Oman,agerpres.ro,0,0,1,1,0.0,0.0
Statele Unite,agerpres.ro,1,0,2,3,0.3333333333333333,0.3333333333333333
Teheran,agerpres.ro,0,0,1,1,0.0,0.0
inamic,agerpres.ro,0,1,0,1,-1.0,1.0
responsabil,agerpres.ro,0,0,1,1,0.0,0.0
Claudiu Damian,www.g4media.ro,0,0,1,1,0.0,0.0
Petre Emanoil Neagu,www.g4media.ro,0,1,1,2,-0.5,0.5
Râmnicu Sărat,www.g4media.ro,0,0,1,1,0.0,0.0
buzoi,www.g4media.ro,0,1,0,1,-1.0,1.0
Carmen Orban,www.g4media.ro,0,0,1,1,0.0,0.0
Mihail Neamțu,www.romaniatv.net,0,1,1,2,-0.5,0.5
Ramona Ioana Bruynseels,www.romaniatv.net,0,1,1,2,-0.5,0.5
Adriana Cotel,recorder.ro,0,1,1,2,-0.5,0.5
Cârcea,recorder.ro,0,1,0,1,-1.0,1.0
Darius Vâlcov,recorder.ro,0,4,0,4,-1.0,1.0
Eugen Teodorivici,recorder.ro,0,1,0,1,-1.0,1.0
Mihaela Triculescu,recorder.ro,0,2,0,2,-1.0,1.0
Triculescu,recorder.ro,0,1,0,1,-1.0,1.0
Valerică Pupăză,recorder.ro,0,0,2,2,0.0,0.0
Vâlcov,recorder.ro,0,2,0,2,-1.0,1.0
căpitan,recorder.ro,1,0,0,1,1.0,1.0
Gaza,www.mediafax.ro,0,1,0,1,-1.0,1.0
Israel Katz,www.mediafax.ro,0,0,1,1,0.0,0.0
Khan Younis,www.mediafax.ro,0,0,1,1,0.0,0.0
Rafah,www.mediafax.ro,0,0,1,1,0.0,0.0
ostatic,www.mediafax.ro,0,2,0,2,-1.0,1.0
ostaș,www.mediafax.ro,0,1,0,1,-1.0,1.0
Algeria,pressone.ro,0,1,0,1,-1.0,1.0
Bernard Arnault,pressone.ro,0,1,0,1,-1.0,1.0
David Cameron,pressone.ro,0,1,0,1,-1.0,1.0
Eric Ciotti,pressone.ro,0,0,1,1,0.0,0.0
Eric Zemmour,pressone.ro,0,1,0,1,-1.0,1.0
Gerald Darmanin,pressone.ro,0,1,0,1,-1.0,1.0
Jacques Chirac,pressone.ro,0,0,1,1,0.0,0.0
Jordan Bardella,pressone.ro,0,0,3,3,0.0,0.0
Manuel Valls,pressone.ro,0,0,1,1,0.0,0.0
Marion,pressone.ro,0,0,1,1,0.0,0.0
Martin Bouygues,pressone.ro,0,1,0,1,-1.0,1.0
Mitterrand,pressone.ro,0,1,0,1,-1.0,1.0
Pierre Bousquet,pressone.ro,0,1,0,1,-1.0,1.0
republică,pressone.ro,0,0,1,1,0.0,0.0
Sarkozy,pressone.ro,0,0,1,1,0.0,0.0
Vincent Bolloré,pressone.ro,0,0,1,1,0.0,0.0
Zemmour,pressone.ro,0,1,0,1,-1.0,1.0
Zenmour,pressone.ro,0,0,1,1,0.0,0.0
cap,pressone.ro,0,2,0,2,-1.0,1.0
Francois Hollande,pressone.ro,0,0,1,1,0.0,0.0
Bogdan,www.gandul.ro,0,1,1,2,-0.5,0.5
Stanciu,www.gandul.ro,0,0,1,1,0.0,0.0
veri,www.gandul.ro,0,0,1,1,0.0,0.0
interpret,adevarul.ro,0,1,0,1,-1.0,1.0
Nando Mocanu,adevarul.ro,0,1,0,1,-1.0,1.0
complic,adevarul.ro,0,1,0,1,-1.0,1.0
Ștefănești,adevarul.ro,0,0,1,1,0.0,0.0
cioloș,www.realitatea.net,0,2,0,2,-1.0,1.0
Dacian Cioloș,www.realitatea.net,0,0,1,1,0.0,0.0
Marian Enache,www.realitatea.net,0,0,1,1,0.0,0.0
Nicolas Warney,www.realitatea.net,0,0,1,1,0.0,0.0
omolog,www.realitatea.net,0,1,1,2,-0.5,0.5
Tati,www.news.ro,1,0,0,1,1.0,1.0
Adrian Dobre,adevarul.ro,0,0,1,1,0.0,0.0
Andrei Volosevici,adevarul.ro,0,1,1,2,-0.5,0.5
Iulian Dumitrescu,adevarul.ro,0,0,1,1,0.0,0.0
Volosevici,adevarul.ro,0,0,1,1,0.0,0.0
Grațiela Gavrilescu,adevarul.ro,0,0,1,1,0.0,0.0
Bertalan Păcuratu Alexandra Beatrice,adevarul.ro,0,0,1,1,0.0,0.0
ui,www.digi24.ro,0,1,0,1,-1.0,1.0
tehnocrat,www.mediafax.ro,0,0,1,1,0.0,0.0
bancher,www.euronews.ro,0,0,1,1,0.0,0.0
Adina Cezar,www.romaniatv.net,0,0,1,1,0.0,0.0
Barbu,www.romaniatv.net,0,0,1,1,0.0,0.0
Daniel Barbu,www.romaniatv.net,0,0,2,2,0.0,0.0
istoric,www.romaniatv.net,0,0,1,1,0.0,0.0
Montană,www.romaniatv.net,0,1,0,1,-1.0,1.0
apărător,www.romaniatv.net,1,0,0,1,1.0,1.0
comunicator,www.romaniatv.net,0,0,1,1,0.0,0.0
Corendea,www.gandul.ro,0,0,2,2,0.0,0.0
Cosmin Corendea,www.gandul.ro,0,0,2,2,0.0,0.0
dansă,www.gandul.ro,0,0,1,1,0.0,0.0
Teodor Paleologu,a1.ro,0,0,1,1,0.0,0.0
Toti,a1.ro,0,0,1,1,0.0,0.0
demisionar,a1.ro,0,0,1,1,0.0,0.0
Norbert Ajok,www.mediafax.ro,0,0,1,1,0.0,0.0
Norbert Apjok,www.mediafax.ro,0,1,0,1,-1.0,1.0
Albania,adevarul.ro,1,0,0,1,1.0,1.0
Bosnia și Herțegovina,adevarul.ro,0,0,1,1,0.0,0.0
Craiova,adevarul.ro,0,0,2,2,0.0,0.0
Croația,adevarul.ro,1,0,0,1,1.0,1.0
Domnia Sa,adevarul.ro,0,1,0,1,-1.0,1.0
Bejinariu,adevarul.ro,1,0,0,1,1.0,1.0
Recep Tayyip Erdogan,adevarul.ro,0,1,1,2,-0.5,0.5
Eugen Teodorovici,adevarul.ro,1,0,2,3,0.3333333333333333,0.3333333333333333
Giorgia Meloni,adevarul.ro,0,0,1,1,0.0,0.0
India,adevarul.ro,0,0,2,2,0.0,0.0
Ioana Petrescu,adevarul.ro,0,0,1,1,0.0,0.0
Izmir,adevarul.ro,0,0,1,1,0.0,0.0
Macedonia,adevarul.ro,1,0,0,1,1.0,1.0
Macedonia de Nord,adevarul.ro,1,0,0,1,1.0,1.0
Marius Nica,adevarul.ro,0,0,1,1,0.0,0.0
Mihaill Kogălnicianu,adevarul.ro,0,1,0,1,-1.0,1.0
Molotov,adevarul.ro,0,1,0,1,-1.0,1.0
Muntenegru,adevarul.ro,0,0,1,1,0.0,0.0
P,adevarul.ro,0,0,1,1,0.0,0.0
Ribbentrop,adevarul.ro,0,1,0,1,-1.0,1.0
Slovenia,adevarul.ro,1,0,0,1,1.0,1.0
Stubb,adevarul.ro,1,0,0,1,1.0,1.0
Turciei,adevarul.ro,0,2,1,3,-0.6666666666666666,0.6666666666666666
amândoi,adevarul.ro,1,0,2,3,0.3333333333333333,0.3333333333333333
dlui Vlase,adevarul.ro,0,0,1,1,0.0,0.0
Dna Kovesi,adevarul.ro,0,0,1,1,0.0,0.0
doamna Corbu,adevarul.ro,0,1,0,1,-1.0,1.0
doamna Kovesi,adevarul.ro,0,1,0,1,-1.0,1.0
Angela Merkel,adevarul.ro,0,0,1,1,0.0,0.0
Renate Weber,adevarul.ro,0,0,1,1,0.0,0.0
Borisov,adevarul.ro,0,0,1,1,0.0,0.0
Hollande,adevarul.ro,0,0,1,1,0.0,0.0
Uncheșelu,adevarul.ro,0,2,0,2,-1.0,1.0
Stor,adevarul.ro,0,1,0,1,-1.0,1.0
mascaț,adevarul.ro,0,1,0,1,-1.0,1.0
mediator,adevarul.ro,1,0,0,1,1.0,1.0
politruc,adevarul.ro,0,3,0,3,-1.0,1.0
prost,adevarul.ro,0,1,0,1,-1.0,1.0
soldat,adevarul.ro,0,2,0,2,-1.0,1.0
suporter,adevarul.ro,1,0,0,1,1.0,1.0
următor,adevarul.ro,0,1,0,1,-1.0,1.0
Daniel Ciornei,www.cotidianul.ro,0,0,1,1,0.0,0.0
Daniel Cătălin Ciornei,www.cotidianul.ro,0,0,1,1,0.0,0.0
Mihai Bogdan Negoescu,www.cotidianul.ro,0,0,1,1,0.0,0.0
Răzvan Biro,www.cotidianul.ro,0,0,1,1,0.0,0.0
Tiberiu Claudiu Bârsan,www.cotidianul.ro,0,0,1,1,0.0,0.0
Claudiu Bârstan,www.cotidianul.ro,0,0,1,1,0.0,0.0
Andreea Cosma,www.b1tv.ro,0,1,0,1,-1.0,1.0
Andreei Cosma,www.b1tv.ro,0,1,0,1,-1.0,1.0
Lucian Onea,www.b1tv.ro,0,0,1,1,0.0,0.0
Mircea Negulescu,www.b1tv.ro,0,0,1,1,0.0,0.0
familie,www.b1tv.ro,2,2,2,6,0.0,0.0
realizator,www.b1tv.ro,0,0,1,1,0.0,0.0
Claudiu Năsui,www.realitatea.net,0,0,1,1,0.0,0.0
edil general,www.realitatea.net,0,1,0,1,-1.0,1.0
Eugen Teodorovici,www.gandul.ro,0,0,2,2,0.0,0.0
Alex Nedea,www.aktual24.ro,0,0,1,1,0.0,0.0
Laurei Vicol,www.aktual24.ro,0,4,0,4,-1.0,1.0
Niculae Learciu,www.aktual24.ro,0,3,0,3,-1.0,1.0
Simonis,www.aktual24.ro,0,0,4,4,0.0,0.0
Voicu,www.aktual24.ro,0,3,1,4,-0.75,0.75
agent,www.aktual24.ro,0,1,0,1,-1.0,1.0
familia Ciorbă,www.aktual24.ro,0,1,0,1,-1.0,1.0
făptuitor,www.aktual24.ro,0,3,0,3,-1.0,1.0
penelist,www.aktual24.ro,0,2,0,2,-1.0,1.0
politruc,www.aktual24.ro,0,2,0,2,-1.0,1.0
profesionist,www.aktual24.ro,0,1,0,1,-1.0,1.0
Tulcea,www.gandul.ro,0,0,2,2,0.0,0.0
Andrioaei,www.luju.ro,0,1,1,2,-0.5,0.5
Chișinău,www.luju.ro,0,1,1,2,-0.5,0.5
Ingrid Mocanu,www.luju.ro,0,0,6,6,0.0,0.0
loctiitor,www.luju.ro,0,1,0,1,-1.0,1.0
observator,www.luju.ro,0,0,1,1,0.0,0.0
Adina Vălean,www.activenews.ro,0,1,1,2,-0.5,0.5
Alexandru Muraru,www.activenews.ro,0,0,2,2,0.0,0.0
Andi Cristea,www.activenews.ro,0,0,1,1,0.0,0.0
Claudiu Manda,www.activenews.ro,0,1,2,3,-0.3333333333333333,0.3333333333333333
Dan Motreanu,www.activenews.ro,0,0,1,1,0.0,0.0
Dan Nica,www.activenews.ro,0,0,1,1,0.0,0.0
Daniel Buda,www.activenews.ro,0,0,2,2,0.0,0.0
Dragoș Benea,www.activenews.ro,0,1,1,2,-0.5,0.5
Gheorghe Cârciu,www.activenews.ro,0,0,1,1,0.0,0.0
Gheorghe Falcă,www.activenews.ro,0,1,0,1,-1.0,1.0
Mara Mareș,www.activenews.ro,0,0,1,1,0.0,0.0
Maria Grapini,www.activenews.ro,0,0,2,2,0.0,0.0
Mihai Tudose,www.activenews.ro,0,0,1,1,0.0,0.0
Mircea Hava,www.activenews.ro,0,0,1,1,0.0,0.0
Ramonei Chiriac,www.activenews.ro,0,0,1,1,0.0,0.0
Roxana Mînzatu,www.activenews.ro,0,0,1,1,0.0,0.0
Siegfried Mureșan,www.activenews.ro,0,0,1,1,0.0,0.0
Titus Corlățean,www.activenews.ro,0,1,0,1,-1.0,1.0
baron,www.activenews.ro,0,3,0,3,-1.0,1.0
pensionar,www.activenews.ro,0,0,1,1,0.0,0.0
sociolog,www.activenews.ro,0,0,1,1,0.0,0.0
Ștefan Moșoiu,www.activenews.ro,0,0,1,1,0.0,0.0
Marcel,www.cotidianul.ro,0,0,1,1,0.0,0.0
Mihai Viteazul,www.cotidianul.ro,1,0,0,1,1.0,1.0
Nicu,www.cotidianul.ro,0,0,1,1,0.0,0.0
Vlad Țepeș,www.cotidianul.ro,0,0,1,1,0.0,0.0
activ,www.cotidianul.ro,0,1,0,1,-1.0,1.0
zurbagiu,www.cotidianul.ro,0,1,0,1,-1.0,1.0
Ștefan cel Mare,www.cotidianul.ro,1,0,0,1,1.0,1.0
Stroe,www.gandul.ro,0,0,1,1,0.0,0.0
Tiberiu Florescu,www.gandul.ro,0,0,1,1,0.0,0.0
Pavel Florescu,www.gandul.ro,1,0,0,1,1.0,1.0
Alexandru Moldovan,recorder.ro,0,0,2,2,0.0,0.0
Frații Kempes,recorder.ro,0,0,1,1,0.0,0.0
Kempes,recorder.ro,0,1,0,1,-1.0,1.0
contrabandist,recorder.ro,0,1,0,1,-1.0,1.0
Flutur,recorder.ro,0,0,1,1,0.0,0.0
țugui,recorder.ro,0,1,0,1,-1.0,1.0
Cristina Prună,www.digi24.ro,0,0,2,2,0.0,0.0
juriști,www.digi24.ro,0,1,0,1,-1.0,1.0
Câmpulung Muscel,recorder.ro,0,0,1,1,0.0,0.0
Meloni,www.euronews.ro,0,1,0,1,-1.0,1.0
Cătălin Cîrstoiu,www.euronews.ro,0,2,2,4,-0.5,0.5
Domnul Cîrstoiu,www.euronews.ro,0,0,1,1,0.0,0.0
Târgoviște,www.aktual24.ro,0,1,0,1,-1.0,1.0
fanatic,www.aktual24.ro,0,1,0,1,-1.0,1.0
patron,www.aktual24.ro,0,1,0,1,-1.0,1.0
penal,www.aktual24.ro,0,3,0,3,-1.0,1.0
rob,www.aktual24.ro,0,1,0,1,-1.0,1.0
vânzător,www.aktual24.ro,0,1,0,1,-1.0,1.0
colegă,www.romaniatv.net,1,1,0,2,0.0,0.0
Corneliu Tudor,observatornews.ro,0,2,1,3,-0.6666666666666666,0.6666666666666666
Domnișoara Rona,observatornews.ro,0,0,1,1,0.0,0.0
domn,observatornews.ro,0,0,1,1,0.0,0.0
Emil Constantinescu,observatornews.ro,0,2,0,2,-1.0,1.0
Mugur Isărescu,observatornews.ro,0,0,2,2,0.0,0.0
Niculae Cerveni,observatornews.ro,0,0,1,1,0.0,0.0
Rona Hartner,observatornews.ro,0,1,1,2,-0.5,0.5
Theodor Stolojan,observatornews.ro,0,0,1,1,0.0,0.0
Vadim,observatornews.ro,0,1,0,1,-1.0,1.0
Vadim Tudor,observatornews.ro,0,1,0,1,-1.0,1.0
Constantinescu,observatornews.ro,0,0,1,1,0.0,0.0
Cetepe,www.activenews.ro,0,1,0,1,-1.0,1.0
Gaza,www.activenews.ro,0,1,0,1,-1.0,1.0
Gâzii,www.activenews.ro,0,1,0,1,-1.0,1.0
Harris,www.activenews.ro,0,1,0,1,-1.0,1.0
Kamala Harris,www.activenews.ro,0,1,0,1,-1.0,1.0
Liban,www.activenews.ro,0,1,0,1,-1.0,1.0
Lucian Mîndruță,www.activenews.ro,0,1,0,1,-1.0,1.0
mândruț,www.activenews.ro,0,1,0,1,-1.0,1.0
Prelipcean,www.activenews.ro,0,1,0,1,-1.0,1.0
Radutudorii,www.activenews.ro,0,1,0,1,-1.0,1.0
Statele,www.activenews.ro,0,0,1,1,0.0,0.0
Unite,www.activenews.ro,0,1,0,1,-1.0,1.0
elector,www.activenews.ro,0,1,0,1,-1.0,1.0
funcționar,www.activenews.ro,0,2,2,4,-0.5,0.5
ideolog,www.activenews.ro,0,1,0,1,-1.0,1.0
suporter,www.activenews.ro,0,2,0,2,-1.0,1.0
IPS Teodosie,www.activenews.ro,0,0,1,1,0.0,0.0
Iunia,www.activenews.ro,0,0,1,1,0.0,0.0
patriarh,www.activenews.ro,0,0,2,2,0.0,0.0
Patriarh Daniel,www.activenews.ro,0,0,1,1,0.0,0.0
Andronic,www.activenews.ro,0,0,1,1,0.0,0.0
Sfântul Paisie,www.activenews.ro,1,0,1,2,0.5,0.5
ocrotitor,www.activenews.ro,0,0,1,1,0.0,0.0
străbun,www.activenews.ro,0,0,1,1,0.0,0.0
Carmen Orban,www.euronews.ro,0,0,1,1,0.0,0.0
Claudiu Manda,www.euronews.ro,0,0,2,2,0.0,0.0
Marius Budăi,www.euronews.ro,0,0,1,1,0.0,0.0
Anca Mirion,pressone.ro,0,0,1,1,0.0,0.0
Consilier,pressone.ro,0,0,1,1,0.0,0.0
Cristian Rădulescu,pressone.ro,0,1,0,1,-1.0,1.0
Dan Cristian Popescu,pressone.ro,0,0,2,2,0.0,0.0
Lili,pressone.ro,0,0,2,2,0.0,0.0
Gabriel Mutu,pressone.ro,0,0,1,1,0.0,0.0
Hristo Botev,pressone.ro,0,0,1,1,0.0,0.0
Ioan Mihăilă,pressone.ro,0,0,1,1,0.0,0.0
Jipa,pressone.ro,0,1,1,2,-0.5,0.5
Lucian Muntean Barbu,pressone.ro,0,0,1,1,0.0,0.0
Mihăilă,pressone.ro,0,2,0,2,-1.0,1.0
Pelican,pressone.ro,0,0,1,1,0.0,0.0
Ruxandra Jipa,pressone.ro,0,0,1,1,0.0,0.0
Tudorache,pressone.ro,0,0,1,1,0.0,0.0
Tudorie,pressone.ro,0,0,1,1,0.0,0.0
Violeta Tudorie,pressone.ro,0,0,1,1,0.0,0.0
an,pressone.ro,0,1,1,2,-0.5,0.5
contribuabil,pressone.ro,0,1,1,2,-0.5,0.5
vânzătoare,pressone.ro,0,0,1,1,0.0,0.0
Cosmin,a1.ro,0,0,2,2,0.0,0.0
Novak Djokovic,a1.ro,0,0,2,2,0.0,0.0
München,a1.ro,1,0,0,1,1.0,1.0
Pilic,a1.ro,0,0,1,1,0.0,0.0
român,a1.ro,0,0,1,1,0.0,0.0
legendă,a1.ro,2,0,0,2,1.0,1.0
fiu,www.cotidianul.ro,0,0,1,1,0.0,0.0
Franta,www.cotidianul.ro,0,1,0,1,-1.0,1.0
Frantei,www.cotidianul.ro,0,1,0,1,-1.0,1.0
Marian Munteanu,www.cotidianul.ro,0,1,1,2,-0.5,0.5
Octavian Știreanu,www.cotidianul.ro,0,1,0,1,-1.0,1.0
agricultor,www.cotidianul.ro,0,1,0,1,-1.0,1.0
și,www.cotidianul.ro,0,0,1,1,0.0,0.0
de,www.mediafax.ro,0,0,1,1,0.0,0.0
a,www.aktual24.ro,0,0,1,1,0.0,0.0
Amândoi,www.digi24.ro,0,1,1,2,-0.5,0.5
doamna Lasconi,www.digi24.ro,0,2,2,4,-0.5,0.5
păpușar,www.digi24.ro,0,1,0,1,-1.0,1.0
Cristina Demetrescu,www.romaniatv.net,0,0,1,1,0.0,0.0
Gemeni,www.romaniatv.net,1,0,0,1,1.0,1.0
Lei,www.romaniatv.net,1,0,0,1,1.0,1.0
Raci,www.romaniatv.net,0,0,1,1,0.0,0.0
Taur,www.romaniatv.net,1,0,0,1,1.0,1.0
criminal,www.b1tv.ro,0,1,0,1,-1.0,1.0
ticălos,www.b1tv.ro,0,1,0,1,-1.0,1.0
Adi Tamas,a1.ro,0,0,1,1,0.0,0.0
Arad,a1.ro,0,0,2,2,0.0,0.0
Ciprian Roman,a1.ro,0,0,1,1,0.0,0.0
Cristian Popescu,a1.ro,0,0,1,1,0.0,0.0
Mariana Anghel,a1.ro,0,0,1,1,0.0,0.0
Mircia Muntean,a1.ro,0,0,1,1,0.0,0.0
Mirela Petrean,a1.ro,0,0,1,1,0.0,0.0
Petrica Vita,a1.ro,0,0,1,1,0.0,0.0
Ramona,a1.ro,0,0,1,1,0.0,0.0
Alba Iulia,recorder.ro,0,0,4,4,0.0,0.0
Orăștie,recorder.ro,0,0,1,1,0.0,0.0
critic,recorder.ro,0,1,0,1,-1.0,1.0
Krivoi Rog,observatornews.ro,0,1,0,1,-1.0,1.0
Sankt Petersburg,observatornews.ro,0,0,1,1,0.0,0.0
Steve Witkoff,observatornews.ro,0,0,1,1,0.0,0.0
Sumî,observatornews.ro,0,0,1,1,0.0,0.0
adult,observatornews.ro,0,1,0,1,-1.0,1.0
cadavru,observatornews.ro,0,1,0,1,-1.0,1.0
locuitor,observatornews.ro,0,0,1,1,0.0,0.0
pasager,observatornews.ro,0,1,0,1,-1.0,1.0
Volodimir Zelenski,observatornews.ro,0,0,4,4,0.0,0.0
salvator,observatornews.ro,0,0,2,2,0.0,0.0
supraviețuitor,observatornews.ro,0,0,1,1,0.0,0.0
victima,observatornews.ro,0,1,1,2,-0.5,0.5
Anatoli,www.activenews.ro,0,0,1,1,0.0,0.0
Apoc,www.activenews.ro,0,1,0,1,-1.0,1.0
Celui,www.activenews.ro,1,0,0,1,1.0,1.0
Matei,www.activenews.ro,0,0,1,1,0.0,0.0
Fotini Samarineanaca,www.activenews.ro,1,0,0,1,1.0,1.0
Fotis,www.activenews.ro,0,0,1,1,0.0,0.0
Foto,www.activenews.ro,0,0,1,1,0.0,0.0
Iacob,www.activenews.ro,0,0,1,1,0.0,0.0
Iosif,www.activenews.ro,0,0,1,1,0.0,0.0
Kiriaki,www.activenews.ro,0,0,1,1,0.0,0.0
Mireasa,www.activenews.ro,1,0,0,1,1.0,1.0
Paraschevi,www.activenews.ro,0,0,1,1,0.0,0.0
Samarineancă,www.activenews.ro,1,0,0,1,1.0,1.0
Saul,www.activenews.ro,0,1,0,1,-1.0,1.0
Sfânta Fotinia,www.activenews.ro,0,0,1,1,0.0,0.0
Sfântul Ilarion V. Felea,www.activenews.ro,1,0,0,1,1.0,1.0
Sfântul Marcu Ascetul,www.activenews.ro,1,0,0,1,1.0,1.0
Victor,www.activenews.ro,0,0,1,1,0.0,0.0
Pavel,www.activenews.ro,0,0,1,1,0.0,0.0
prigonitor,www.activenews.ro,0,1,0,1,-1.0,1.0
teolog,www.activenews.ro,1,0,0,1,1.0,1.0
Levi,www.activenews.ro,0,0,1,1,0.0,0.0
Nero,www.activenews.ro,0,1,0,1,-1.0,1.0
cadru,www.digi24.ro,0,1,0,1,-1.0,1.0
federație,recorder.ro,0,2,0,2,-1.0,1.0
Matt Gaetz,recorder.ro,0,1,0,1,-1.0,1.0
Todd Blanche,recorder.ro,0,0,1,1,0.0,0.0
străin,recorder.ro,0,1,0,1,-1.0,1.0
Attila Cseke,www.antena3.ro,0,0,1,1,0.0,0.0
Cseke Attila,www.antena3.ro,0,0,1,1,0.0,0.0
guvern,observatornews.ro,0,1,0,1,-1.0,1.0
Nicoale Ciucă,observatornews.ro,0,0,1,1,0.0,0.0
Niculae Ciucă,observatornews.ro,0,0,1,1,0.0,0.0
"Ludovic Orban, candidatul",www.euronews.ro,0,0,1,1,0.0,0.0
Alexandra Șerban,recorder.ro,0,0,1,1,0.0,0.0
Fundeni,recorder.ro,0,0,1,1,0.0,0.0
Gheorghe Burnei,recorder.ro,0,1,0,1,-1.0,1.0
Găești,recorder.ro,0,0,2,2,0.0,0.0
Ohio,recorder.ro,0,0,1,1,0.0,0.0
Pennsylvania,recorder.ro,0,0,1,1,0.0,0.0
Wisconsin,recorder.ro,0,0,1,1,0.0,0.0
Șercan,recorder.ro,0,1,0,1,-1.0,1.0
vedetă,adevarul.ro,0,1,0,1,-1.0,1.0
vedetel,adevarul.ro,0,1,1,2,-0.5,0.5
Bolyai,recorder.ro,0,0,1,1,0.0,0.0
Danemarcei,recorder.ro,0,0,1,1,0.0,0.0
Marius Pieleanu,recorder.ro,0,0,1,1,0.0,0.0
Mexic,recorder.ro,0,0,1,1,0.0,0.0
Mihaiu,recorder.ro,0,0,1,1,0.0,0.0
Valentin Naumescu,recorder.ro,0,0,2,2,0.0,0.0
Radu Oprea,recorder.ro,0,2,1,3,-0.6666666666666666,0.6666666666666666
subiect,recorder.ro,0,1,0,1,-1.0,1.0
Andreea Ghiorghe,www.digi24.ro,0,0,1,1,0.0,0.0
deținător,www.digi24.ro,0,0,2,2,0.0,0.0
rude,www.digi24.ro,0,0,1,1,0.0,0.0
Ivan Kochedykov,www.comisarul.ro,0,0,1,1,0.0,0.0
Kochedykov,www.comisarul.ro,0,0,1,1,0.0,0.0
Bacău,www.romaniatv.net,0,0,2,2,0.0,0.0
Robert Alecu,www.romaniatv.net,0,0,2,2,0.0,0.0
Șerban Dimitrie Sturdza,www.romaniatv.net,0,0,1,1,0.0,0.0
colectiv,www.news.ro,0,0,1,1,0.0,0.0
Macedonia de Nord,www.news.ro,0,0,1,1,0.0,0.0
mari arși,www.news.ro,0,1,0,1,-1.0,1.0
mort,www.news.ro,0,1,0,1,-1.0,1.0
rănit,www.news.ro,0,1,0,1,-1.0,1.0
Predoiu,www.comisarul.ro,0,0,1,1,0.0,0.0
demnitar,www.comisarul.ro,0,1,0,1,-1.0,1.0
om politic,www.comisarul.ro,0,1,0,1,-1.0,1.0
Anamaria,www.digi24.ro,0,1,0,1,-1.0,1.0
Anamaria Gavrilă,www.digi24.ro,0,3,1,4,-0.75,0.75
George,www.digi24.ro,0,1,0,1,-1.0,1.0
frate,www.digi24.ro,1,2,0,3,-0.3333333333333333,0.3333333333333333
portar,www.digi24.ro,0,1,0,1,-1.0,1.0
B,www.comisarul.ro,0,1,0,1,-1.0,1.0
Bernhard Z,www.comisarul.ro,0,0,1,1,0.0,0.0
Cotofenești,www.comisarul.ro,0,1,0,1,-1.0,1.0
Douglas Chesley W,www.comisarul.ro,0,1,0,1,-1.0,1.0
Jan B,www.comisarul.ro,0,1,0,1,-1.0,1.0
W,www.comisarul.ro,0,1,0,1,-1.0,1.0
Z,www.comisarul.ro,0,1,0,1,-1.0,1.0
Georgia,adevarul.ro,0,0,4,4,0.0,0.0
Adrian Vasilescu,www.digi24.ro,0,0,3,3,0.0,0.0
NOI,www.digi24.ro,0,0,1,1,0.0,0.0
Mugur Isărescu,www.digi24.ro,0,0,3,3,0.0,0.0
Adrian Wiener,www.g4media.ro,0,2,0,2,-1.0,1.0
Rafila,www.g4media.ro,0,1,0,1,-1.0,1.0
adolescent,www.g4media.ro,0,1,0,1,-1.0,1.0
cooperatist,www.digi24.ro,0,1,0,1,-1.0,1.0
Antonio Costa,www.cotidianul.ro,0,0,1,1,0.0,0.0
populist,www.cotidianul.ro,0,1,0,1,-1.0,1.0
Federovici,agerpres.ro,0,0,1,1,0.0,0.0
Doina Federovici,agerpres.ro,0,0,1,1,0.0,0.0
Andre Ventura,www.aktual24.ro,0,1,0,1,-1.0,1.0
Faro,www.aktual24.ro,0,0,1,1,0.0,0.0
Odemira,www.aktual24.ro,0,0,1,1,0.0,0.0
politică,www.aktual24.ro,0,0,1,1,0.0,0.0
Setubal,www.aktual24.ro,0,0,1,1,0.0,0.0
Tavira,www.aktual24.ro,0,0,1,1,0.0,0.0
Ventura,www.aktual24.ro,0,0,1,1,0.0,0.0
Oana Crețu,www.euronews.ro,0,0,1,1,0.0,0.0
Attila Cseke,www.aktual24.ro,0,0,2,2,0.0,0.0
Cătălin Stoica,www.comisarul.ro,0,0,2,2,0.0,0.0
Keir Starmer,www.realitatea.net,0,0,1,1,0.0,0.0
Kiev,www.realitatea.net,0,1,0,1,-1.0,1.0
Marea Britanie,www.realitatea.net,1,0,0,1,1.0,1.0
Starmer,www.realitatea.net,0,0,1,1,0.0,0.0
dictator,www.realitatea.net,0,1,0,1,-1.0,1.0
Adrian Ioan Veștea,www.mediafax.ro,0,0,1,1,0.0,0.0
Veștea,www.mediafax.ro,0,0,1,1,0.0,0.0
Alin Iacob,snoop.ro,0,0,3,3,0.0,0.0
Daniel Velicu,snoop.ro,0,0,1,1,0.0,0.0
Belgia,snoop.ro,0,0,2,2,0.0,0.0
Claudiu Năsui,snoop.ro,0,0,2,2,0.0,0.0
Clienți,snoop.ro,0,0,1,1,0.0,0.0
Corneliu Ionescu,snoop.ro,2,0,1,3,0.6666666666666666,0.6666666666666666
Cuculis,snoop.ro,0,0,1,1,0.0,0.0
Daniel Zamfir,snoop.ro,0,0,1,1,0.0,0.0
Dorin,snoop.ro,0,0,3,3,0.0,0.0
Elene,snoop.ro,0,0,1,1,0.0,0.0
Horă,snoop.ro,0,1,0,1,-1.0,1.0
Iacob,snoop.ro,0,0,2,2,0.0,0.0
Isărescu,snoop.ro,0,0,1,1,0.0,0.0
Mirel,snoop.ro,0,0,1,1,0.0,0.0
Mugur Isărescu,snoop.ro,0,0,2,2,0.0,0.0
Norwood,snoop.ro,0,0,1,1,0.0,0.0
Năsui,snoop.ro,0,0,1,1,0.0,0.0
Peter Norwood,snoop.ro,0,0,1,1,0.0,0.0
Roșiori de Vede,snoop.ro,0,0,1,1,0.0,0.0
Tatiana,snoop.ro,0,0,1,1,0.0,0.0
Tatianei,snoop.ro,0,0,1,1,0.0,0.0
Teleorman,snoop.ro,0,0,3,3,0.0,0.0
Zamfir,snoop.ro,0,0,1,1,0.0,0.0
Adrian Cuculis,snoop.ro,0,0,1,1,0.0,0.0
cunoscut,snoop.ro,0,1,1,2,-0.5,0.5
cămătar,snoop.ro,0,1,0,1,-1.0,1.0
executor judecătoresc,snoop.ro,0,1,1,2,-0.5,0.5
executor,snoop.ro,0,1,0,1,-1.0,1.0
licean,snoop.ro,0,0,1,1,0.0,0.0
Arina Delcea,www.euronews.ro,0,0,1,1,0.0,0.0
Marcel Bartic,www.euronews.ro,0,0,1,1,0.0,0.0
Marian Staș,www.euronews.ro,0,0,1,1,0.0,0.0
preșcolar,www.euronews.ro,0,1,0,1,-1.0,1.0
pilot,www.gandul.ro,0,0,1,1,0.0,0.0
Alexandru Peres,a1.ro,0,0,1,1,0.0,0.0
Antoanella Motoc,a1.ro,0,1,0,1,-1.0,1.0
Dorneanu,a1.ro,0,0,1,1,0.0,0.0
Puiu Hasotti,a1.ro,0,0,1,1,0.0,0.0
Ștefan Minea,a1.ro,0,0,1,1,0.0,0.0
Toni Grebla,a1.ro,0,1,0,1,-1.0,1.0
Valentin Zoltan Puskas,a1.ro,0,0,1,1,0.0,0.0
Valer Dorneanu,a1.ro,0,0,3,3,0.0,0.0
Benny Steinmetz,adevarul.ro,0,0,1,1,0.0,0.0
Bogdan Gheorghiu,adevarul.ro,0,0,1,1,0.0,0.0
Claudiu Crăciun,adevarul.ro,0,0,2,2,0.0,0.0
Corina Șuteu,adevarul.ro,0,0,1,1,0.0,0.0
Crăciun,adevarul.ro,0,0,1,1,0.0,0.0
Fouzhou,adevarul.ro,0,0,1,1,0.0,0.0
Magyar Nemzet,adevarul.ro,0,1,0,1,-1.0,1.0
Mihail Bumbeș,adevarul.ro,0,0,1,1,0.0,0.0
Montane,adevarul.ro,0,0,1,1,0.0,0.0
Octavian Goga,adevarul.ro,0,0,1,1,0.0,0.0
Roșia Montana,adevarul.ro,0,1,0,1,-1.0,1.0
Roșia Montană,adevarul.ro,0,2,1,3,-0.6666666666666666,0.6666666666666666
Roșia Montane,adevarul.ro,0,0,1,1,0.0,0.0
manifestant,adevarul.ro,0,2,0,2,-1.0,1.0
protestatar,adevarul.ro,0,3,1,4,-0.75,0.75
Ionuț Stroe,www.news.ro,1,0,1,2,0.5,0.5
Stroe,www.news.ro,0,0,1,1,0.0,0.0
Daniel Ghita,www.aktual24.ro,0,1,2,3,-0.3333333333333333,0.3333333333333333
Președinte,www.aktual24.ro,0,1,0,1,-1.0,1.0
Ghita,www.aktual24.ro,0,2,0,2,-1.0,1.0
Lipa,www.aktual24.ro,0,3,0,3,-1.0,1.0
patriot,www.aktual24.ro,0,1,0,1,-1.0,1.0
Vulpescu,www.aktual24.ro,0,1,0,1,-1.0,1.0
incompetent,www.aktual24.ro,0,1,0,1,-1.0,1.0
mitoman,www.aktual24.ro,0,1,0,1,-1.0,1.0
opozant,www.aktual24.ro,0,1,0,1,-1.0,1.0
Daniela Draghia,a1.ro,0,1,1,2,-0.5,0.5
directoare,a1.ro,0,1,0,1,-1.0,1.0
Draghia,a1.ro,0,1,0,1,-1.0,1.0
Eugen Nicolicea,a1.ro,0,0,1,1,0.0,0.0
Mircea Epure,a1.ro,0,0,1,1,0.0,0.0
Premierul Ungureanu,a1.ro,0,1,1,2,-0.5,0.5
Soci,www.aktual24.ro,0,1,0,1,-1.0,1.0
pierzător,www.aktual24.ro,0,1,0,1,-1.0,1.0
Adrian Axinia,www.g4media.ro,0,0,1,1,0.0,0.0
Avram Fițiu,www.g4media.ro,0,0,1,1,0.0,0.0
Ciprian Nicolae,www.g4media.ro,0,0,1,1,0.0,0.0
Dorina Barcari Ramona Ioana Bruynseels,www.g4media.ro,0,0,1,1,0.0,0.0
Mangalia,www.g4media.ro,0,0,1,1,0.0,0.0
Marius Dorin Lulea,www.g4media.ro,0,0,1,1,0.0,0.0
Radu Baltasiu,www.g4media.ro,0,0,1,1,0.0,0.0
Valer Kovacs,www.g4media.ro,0,0,1,1,0.0,0.0
inginer,www.g4media.ro,0,0,3,3,0.0,0.0
Cristi Săpunaru,primanews.ro,0,0,1,1,0.0,0.0
Giulești,primanews.ro,1,0,0,1,1.0,1.0
Săpunaru,primanews.ro,1,0,0,1,1.0,1.0
căpitan,primanews.ro,0,0,1,1,0.0,0.0
candidați,stirileprotv.ro,0,1,1,2,-0.5,0.5
manager,stirileprotv.ro,0,1,1,2,-0.5,0.5
Giurgiu,www.aktual24.ro,1,0,3,4,0.25,0.25
Giurgiuveni,www.aktual24.ro,1,0,0,1,1.0,1.0
Ialomița,www.aktual24.ro,0,0,1,1,0.0,0.0
Piedone,www.aktual24.ro,0,3,1,4,-0.75,0.75
giurgiuvener,www.aktual24.ro,0,1,0,1,-1.0,1.0
Omar Hayssam,recorder.ro,0,1,0,1,-1.0,1.0
Vasile Ion,recorder.ro,0,0,2,2,0.0,0.0
licean,recorder.ro,0,0,1,1,0.0,0.0
Ana Coman,pressone.ro,0,0,2,2,0.0,0.0
Anquetil Karoly Kolcsar,pressone.ro,0,1,1,2,-0.5,0.5
Berescu,pressone.ro,0,0,1,1,0.0,0.0
Corbeanca,pressone.ro,0,0,1,1,0.0,0.0
Crevedia,pressone.ro,0,0,1,1,0.0,0.0
Delia,pressone.ro,0,0,1,1,0.0,0.0
Ion Iordache,pressone.ro,0,1,1,2,-0.5,0.5
Londra,pressone.ro,0,0,2,2,0.0,0.0
Matei Capotă,pressone.ro,0,0,2,2,0.0,0.0
Milionara,pressone.ro,0,0,1,1,0.0,0.0
Monica Berescu,pressone.ro,0,0,1,1,0.0,0.0
Otopeni,pressone.ro,0,0,1,1,0.0,0.0
Râșnov,pressone.ro,0,0,1,1,0.0,0.0
Turceni,pressone.ro,0,0,2,2,0.0,0.0
Dîncu,agerpres.ro,0,0,1,1,0.0,0.0
Dolj,www.antena3.ro,0,0,1,1,0.0,0.0
Dolju,www.antena3.ro,0,0,1,1,0.0,0.0
La Buturugi,www.antena3.ro,0,0,1,1,0.0,0.0
Maglavit,www.antena3.ro,0,0,1,1,0.0,0.0
Petre Lupu,www.antena3.ro,0,0,1,1,0.0,0.0
Petrache Lupu,www.antena3.ro,0,0,1,1,0.0,0.0
cioban,www.antena3.ro,0,0,1,1,0.0,0.0
moderatoare,www.digi24.ro,0,0,1,1,0.0,0.0
Corina Corbu,www.aktual24.ro,0,0,1,1,0.0,0.0
Corinei Corbu,www.aktual24.ro,0,0,1,1,0.0,0.0
Cezar Corici,a1.ro,0,0,1,1,0.0,0.0
Boldea,a1.ro,0,1,0,1,-1.0,1.0
Gheorghe Falca,a1.ro,0,0,2,2,0.0,0.0
Pecica,a1.ro,0,0,2,2,0.0,0.0
Petru Antal,a1.ro,0,0,1,1,0.0,0.0
Cătălin Striblea,www.mediafax.ro,0,0,1,1,0.0,0.0
Ionuț Cristache,www.mediafax.ro,0,0,1,1,0.0,0.0
persoană fizică,www.g4media.ro,0,0,1,1,0.0,0.0
senior,www.g4media.ro,4,0,0,4,1.0,1.0
Richard Grenell,www.news.ro,0,0,1,1,0.0,0.0
Tate,www.news.ro,0,0,1,1,0.0,0.0
Toni Neacșu,www.realitatea.net,0,0,1,1,0.0,0.0
Georgescu Călin,www.realitatea.net,0,0,1,1,0.0,0.0
Dumitru Berciu,www.comisarul.ro,0,0,1,1,0.0,0.0
Poiana Vărbilău,www.comisarul.ro,0,0,1,1,0.0,0.0
Radu Coroamă,www.comisarul.ro,0,0,1,1,0.0,0.0
Simion Alexandru,www.comisarul.ro,0,0,2,2,0.0,0.0
Vlad Manoliu,www.comisarul.ro,0,0,1,1,0.0,0.0
artist,www.comisarul.ro,1,1,3,5,0.0,0.0
căpetenie,www.comisarul.ro,0,0,2,2,0.0,0.0
locanic,www.comisarul.ro,0,1,0,1,-1.0,1.0
prinț,www.comisarul.ro,0,1,0,1,-1.0,1.0
părinte,www.comisarul.ro,1,1,0,2,0.0,0.0
Mircea Geoana,www.aktual24.ro,0,0,1,1,0.0,0.0
evazionist,www.aktual24.ro,0,1,0,1,-1.0,1.0
finalist,www.aktual24.ro,0,0,1,1,0.0,0.0
Viorica Dancilă,www.aktual24.ro,0,0,1,1,0.0,0.0
președinte femeie,www.aktual24.ro,0,1,0,1,-1.0,1.0
miniștri,www.comisarul.ro,0,0,4,4,0.0,0.0
Anthony Albanese,www.euronews.ro,0,0,1,1,0.0,0.0
Coreea de Sud,www.euronews.ro,0,0,1,1,0.0,0.0
India,www.euronews.ro,0,0,1,1,0.0,0.0
Roma,www.euronews.ro,0,0,1,1,0.0,0.0
Von der Leyen,www.euronews.ro,0,0,1,1,0.0,0.0
Alexandra Samoilă,snoop.ro,0,0,1,1,0.0,0.0
Ana Dumitru,snoop.ro,0,0,1,1,0.0,0.0
Bogdan Manolea,snoop.ro,0,0,2,2,0.0,0.0
Bogdan Sturzu,snoop.ro,0,0,1,1,0.0,0.0
Brezeanu,snoop.ro,0,0,1,1,0.0,0.0
Cristina Bolmadir,snoop.ro,0,0,1,1,0.0,0.0
Drăgușin,snoop.ro,0,0,1,1,0.0,0.0
Marius Drăgușin,snoop.ro,0,0,1,1,0.0,0.0
Marius Florin Sturzu,snoop.ro,0,0,1,1,0.0,0.0
Nadia Bulgariu,snoop.ro,0,0,1,1,0.0,0.0
Sturzu,snoop.ro,0,0,1,1,0.0,0.0
Tecuci,snoop.ro,0,0,1,1,0.0,0.0
Telega,snoop.ro,0,0,1,1,0.0,0.0
barman,snoop.ro,0,0,1,1,0.0,0.0
Bulgariu,snoop.ro,0,0,1,1,0.0,0.0
soacra,snoop.ro,0,2,0,2,-1.0,1.0
terorist,snoop.ro,0,1,0,1,-1.0,1.0
Horațiu Nicolaidis,snoop.ro,0,0,1,1,0.0,0.0
Mihai Toader,www.luju.ro,0,0,1,1,0.0,0.0
făptuitor,www.luju.ro,0,4,0,4,-1.0,1.0
guvernator,www.euronews.ro,0,2,0,2,-1.0,1.0
Simona Halep,www.euronews.ro,0,0,1,1,0.0,0.0
Tel Aviv,www.euronews.ro,0,0,2,2,0.0,0.0
Texas,www.euronews.ro,0,1,2,3,-0.3333333333333333,0.3333333333333333
Andri Kovalenko,www.comisarul.ro,0,0,1,1,0.0,0.0
Vladimir,www.comisarul.ro,0,0,1,1,0.0,0.0
Olanesti,a1.ro,0,0,1,1,0.0,0.0
guvernant,a1.ro,0,2,0,2,-1.0,1.0
Armand,stirileprotv.ro,0,1,0,1,-1.0,1.0
Arabia Saudită,www.cotidianul.ro,0,0,1,1,0.0,0.0
Barnier,www.cotidianul.ro,0,0,1,1,0.0,0.0
Le Pen,www.cotidianul.ro,0,0,1,1,0.0,0.0
Michel Barnier,www.cotidianul.ro,0,0,1,1,0.0,0.0
Mihai Morar,www.g4media.ro,0,0,1,1,0.0,0.0
Bădălău,www.euronews.ro,0,1,0,1,-1.0,1.0
Niculae Bădălău,www.euronews.ro,0,0,1,1,0.0,0.0
apropiat,www.euronews.ro,0,0,1,1,0.0,0.0
Andreea Alexandru,www.comisarul.ro,0,0,1,1,0.0,0.0
George Calin,www.comisarul.ro,0,0,1,1,0.0,0.0
Ilinca Simion,www.comisarul.ro,0,0,1,1,0.0,0.0
bodyguard,www.comisarul.ro,0,0,1,1,0.0,0.0
Ciprian Șerban,primanews.ro,0,0,1,1,0.0,0.0
Șerban,primanews.ro,0,0,1,1,0.0,0.0
Ostașul Ciucă,www.gandul.ro,0,1,0,1,-1.0,1.0
comunicator,www.gandul.ro,0,0,1,1,0.0,0.0
cotizant,www.gandul.ro,0,1,0,1,-1.0,1.0
Cîțu,www.gandul.ro,1,0,1,2,0.5,0.5
Adrian Caciu,www.aktual24.ro,0,1,0,1,-1.0,1.0
Caciu,www.aktual24.ro,0,1,0,1,-1.0,1.0
Ioan Mircea Pașcu,www.digi24.ro,0,0,1,1,0.0,0.0
Ovidiu Raețchi,www.digi24.ro,0,0,1,1,0.0,0.0
Chițac,www.realitatea.net,0,1,0,1,-1.0,1.0
Andrei Baciu,www.aktual24.ro,0,1,0,1,-1.0,1.0
Cristina Traila,www.aktual24.ro,0,1,0,1,-1.0,1.0
Deca,www.aktual24.ro,0,0,1,1,0.0,0.0
Diana Paun,www.aktual24.ro,0,0,1,1,0.0,0.0
Ionut Stroe,www.aktual24.ro,0,0,1,1,0.0,0.0
Ligia Deca,www.aktual24.ro,0,1,1,2,-0.5,0.5
Mihai Voicu,www.aktual24.ro,0,0,1,1,0.0,0.0
Monica Anisie,www.aktual24.ro,0,0,1,1,0.0,0.0
Octavian Oprea,www.aktual24.ro,0,0,1,1,0.0,0.0
Sorin Cimpeanu,www.aktual24.ro,0,0,1,1,0.0,0.0
Vlad Nistor,www.aktual24.ro,0,0,1,1,0.0,0.0
Florin Cîțu,www.aktual24.ro,0,0,1,1,0.0,0.0
Radu Mihaiu,www.b1tv.ro,0,0,2,2,0.0,0.0
Serb,www.b1tv.ro,0,0,1,1,0.0,0.0
Victor,www.b1tv.ro,0,1,1,2,-0.5,0.5
Bănicioiu,www.b1tv.ro,0,1,0,1,-1.0,1.0
domnul Ponta,www.b1tv.ro,0,1,0,1,-1.0,1.0
vinovat,www.b1tv.ro,0,1,0,1,-1.0,1.0
Nelu Tătaru,adevarul.ro,0,0,1,1,0.0,0.0
Tătaru,adevarul.ro,0,0,1,1,0.0,0.0
Adrian Năstase,www.antena3.ro,0,0,3,3,0.0,0.0
parvenit,www.news.ro,0,1,0,1,-1.0,1.0
Sinaia,www.comisarul.ro,0,0,1,1,0.0,0.0
Vlad Oprea,www.comisarul.ro,0,1,0,1,-1.0,1.0
Oprea Vlad Gheorghe,www.comisarul.ro,0,1,0,1,-1.0,1.0
Cosette Chichirău,primanews.ro,0,0,2,2,0.0,0.0
Călin Georgescu Anton Pisaroglu,adevarul.ro,0,0,1,1,0.0,0.0
Ispas Paul,adevarul.ro,0,0,1,1,0.0,0.0
Marcu Maria,adevarul.ro,0,0,1,1,0.0,0.0
Muscel,adevarul.ro,0,0,1,1,0.0,0.0
Vanea Matei,adevarul.ro,0,0,1,1,0.0,0.0
Vieriu Constantin,adevarul.ro,0,0,1,1,0.0,0.0
Marcela Șandru,adevarul.ro,0,0,1,1,0.0,0.0
Bota,pressone.ro,0,0,1,1,0.0,0.0
Voluntarii,pressone.ro,0,0,1,1,0.0,0.0
militar voluntar,pressone.ro,1,0,0,1,1.0,1.0
Stroe,www.euronews.ro,0,0,1,1,0.0,0.0
Rompetrom,www.luju.ro,0,0,1,1,0.0,0.0
Cristian Popescu Piedone,adevarul.ro,0,2,1,3,-0.6666666666666666,0.6666666666666666
Herăstrău,adevarul.ro,0,1,0,1,-1.0,1.0
mămică,adevarul.ro,0,1,0,1,-1.0,1.0
bancher,adevarul.ro,0,2,0,2,-1.0,1.0
bonele,adevarul.ro,0,1,0,1,-1.0,1.0
zeu,adevarul.ro,0,1,0,1,-1.0,1.0
apropiere,www.aktual24.ro,0,0,1,1,0.0,0.0
bătrân,www.aktual24.ro,0,0,1,1,0.0,0.0
bolnav,www.aktual24.ro,0,0,1,1,0.0,0.0
Nicolae Popescu,adevarul.ro,0,0,1,1,0.0,0.0
Câmpulung,www.news.ro,1,0,0,1,1.0,1.0
traficant,www.news.ro,0,1,0,1,-1.0,1.0
Karl Nehammer,stirileprotv.ro,0,0,2,2,0.0,0.0
Manfred Weber,stirileprotv.ro,0,0,4,4,0.0,0.0
popular,stirileprotv.ro,0,0,2,2,0.0,0.0
Romexpo,stirileprotv.ro,0,0,1,1,0.0,0.0
manifestanț,stirileprotv.ro,0,1,0,1,-1.0,1.0
matematician,www.luju.ro,0,0,1,1,0.0,0.0
ministră,www.luju.ro,0,1,0,1,-1.0,1.0
cioloș,www.antena3.ro,0,0,1,1,0.0,0.0
Corneliu Zelea Codreanu,www.antena3.ro,0,1,0,1,-1.0,1.0
Călărași,www.antena3.ro,0,1,1,2,-0.5,0.5
Elveția,www.antena3.ro,0,0,1,1,0.0,0.0
Ion Antonescu,www.antena3.ro,0,1,0,1,-1.0,1.0
Malița,www.antena3.ro,0,0,1,1,0.0,0.0
Marcian Bleahu,www.antena3.ro,0,0,1,1,0.0,0.0
Mircea Malița,www.antena3.ro,0,0,1,1,0.0,0.0
Mugur Isărescu,www.antena3.ro,0,0,1,1,0.0,0.0
Nicolae Iorga,www.antena3.ro,0,0,1,1,0.0,0.0
Stolojan,www.antena3.ro,0,0,1,1,0.0,0.0
Ulteior,www.antena3.ro,0,0,1,1,0.0,0.0
adjunct,www.antena3.ro,0,0,1,1,0.0,0.0
vinovat,www.antena3.ro,0,1,0,1,-1.0,1.0
Beijing,www.news.ro,0,0,1,1,0.0,0.0
China,www.news.ro,0,0,1,1,0.0,0.0
Kremlin,www.news.ro,0,2,0,2,-1.0,1.0
Dan Drăgan,stirileprotv.ro,0,0,1,1,0.0,0.0
Pavel Nițulescu,stirileprotv.ro,0,0,1,1,0.0,0.0
profesionist,stirileprotv.ro,2,0,0,2,1.0,1.0
Avocatul Poporului,www.news.ro,0,0,1,1,0.0,0.0
Renate Weber,www.news.ro,0,0,1,1,0.0,0.0
rezervist,www.news.ro,0,1,0,1,-1.0,1.0
Anca Dinu,a1.ro,0,0,1,1,0.0,0.0
Cocos,a1.ro,0,2,0,2,-1.0,1.0
Daniel Cozac,a1.ro,0,0,3,3,0.0,0.0
Dorin Cocos,a1.ro,0,0,2,2,0.0,0.0
Dani,a1.ro,0,0,1,1,0.0,0.0
Daniela Andreescu,a1.ro,0,0,1,1,0.0,0.0
Huelva,a1.ro,0,0,1,1,0.0,0.0
Marbella,a1.ro,0,0,1,1,0.0,0.0
Marcel,a1.ro,0,0,1,1,0.0,0.0
Sevilla,a1.ro,0,0,1,1,0.0,0.0
s,a1.ro,0,1,0,1,-1.0,1.0
Corneliu Zelea Codreanu,pressone.ro,0,1,0,1,-1.0,1.0
Dumitru Dragomir,pressone.ro,0,0,1,1,0.0,0.0
Ivan Subotić,pressone.ro,0,0,1,1,0.0,0.0
Kosovo,pressone.ro,0,0,1,1,0.0,0.0
Valea Uzului,pressone.ro,0,0,1,1,0.0,0.0
corespondent,pressone.ro,0,0,1,1,0.0,0.0
mareșal,pressone.ro,0,1,0,1,-1.0,1.0
spectator,pressone.ro,0,2,1,3,-0.6666666666666666,0.6666666666666666
Palestina,recorder.ro,0,0,1,1,0.0,0.0
Tel Aviv,recorder.ro,0,1,2,3,-0.3333333333333333,0.3333333333333333
Burduja,www.digi24.ro,0,0,1,1,0.0,0.0
Hunor,www.romaniatv.net,0,1,1,2,-0.5,0.5
Kelemen,www.romaniatv.net,0,1,0,1,-1.0,1.0
Helena Dalli,adevarul.ro,0,0,2,2,0.0,0.0
Bjola,www.comisarul.ro,0,0,1,1,0.0,0.0
Chișinău,www.comisarul.ro,0,1,3,4,-0.25,0.25
Fota,www.comisarul.ro,0,0,1,1,0.0,0.0
Mirabela,www.comisarul.ro,0,0,1,1,0.0,0.0
Radu Buzăianu,www.comisarul.ro,0,1,0,1,-1.0,1.0
Răzvan Zamfir,www.comisarul.ro,0,0,1,1,0.0,0.0
cântăreț,www.comisarul.ro,0,0,1,1,0.0,0.0
Metsola,www.comisarul.ro,0,0,1,1,0.0,0.0
David,www.comisarul.ro,1,0,0,1,1.0,1.0
Naumescu,www.comisarul.ro,0,0,1,1,0.0,0.0
fotbalist,www.comisarul.ro,0,0,3,3,0.0,0.0
om de cultură,www.comisarul.ro,1,0,0,1,1.0,1.0
oamn,www.comisarul.ro,0,1,0,1,-1.0,1.0
unionist,www.comisarul.ro,0,1,0,1,-1.0,1.0
Diaconescu,pressone.ro,0,1,0,1,-1.0,1.0
destui,pressone.ro,0,1,0,1,-1.0,1.0
Capsa,www.aktual24.ro,0,1,0,1,-1.0,1.0
Caragiale,www.aktual24.ro,0,0,1,1,0.0,0.0
Ciolos,www.aktual24.ro,0,0,2,2,0.0,0.0
Lazaroiu,www.aktual24.ro,0,1,0,1,-1.0,1.0
Iepurasi,www.aktual24.ro,0,1,0,1,-1.0,1.0
Isarescu,www.aktual24.ro,0,1,0,1,-1.0,1.0
Robert F. Kennedy Jr,www.aktual24.ro,0,1,0,1,-1.0,1.0
Terhes,www.aktual24.ro,0,1,0,1,-1.0,1.0
ghid,www.aktual24.ro,0,0,1,1,0.0,0.0
iepurat,www.aktual24.ro,0,1,0,1,-1.0,1.0
Prezidențiabil,www.comisarul.ro,0,0,1,1,0.0,0.0
mic,a1.ro,0,0,1,1,0.0,0.0
Estonia,www.news.ro,1,0,0,1,1.0,1.0
avocat,www.news.ro,1,0,0,1,1.0,1.0
fugitiv,www.news.ro,0,1,0,1,-1.0,1.0
ia,www.news.ro,0,0,1,1,0.0,0.0
multor,www.news.ro,0,1,0,1,-1.0,1.0
întreprinzător,www.news.ro,2,0,0,2,1.0,1.0
Dan Șucu,www.digi24.ro,0,0,2,2,0.0,0.0
Elena Crâmgașu,www.digi24.ro,0,0,1,1,0.0,0.0
finanțator,www.digi24.ro,0,0,1,1,0.0,0.0
Crin,www.euronews.ro,0,0,1,1,0.0,0.0
Votanțiu,www.euronews.ro,0,1,1,2,-0.5,0.5
Caramitru,www.romaniatv.net,0,0,1,1,0.0,0.0
Robert Sighiartău,www.romaniatv.net,0,0,2,2,0.0,0.0
Sighiartău,www.romaniatv.net,0,0,1,1,0.0,0.0
Cosmin,www.romaniatv.net,0,1,0,1,-1.0,1.0
POT,www.romaniatv.net,0,1,0,1,-1.0,1.0
Simion Aur,www.romaniatv.net,0,1,0,1,-1.0,1.0
excursionișt,www.romaniatv.net,0,0,1,1,0.0,0.0
personalitate,www.g4media.ro,0,1,3,4,-0.25,0.25
Chichirău,observatornews.ro,0,0,1,1,0.0,0.0
Suciu,www.gandul.ro,0,0,1,1,0.0,0.0
mulțime,www.cotidianul.ro,1,0,0,1,1.0,1.0
Alexandru Nanu,recorder.ro,0,1,0,1,-1.0,1.0
Mihai Oprea,recorder.ro,0,0,2,2,0.0,0.0
Vîlceanu,recorder.ro,0,0,1,1,0.0,0.0
Varujan Vosganian,www.mediafax.ro,0,0,2,2,0.0,0.0
cano,pressone.ro,0,0,1,1,0.0,0.0
Cristi Maliș,pressone.ro,0,0,1,1,0.0,0.0
Doroteia,pressone.ro,0,0,1,1,0.0,0.0
Fălticeni,pressone.ro,0,0,1,1,0.0,0.0
Gianina,pressone.ro,0,1,0,1,-1.0,1.0
Gianina Beleagă,pressone.ro,0,0,1,1,0.0,0.0
Ionela,pressone.ro,0,1,0,1,-1.0,1.0
Ionela Lehaci,pressone.ro,0,0,1,1,0.0,0.0
Ionelei Lehaci,pressone.ro,0,0,1,1,0.0,0.0
Plutonița,pressone.ro,0,0,1,1,0.0,0.0
Sarasota,pressone.ro,0,0,1,1,0.0,0.0
Valea Moldovei,pressone.ro,0,0,1,1,0.0,0.0
cadet,pressone.ro,0,1,0,1,-1.0,1.0
competitoare,pressone.ro,0,1,0,1,-1.0,1.0
fete,pressone.ro,0,0,1,1,0.0,0.0
mireasă,pressone.ro,0,1,0,1,-1.0,1.0
Cristina Trăilă,www.cotidianul.ro,0,0,2,2,0.0,0.0
Doru Trăilă,www.cotidianul.ro,0,2,0,2,-1.0,1.0
Dumitru Dumbravă,www.cotidianul.ro,0,0,1,1,0.0,0.0
Mihai Emil Tufan,www.cotidianul.ro,0,2,0,2,-1.0,1.0
Mihai Tufan,www.cotidianul.ro,0,0,1,1,0.0,0.0
Petru Zoltan,www.cotidianul.ro,0,0,1,1,0.0,0.0
Trăilă,www.cotidianul.ro,0,1,0,1,-1.0,1.0
soț,www.cotidianul.ro,1,0,1,2,0.5,0.5
Cristian Hrițuc,www.comisarul.ro,0,0,1,1,0.0,0.0
Delicote,www.comisarul.ro,0,0,1,1,0.0,0.0
George Simeon,www.comisarul.ro,0,1,0,1,-1.0,1.0
Hrițuc,www.comisarul.ro,0,0,1,1,0.0,0.0
SOS,www.comisarul.ro,0,1,0,1,-1.0,1.0
Sorin,www.comisarul.ro,0,0,1,1,0.0,0.0
Y,www.comisarul.ro,0,0,1,1,0.0,0.0
actor,www.comisarul.ro,1,0,1,2,0.5,0.5
factor,www.comisarul.ro,0,1,0,1,-1.0,1.0
Alduy,www.aktual24.ro,0,0,1,1,0.0,0.0
Bardella,www.aktual24.ro,0,0,1,1,0.0,0.0
Cécile Alduy,www.aktual24.ro,0,0,1,1,0.0,0.0
Denis,www.aktual24.ro,0,0,1,1,0.0,0.0
Jordan Bardella,www.aktual24.ro,0,0,1,1,0.0,0.0
Le Pen,www.aktual24.ro,0,0,1,1,0.0,0.0
Seine,www.aktual24.ro,0,0,1,1,0.0,0.0
mentor,www.aktual24.ro,0,0,1,1,0.0,0.0
tătăl,www.aktual24.ro,0,0,2,2,0.0,0.0
urmăritor,www.aktual24.ro,0,0,1,1,0.0,0.0
Andreea Catrina,observatornews.ro,0,0,1,1,0.0,0.0
poet,observatornews.ro,1,0,0,1,1.0,1.0
David Popovici,www.comisarul.ro,1,0,0,1,1.0,1.0
Popovici,www.comisarul.ro,0,0,1,1,0.0,0.0
inginer,www.comisarul.ro,0,0,1,1,0.0,0.0
mecanic,www.comisarul.ro,0,0,1,1,0.0,0.0
sportiv,www.comisarul.ro,0,0,2,2,0.0,0.0
student,www.comisarul.ro,1,0,6,7,0.14285714285714285,0.14285714285714285
Varujan Pambuccian,www.luju.ro,0,1,1,2,-0.5,0.5
Biden,www.comisarul.ro,0,0,1,1,0.0,0.0
Reșița,www.antena3.ro,0,0,2,2,0.0,0.0
Riad,www.antena3.ro,0,0,1,1,0.0,0.0
Campulung,observatornews.ro,1,0,0,1,1.0,1.0
Cristian Seidler,observatornews.ro,0,0,1,1,0.0,0.0
Câmpulung Muscel,observatornews.ro,0,0,1,1,0.0,0.0
Drula,observatornews.ro,0,1,0,1,-1.0,1.0
Oana Lasconi,observatornews.ro,0,0,1,1,0.0,0.0
fiică,observatornews.ro,0,1,1,2,-0.5,0.5
jurnalistă,observatornews.ro,0,0,1,1,0.0,0.0
vedetel,observatornews.ro,0,0,1,1,0.0,0.0
căpitan,www.activenews.ro,0,1,1,2,-0.5,0.5
Orlea,www.activenews.ro,0,0,1,1,0.0,0.0
Soros,www.activenews.ro,0,2,0,2,-1.0,1.0
Ursula von der Leyen,www.activenews.ro,0,1,0,1,-1.0,1.0
Vădastra,www.activenews.ro,0,0,1,1,0.0,0.0
boier,www.activenews.ro,0,1,1,2,-0.5,0.5
Propopescu,www.activenews.ro,0,0,1,1,0.0,0.0
dumnealor,www.activenews.ro,0,1,0,1,-1.0,1.0
fecior,www.activenews.ro,0,0,1,1,0.0,0.0
fete,www.activenews.ro,0,1,1,2,-0.5,0.5
vice,www.activenews.ro,0,1,0,1,-1.0,1.0
țastă,www.activenews.ro,0,1,0,1,-1.0,1.0
Adrian Cioroianu,www.digi24.ro,0,0,2,2,0.0,0.0
Alex Nedea,www.digi24.ro,0,0,1,1,0.0,0.0
Vladimir Ciorbă,www.digi24.ro,0,0,1,1,0.0,0.0
Covasna,www.digi24.ro,1,0,0,1,1.0,1.0
Elena Laconi,www.digi24.ro,0,0,1,1,0.0,0.0
Elenea Lasconi,www.digi24.ro,0,0,1,1,0.0,0.0
fetele,www.digi24.ro,0,1,0,1,-1.0,1.0
Florin Negrutiu,www.digi24.ro,0,0,1,1,0.0,0.0
Harghita,www.digi24.ro,1,0,0,1,1.0,1.0
Ion M. Ioniță,www.digi24.ro,0,0,1,1,0.0,0.0
Ionuț Bodonea,www.digi24.ro,0,0,1,1,0.0,0.0
Kemelen Hunor,www.digi24.ro,0,0,1,1,0.0,0.0
Lili Ruse,www.digi24.ro,0,0,1,1,0.0,0.0
Marco Rubio,www.digi24.ro,0,0,1,1,0.0,0.0
Marko Balint,www.digi24.ro,0,1,0,1,-1.0,1.0
Mircea Goană,www.digi24.ro,0,0,1,1,0.0,0.0
negociator,www.digi24.ro,0,1,0,1,-1.0,1.0
Netanyahu,www.digi24.ro,0,1,0,1,-1.0,1.0
Nicoale Ciucă,www.digi24.ro,1,0,0,1,1.0,1.0
Palestina,www.digi24.ro,0,0,1,1,0.0,0.0
Sabin Orcan,www.digi24.ro,0,0,1,1,0.0,0.0
spectator,www.digi24.ro,0,0,1,1,0.0,0.0
Târgu Jiu,www.digi24.ro,0,0,1,1,0.0,0.0
Vicol,www.digi24.ro,0,0,1,1,0.0,0.0
Vlad Craioveanu,www.digi24.ro,0,1,0,1,-1.0,1.0
Vlad Gheorghe,www.digi24.ro,0,0,1,1,0.0,0.0
bolnav,www.digi24.ro,0,1,0,1,-1.0,1.0
cadru medical,www.digi24.ro,0,1,0,1,-1.0,1.0
chirurg,www.digi24.ro,0,0,1,1,0.0,0.0
cititor,www.digi24.ro,0,0,1,1,0.0,0.0
consumator,www.digi24.ro,1,1,0,2,0.0,0.0
dascăl,www.digi24.ro,1,0,0,1,1.0,1.0
dealer,www.digi24.ro,0,1,0,1,-1.0,1.0
delincvent,www.digi24.ro,0,1,0,1,-1.0,1.0
dependent,www.digi24.ro,0,2,0,2,-1.0,1.0
domnul Geoană,www.digi24.ro,0,1,0,1,-1.0,1.0
domnule Geoană,www.digi24.ro,0,1,0,1,-1.0,1.0
Tomac,www.digi24.ro,1,0,0,1,1.0,1.0
extremist,www.digi24.ro,0,1,0,1,-1.0,1.0
gazdă,www.digi24.ro,0,1,0,1,-1.0,1.0
mamelă,www.digi24.ro,0,1,0,1,-1.0,1.0
mediator,www.digi24.ro,0,0,1,1,0.0,0.0
președinte arhitect,www.digi24.ro,0,1,0,1,-1.0,1.0
responsabil,www.digi24.ro,0,1,0,1,-1.0,1.0
rudă,www.digi24.ro,0,1,0,1,-1.0,1.0
telespectator,www.digi24.ro,0,1,1,2,-0.5,0.5
traficant,www.digi24.ro,0,1,0,1,-1.0,1.0
voi,www.digi24.ro,0,1,0,1,-1.0,1.0
votant,www.digi24.ro,0,1,0,1,-1.0,1.0
împrumutător,www.digi24.ro,0,1,0,1,-1.0,1.0
Cristian Diaconescu,www.romaniatv.net,0,0,2,2,0.0,0.0
Andreea Marin,pressone.ro,0,0,1,1,0.0,0.0
Basel,pressone.ro,0,0,1,1,0.0,0.0
Bistrița Năsăud,pressone.ro,0,0,3,3,0.0,0.0
David Steele,pressone.ro,0,0,1,1,0.0,0.0
Gen Z,pressone.ro,0,0,1,1,0.0,0.0
Cristian Tudor Popescu,pressone.ro,0,0,1,1,0.0,0.0
ministră,pressone.ro,0,1,0,1,-1.0,1.0
Remus Ștefureac,pressone.ro,0,0,1,1,0.0,0.0
Tolstoi,pressone.ro,0,0,1,1,0.0,0.0
programator,pressone.ro,0,0,1,1,0.0,0.0
ziarist,agerpres.ro,1,0,1,2,0.5,0.5
Andrei Dîrlău,www.digi24.ro,0,0,1,1,0.0,0.0
George Becali,www.digi24.ro,0,1,3,4,-0.25,0.25
Bolojan Ilie,www.digi24.ro,0,1,0,1,-1.0,1.0
Ciprian Ciubuc,www.digi24.ro,0,0,1,1,0.0,0.0
Ciprian Titi Stoica,www.digi24.ro,0,0,1,1,0.0,0.0
Ciubuc,www.digi24.ro,0,1,0,1,-1.0,1.0
Cuza,www.digi24.ro,0,1,0,1,-1.0,1.0
Georges Simion,www.digi24.ro,0,0,1,1,0.0,0.0
Kogălniceanu,www.digi24.ro,0,1,0,1,-1.0,1.0
Maniu,www.digi24.ro,0,1,0,1,-1.0,1.0
Mihai Enache,www.digi24.ro,0,0,1,1,0.0,0.0
cioban,www.digi24.ro,0,1,1,2,-0.5,0.5
SOS,www.digi24.ro,0,1,0,1,-1.0,1.0
doamna Șoșoacă,www.digi24.ro,0,1,0,1,-1.0,1.0
ziarist,www.digi24.ro,0,1,0,1,-1.0,1.0
Daniel Buda,stirileprotv.ro,0,1,0,1,-1.0,1.0
colegă,stirileprotv.ro,0,1,0,1,-1.0,1.0
Minica Iacob Ridzi,stirileprotv.ro,0,1,0,1,-1.0,1.0
Barcani,www.g4media.ro,0,0,1,1,0.0,0.0
Dobârlău,www.g4media.ro,0,1,0,1,-1.0,1.0
Hăghig,www.g4media.ro,0,1,0,1,-1.0,1.0
Sita Buzău,www.g4media.ro,0,0,1,1,0.0,0.0
Valea Mare,www.g4media.ro,0,1,0,1,-1.0,1.0
Vâlcele,www.g4media.ro,0,0,1,1,0.0,0.0
Întorsura Buzăului,www.g4media.ro,0,0,2,2,0.0,0.0
Gerogescu,www.aktual24.ro,0,1,0,1,-1.0,1.0
Neamțu,www.aktual24.ro,0,0,1,1,0.0,0.0
Constantinescu,adevarul.ro,0,1,1,2,-0.5,0.5
Cristian Paturca,adevarul.ro,0,0,1,1,0.0,0.0
Danut Cornea,adevarul.ro,0,0,1,1,0.0,0.0
Decebal Remes,adevarul.ro,0,0,1,1,0.0,0.0
Dr. Barbi,adevarul.ro,0,0,1,1,0.0,0.0
George Șerban,adevarul.ro,0,0,1,1,0.0,0.0
Max Badiu,adevarul.ro,0,0,1,1,0.0,0.0
Octavian Bot,adevarul.ro,0,0,1,1,0.0,0.0
Tunis,adevarul.ro,0,0,1,1,0.0,0.0
Vlad Rosca,adevarul.ro,0,0,1,1,0.0,0.0
Zoe Petre,adevarul.ro,0,0,1,1,0.0,0.0
Fritz,adevarul.ro,0,0,3,3,0.0,0.0
puber,recorder.ro,1,0,0,1,1.0,1.0
Auckland,www.gandul.ro,0,0,1,1,0.0,0.0
Australia,www.gandul.ro,0,0,1,1,0.0,0.0
Bunul Dumnezeu,www.gandul.ro,1,0,0,1,1.0,1.0
Filipine,www.gandul.ro,0,0,1,1,0.0,0.0
Hong Kong,www.gandul.ro,0,0,1,1,0.0,0.0
Maica Domnului,www.gandul.ro,1,0,0,1,1.0,1.0
Malaysia,www.gandul.ro,0,0,1,1,0.0,0.0
Mihai Mircea Corpodean,www.gandul.ro,1,0,3,4,0.25,0.25
Noua Zeelandă,www.gandul.ro,0,0,1,1,0.0,0.0
preot,www.gandul.ro,2,0,0,2,1.0,1.0
Coreea de Sud,www.gandul.ro,1,0,2,3,0.3333333333333333,0.3333333333333333
Sfântul Ignatie Teoforul,www.gandul.ro,0,0,1,1,0.0,0.0
Singapore,www.gandul.ro,0,0,1,1,0.0,0.0
Thailanda,www.gandul.ro,0,0,1,1,0.0,0.0
Vietnam,www.gandul.ro,0,0,1,1,0.0,0.0
căsător,www.gandul.ro,1,0,0,1,1.0,1.0
paroh,www.gandul.ro,0,0,1,1,0.0,0.0
Cristian Buican,www.realitatea.net,0,1,0,1,-1.0,1.0
Fecioara Maria,www.realitatea.net,0,1,0,1,-1.0,1.0
Iftimie,www.realitatea.net,0,1,0,1,-1.0,1.0
Ilftime,www.realitatea.net,0,1,0,1,-1.0,1.0
Laura Codruța Kovesi,www.realitatea.net,0,1,0,1,-1.0,1.0
Maia Sandu,www.realitatea.net,1,0,1,2,0.5,0.5
Oradea,www.realitatea.net,0,1,1,2,-0.5,0.5
Valcea,www.realitatea.net,0,1,0,1,-1.0,1.0
artizan,www.realitatea.net,0,1,0,1,-1.0,1.0
liberal,www.realitatea.net,0,1,0,1,-1.0,1.0
liber,www.realitatea.net,0,1,0,1,-1.0,1.0
prim-vicepreședinte,www.realitatea.net,0,1,0,1,-1.0,1.0
Iohannis,www.realitatea.net,0,1,1,2,-0.5,0.5
Aurelian Virgil Băluță,snoop.ro,0,0,1,1,0.0,0.0
Bleahu,snoop.ro,0,0,1,1,0.0,0.0
Cristian Hera,snoop.ro,0,0,1,1,0.0,0.0
Ecaterina Andronescu,snoop.ro,0,0,1,1,0.0,0.0
Emil Calotă,snoop.ro,0,0,1,1,0.0,0.0
Eugen Simion,snoop.ro,0,0,1,1,0.0,0.0
Geneva,snoop.ro,0,0,1,1,0.0,0.0
Iliescu,snoop.ro,0,0,1,1,0.0,0.0
Ioan Oltean,snoop.ro,0,1,1,2,-0.5,0.5
Mircea Malița,snoop.ro,0,0,1,1,0.0,0.0
Oltean,snoop.ro,0,0,1,1,0.0,0.0
Petre Roman,snoop.ro,0,0,1,1,0.0,0.0
Regatul Unit,snoop.ro,0,0,1,1,0.0,0.0
Romică Tomescu,snoop.ro,0,0,1,1,0.0,0.0
Sergiu Celac,snoop.ro,0,0,1,1,0.0,0.0
Viorel Raicu,snoop.ro,0,0,1,1,0.0,0.0
contracandidat,snoop.ro,0,3,1,4,-0.75,0.75
Daniel Dăianu,snoop.ro,0,0,1,1,0.0,0.0
Marcian Bleahu,snoop.ro,0,0,1,1,0.0,0.0
agricultor,primanews.ro,0,0,1,1,0.0,0.0
Constantin Crăciun,primanews.ro,0,0,1,1,0.0,0.0
organizator,primanews.ro,0,1,0,1,-1.0,1.0
sindicalist,primanews.ro,0,0,1,1,0.0,0.0
transportator,primanews.ro,0,0,1,1,0.0,0.0
Cătălin Cârstoiu,www.euronews.ro,0,1,0,1,-1.0,1.0
Ioan Aurel Pop,www.euronews.ro,0,0,1,1,0.0,0.0
Alkmaar,observatornews.ro,0,0,1,1,0.0,0.0
investigator,observatornews.ro,0,0,2,2,0.0,0.0
suspect,observatornews.ro,0,4,0,4,-1.0,1.0
hoț,observatornews.ro,0,2,0,2,-1.0,1.0
Țările de Jos,observatornews.ro,0,0,1,1,0.0,0.0
Marian,www.aktual24.ro,0,0,1,1,0.0,0.0
Mircea Marian,www.aktual24.ro,0,0,1,1,0.0,0.0
Britta Haselmann,www.aktual24.ro,0,0,1,1,0.0,0.0
Lars Klingbeil,www.aktual24.ro,0,0,1,1,0.0,0.0
Thorsten Frei,www.aktual24.ro,0,0,1,1,0.0,0.0
Uniunea,www.aktual24.ro,0,2,0,2,-1.0,1.0
unit,www.aktual24.ro,0,0,1,1,0.0,0.0
vicecancelar,www.aktual24.ro,0,0,1,1,0.0,0.0
Cristian Pătrășconiu,adevarul.ro,0,0,1,1,0.0,0.0
Cristina Țopescu,adevarul.ro,0,0,1,1,0.0,0.0
Sorin Roșca Stănescu,adevarul.ro,0,0,1,1,0.0,0.0
Traian Ungureanu,adevarul.ro,0,0,1,1,0.0,0.0
Tudor Barbu,adevarul.ro,0,0,1,1,0.0,0.0
acționar,adevarul.ro,0,0,1,1,0.0,0.0
Adrian Vornicu,www.romaniatv.net,2,0,0,2,1.0,1.0
Gheorghe Tinca,www.realitatea.net,0,0,2,2,0.0,0.0
Radu Tudor,www.realitatea.net,0,0,1,1,0.0,0.0
Benchescu,pressone.ro,0,0,1,1,0.0,0.0
Cataramă,pressone.ro,0,0,1,1,0.0,0.0
Claudia Benchescu,pressone.ro,0,0,1,1,0.0,0.0
Mihai Gâdea,pressone.ro,0,0,1,1,0.0,0.0
Mihai Voicu,pressone.ro,0,0,3,3,0.0,0.0
Mugurel Cozmanciuc,pressone.ro,0,0,1,1,0.0,0.0
Tabăra Bușoi,pressone.ro,0,0,1,1,0.0,0.0
Tiberiu Urdăreanu,pressone.ro,0,0,1,1,0.0,0.0
analișt,pressone.ro,0,2,0,2,-1.0,1.0
Dan Tăpălagă,pressone.ro,0,0,2,2,0.0,0.0
Cătălin Moroșanu,pressone.ro,0,0,1,1,0.0,0.0
Sulfina Barbu,pressone.ro,0,0,1,1,0.0,0.0
Constantin Titel Petrescu,www.romaniatv.net,0,0,1,1,0.0,0.0
Michael Dan Ujeucă,www.romaniatv.net,0,0,1,1,0.0,0.0
Oana Crețu,www.romaniatv.net,0,0,1,1,0.0,0.0
arhitect,www.romaniatv.net,0,0,1,1,0.0,0.0
inspector,www.romaniatv.net,0,0,1,1,0.0,0.0
secretariat,www.aktual24.ro,0,1,0,1,-1.0,1.0
Făgăraș,www.gandul.ro,0,0,1,1,0.0,0.0
matematician,www.gandul.ro,0,0,2,2,0.0,0.0
chestor,www.aktual24.ro,0,0,1,1,0.0,0.0
Borș,www.antena3.ro,0,0,1,1,0.0,0.0
Mădălin Borș,www.antena3.ro,1,0,0,1,1.0,1.0
aliat,www.antena3.ro,1,1,0,2,0.0,0.0
aliaț,www.antena3.ro,0,1,0,1,-1.0,1.0
ior,www.antena3.ro,0,0,1,1,0.0,0.0
Tăricianu,adevarul.ro,0,0,1,1,0.0,0.0
Bogdan Trif,www.digi24.ro,0,0,3,3,0.0,0.0
Lavinia Șandru,www.digi24.ro,0,0,1,1,0.0,0.0
Mediaș,www.digi24.ro,0,0,1,1,0.0,0.0
Potra,www.digi24.ro,0,0,1,1,0.0,0.0
Trif,www.digi24.ro,0,0,1,1,0.0,0.0
Gheorghe Roman,www.digi24.ro,0,0,1,1,0.0,0.0
Bavaria,www.gandul.ro,0,0,2,2,0.0,0.0
München,www.gandul.ro,0,0,2,2,0.0,0.0
suporter,www.gandul.ro,2,1,0,3,0.3333333333333333,0.3333333333333333
tricolor,www.gandul.ro,2,0,1,3,0.6666666666666666,0.6666666666666666
Daniel Funeriu,www.cotidianul.ro,0,0,2,2,0.0,0.0
Lavinia Șandru,www.cotidianul.ro,0,0,1,1,0.0,0.0
Sebastian Popescu,www.cotidianul.ro,0,0,1,1,0.0,0.0
respondent,www.cotidianul.ro,0,0,2,2,0.0,0.0
subiect,www.cotidianul.ro,0,0,1,1,0.0,0.0
Adina Marincea,pressone.ro,0,1,0,1,-1.0,1.0
Aprod Purice,pressone.ro,0,1,0,1,-1.0,1.0
Imperiul Roman,pressone.ro,0,0,1,1,0.0,0.0
Irlanda de Nord,pressone.ro,0,0,1,1,0.0,0.0
Mircea cel Bătrân,pressone.ro,0,0,1,1,0.0,0.0
Pascal Boyer,pressone.ro,1,0,0,1,1.0,1.0
Radu Oltean,pressone.ro,0,0,1,1,0.0,0.0
Regatul Unit al Marii Britanii,pressone.ro,0,0,1,1,0.0,0.0
Valahia,pressone.ro,0,0,1,1,0.0,0.0
Valah,pressone.ro,0,0,1,1,0.0,0.0
Vlad Pașca,pressone.ro,0,0,1,1,0.0,0.0
Vlad Țepes,pressone.ro,0,0,1,1,0.0,0.0
voievod,pressone.ro,1,0,0,1,1.0,1.0
Wrangham,pressone.ro,0,0,1,1,0.0,0.0
ascet,pressone.ro,1,0,0,1,1.0,1.0
cârmuitor,pressone.ro,0,1,0,1,-1.0,1.0
călugăr,pressone.ro,0,0,1,1,0.0,0.0
inferior,pressone.ro,0,1,0,1,-1.0,1.0
monarh,pressone.ro,0,0,1,1,0.0,0.0
receptor,pressone.ro,0,0,1,1,0.0,0.0
războinic,pressone.ro,0,0,1,1,0.0,0.0
sabotor,pressone.ro,0,1,0,1,-1.0,1.0
străbun,pressone.ro,0,0,1,1,0.0,0.0
strămoș,pressone.ro,0,1,1,2,-0.5,0.5
voievoz,pressone.ro,0,1,0,1,-1.0,1.0
Ștefan,pressone.ro,0,2,0,2,-1.0,1.0
Buican,www.cotidianul.ro,0,0,1,1,0.0,0.0
Cristian Buican,www.cotidianul.ro,0,0,2,2,0.0,0.0
Caransebes,www.cotidianul.ro,0,0,1,1,0.0,0.0
Petru Miculescu,www.cotidianul.ro,0,0,1,1,0.0,0.0
subprefect,www.cotidianul.ro,0,1,1,2,-0.5,0.5
Timișoara,www.cotidianul.ro,0,0,1,1,0.0,0.0
Titular,www.cotidianul.ro,0,0,1,1,0.0,0.0
constituant,www.cotidianul.ro,1,0,0,1,1.0,1.0
dans,www.cotidianul.ro,0,0,1,1,0.0,0.0
dl Johanis,www.cotidianul.ro,1,0,0,1,1.0,1.0
legiuitor,www.cotidianul.ro,0,1,0,1,-1.0,1.0
profesor doctor,www.cotidianul.ro,0,0,1,1,0.0,0.0
Anamaria Gavrila,adevarul.ro,0,0,1,1,0.0,0.0
opozant,www.comisarul.ro,0,1,0,1,-1.0,1.0
Steve Banon,www.euronews.ro,0,0,1,1,0.0,0.0
Emil Popa,www.comisarul.ro,0,0,1,1,0.0,0.0
Mario De Mezzo,www.comisarul.ro,0,1,0,1,-1.0,1.0
Adrian Paunescu,stirileprotv.ro,0,0,1,1,0.0,0.0
Nicolescu,stirileprotv.ro,0,0,1,1,0.0,0.0
Sergiu Nicolaescu,stirileprotv.ro,0,1,0,1,-1.0,1.0
Sergiu Nicolescu,stirileprotv.ro,0,0,1,1,0.0,0.0
Bogdan Pintileasa,www.gandul.ro,0,0,1,1,0.0,0.0
Vlad Popescu Piedone,www.gandul.ro,1,0,0,1,1.0,1.0
Daniel Băluță,www.gandul.ro,1,0,0,1,1.0,1.0
Fata,www.euronews.ro,0,0,1,1,0.0,0.0
Ion Rațiu,www.euronews.ro,0,0,1,1,0.0,0.0
Ionuț Pucheanu,www.euronews.ro,0,1,0,1,-1.0,1.0
Nicolae Rațiu,www.euronews.ro,0,2,1,3,-0.6666666666666666,0.6666666666666666
Oana Țoiu,www.euronews.ro,0,0,1,1,0.0,0.0
Pucheanu,www.euronews.ro,0,1,0,1,-1.0,1.0
Rațiu,www.euronews.ro,0,0,1,1,0.0,0.0
diplomat,www.euronews.ro,0,1,1,2,-0.5,0.5
Cătălina,www.gandul.ro,0,0,1,1,0.0,0.0
Cătălina Ștefănescu,www.gandul.ro,1,0,0,1,1.0,1.0
Dan Șova,www.gandul.ro,0,0,1,1,0.0,0.0
Tânăra,www.gandul.ro,0,0,1,1,0.0,0.0
Șova,www.gandul.ro,0,0,1,1,0.0,0.0
Cezar Baciu,observatornews.ro,0,0,1,1,0.0,0.0
Chirica,observatornews.ro,0,0,1,1,0.0,0.0
Mihai Chirica,observatornews.ro,1,0,2,3,0.3333333333333333,0.3333333333333333
erou,observatornews.ro,1,0,0,1,1.0,1.0
Andrei Alexandru,www.aktual24.ro,0,0,1,1,0.0,0.0
Aneta Matei,www.aktual24.ro,0,0,1,1,0.0,0.0
Cristian Ancu,www.aktual24.ro,0,0,1,1,0.0,0.0
Gabriela Horga,www.aktual24.ro,0,0,1,1,0.0,0.0
Gheorghe Piperea,www.aktual24.ro,0,0,1,1,0.0,0.0
Ciprian Purice,www.aktual24.ro,0,0,1,1,0.0,0.0
Albania,www.romaniatv.net,0,0,1,1,0.0,0.0
Alexandru Ciobotea,www.romaniatv.net,0,0,1,1,0.0,0.0
Algeria,www.romaniatv.net,0,0,1,1,0.0,0.0
Andrei Vila,www.romaniatv.net,0,0,1,1,0.0,0.0
Arabia Saudită,www.romaniatv.net,0,0,1,1,0.0,0.0
Azerbaijan,www.romaniatv.net,0,0,1,1,0.0,0.0
Bosnia și Herțegovina,www.romaniatv.net,0,0,1,1,0.0,0.0
David Ghibu,www.romaniatv.net,0,0,1,1,0.0,0.0
Emanuel Mazăre,www.romaniatv.net,0,0,1,1,0.0,0.0
Georgia,www.romaniatv.net,0,0,1,1,0.0,0.0
Grecia,www.romaniatv.net,0,0,2,2,0.0,0.0
Kirgistan,www.romaniatv.net,0,0,1,1,0.0,0.0
Macedonia de Nord,www.romaniatv.net,0,0,1,1,0.0,0.0
Malaysia,www.romaniatv.net,0,0,1,1,0.0,0.0
Muntenegru,www.romaniatv.net,0,0,1,1,0.0,0.0
Pavel Ciurea,www.romaniatv.net,0,0,1,1,0.0,0.0
Radu Stoleriu,www.romaniatv.net,0,0,1,1,0.0,0.0
Sarajevo,www.romaniatv.net,0,0,1,1,0.0,0.0
Serbia,www.romaniatv.net,0,0,1,1,0.0,0.0
Turkmenistan,www.romaniatv.net,0,0,1,1,0.0,0.0
Ovidiu Sontea,www.romaniatv.net,0,0,1,1,0.0,0.0
Valeriu Iftime,agerpres.ro,0,0,1,1,0.0,0.0
Cristian Diaconescu,observatornews.ro,0,0,3,3,0.0,0.0
München,observatornews.ro,0,0,1,1,0.0,0.0
Riad,observatornews.ro,0,0,1,1,0.0,0.0
Vicepreședintele,observatornews.ro,0,0,2,2,0.0,0.0
Eugen Rădulescu,www.comisarul.ro,0,1,1,2,-0.5,0.5
Rădulescu,www.comisarul.ro,0,1,0,1,-1.0,1.0
bancher,www.comisarul.ro,0,1,0,1,-1.0,1.0
Florin Tiutiu,www.g4media.ro,0,0,1,1,0.0,0.0
Gigel Știrbu,www.g4media.ro,0,1,2,3,-0.3333333333333333,0.3333333333333333
Laura Giura,www.g4media.ro,0,0,1,1,0.0,0.0
Marin Vasile,www.g4media.ro,0,0,1,1,0.0,0.0
Marius Bălașa,www.g4media.ro,0,0,1,1,0.0,0.0
Nicole Titulescu,www.g4media.ro,0,0,1,1,0.0,0.0
Răducu Șurlan,www.g4media.ro,0,0,1,1,0.0,0.0
Slatina,www.g4media.ro,0,0,3,3,0.0,0.0
Studina,www.g4media.ro,0,0,1,1,0.0,0.0
Victor Iacobescu,www.g4media.ro,0,0,1,1,0.0,0.0
Adam,www.gandul.ro,0,0,1,1,0.0,0.0
Dan Mihalache,www.gandul.ro,0,0,1,1,0.0,0.0
Hrebenciuc,www.gandul.ro,0,1,0,1,-1.0,1.0
Ilie Sîrbu,www.gandul.ro,0,1,2,3,-0.3333333333333333,0.3333333333333333
mort,www.gandul.ro,0,1,0,1,-1.0,1.0
ticălos,www.gandul.ro,0,1,0,1,-1.0,1.0
student,www.gandul.ro,0,0,1,1,0.0,0.0
Eli Roman,www.b1tv.ro,0,0,1,1,0.0,0.0
Oana Florea,www.b1tv.ro,1,0,0,1,1.0,1.0
Albania,agerpres.ro,0,0,1,1,0.0,0.0
Alfredo Maria Durante Mangoni,agerpres.ro,0,0,1,1,0.0,0.0
Nicolae Iftimiu,agerpres.ro,0,0,1,1,0.0,0.0
Claudia Nicolae,agerpres.ro,0,0,1,1,0.0,0.0
director general,agerpres.ro,0,0,1,1,0.0,0.0
Enkeleda Merkuri,agerpres.ro,0,0,1,1,0.0,0.0
Grigore Popescu,agerpres.ro,0,0,2,2,0.0,0.0
Italia,agerpres.ro,0,0,1,1,0.0,0.0
Republica,agerpres.ro,0,0,1,1,0.0,0.0
Traian Briciu,agerpres.ro,0,0,1,1,0.0,0.0
Victor Chirilă,agerpres.ro,0,0,1,1,0.0,0.0
director,agerpres.ro,0,0,2,2,0.0,0.0
Ilona Stepan,agerpres.ro,0,0,1,1,0.0,0.0
Mihail Bucă,agerpres.ro,0,0,1,1,0.0,0.0
Țâgârlaș,agerpres.ro,0,0,1,1,0.0,0.0
Muscel,www.comisarul.ro,0,0,1,1,0.0,0.0
George Crin Laurențiu Antonescu,www.antena3.ro,0,0,1,1,0.0,0.0
Corina Bokor,agerpres.ro,0,0,1,1,0.0,0.0
Sebastian Forir,agerpres.ro,0,0,1,1,0.0,0.0
Sibiul,agerpres.ro,1,1,0,2,0.0,0.0
sibian,agerpres.ro,2,0,0,2,1.0,1.0
Andrea Chis,www.luju.ro,0,1,0,1,-1.0,1.0
Aydin,www.luju.ro,0,0,1,1,0.0,0.0
Ciprian Tita,www.luju.ro,0,0,1,1,0.0,0.0
Dana Girbovan,www.luju.ro,0,0,1,1,0.0,0.0
Mihet,www.luju.ro,0,0,1,1,0.0,0.0
inspectoare,www.luju.ro,0,0,1,1,0.0,0.0
Luciana Aydin,www.luju.ro,0,0,1,1,0.0,0.0
Iancu de Hunedoara,www.realitatea.net,0,1,0,1,-1.0,1.0
Mahomed,www.realitatea.net,0,1,0,1,-1.0,1.0
Burkina Faso,pressone.ro,0,0,1,1,0.0,0.0
Burundi,pressone.ro,0,0,1,1,0.0,0.0
Cuba,pressone.ro,0,0,1,1,0.0,0.0
Finlanda,pressone.ro,0,0,5,5,0.0,0.0
Florin Melciu,pressone.ro,0,0,1,1,0.0,0.0
Guineea,pressone.ro,0,0,1,1,0.0,0.0
Haiti,pressone.ro,0,0,1,1,0.0,0.0
Madagascar,pressone.ro,0,0,1,1,0.0,0.0
Melciu,pressone.ro,0,0,1,1,0.0,0.0
Nigeria,pressone.ro,0,0,1,1,0.0,0.0
Pimen Zainea,pressone.ro,0,0,1,1,0.0,0.0
Rădăuți,pressone.ro,0,0,1,1,0.0,0.0
Tuta George Cristian,pressone.ro,0,0,1,1,0.0,0.0
Violeta,pressone.ro,0,1,0,1,-1.0,1.0
agnostic,pressone.ro,0,0,1,1,0.0,0.0
cler,pressone.ro,1,0,0,1,1.0,1.0
credincios,pressone.ro,0,0,1,1,0.0,0.0
ghiocel,pressone.ro,0,1,0,1,-1.0,1.0
Emil Nedelea Cărămizaru,pressone.ro,0,0,1,1,0.0,0.0
Adrian Petrache,recorder.ro,0,0,1,1,0.0,0.0
Alexandru Bittner,recorder.ro,0,0,1,1,0.0,0.0
Bartolomeu Finiș,recorder.ro,0,0,1,1,0.0,0.0
Crimeea,recorder.ro,0,1,0,1,-1.0,1.0
Crin,recorder.ro,0,1,0,1,-1.0,1.0
Musk,recorder.ro,0,0,1,1,0.0,0.0
Tudor Galoș,recorder.ro,0,0,1,1,0.0,0.0
bunică,recorder.ro,0,0,2,2,0.0,0.0
Puiu Popoviciu,recorder.ro,0,1,0,1,-1.0,1.0
Adrian Neacșu,www.mediafax.ro,0,0,1,1,0.0,0.0
Adrian Țuțuianu,www.mediafax.ro,0,0,2,2,0.0,0.0
Alexandru Șerban,www.mediafax.ro,0,0,1,1,0.0,0.0
Corina Dumitrescu,www.mediafax.ro,0,0,2,2,0.0,0.0
Cristi Danileț,www.mediafax.ro,0,0,1,1,0.0,0.0
Cristian Dumitrescu,www.mediafax.ro,0,0,1,1,0.0,0.0
Daea,www.mediafax.ro,0,0,2,2,0.0,0.0
Dan Lupașcu,www.mediafax.ro,0,0,1,1,0.0,0.0
Dan Șova,www.mediafax.ro,0,1,0,1,-1.0,1.0
George Bălan,www.mediafax.ro,0,0,1,1,0.0,0.0
György Frunda,www.mediafax.ro,0,0,1,1,0.0,0.0
Horațius Dumbravă,www.mediafax.ro,0,0,1,1,0.0,0.0
Lidia Bărbulescu,www.mediafax.ro,0,0,1,1,0.0,0.0
Marius Tudose Badea,www.mediafax.ro,0,0,1,1,0.0,0.0
Mircea Bucurel Aron,www.mediafax.ro,0,0,1,1,0.0,0.0
Oana Schmidt Hăineală,www.mediafax.ro,0,0,1,1,0.0,0.0
Predoiu,www.mediafax.ro,0,0,3,3,0.0,0.0
Victor Alistar,www.mediafax.ro,0,0,2,2,0.0,0.0
Dan Chiujdea,www.mediafax.ro,0,0,1,1,0.0,0.0
Petre Daea,www.mediafax.ro,0,0,3,3,0.0,0.0
Anna,www.gandul.ro,0,0,1,1,0.0,0.0
Paulina Luna,www.gandul.ro,0,0,1,1,0.0,0.0
fotograf,www.mediafax.ro,0,1,0,1,-1.0,1.0
Cornel Vasile Folescu,www.aktual24.ro,0,0,1,1,0.0,0.0
Balotești,www.comisarul.ro,0,0,1,1,0.0,0.0
Bucureștii Noi,www.comisarul.ro,0,1,0,1,-1.0,1.0
Ciolpani,www.comisarul.ro,0,0,1,1,0.0,0.0
Grădiștea,www.comisarul.ro,0,0,1,1,0.0,0.0
Izvorani,www.comisarul.ro,0,0,1,1,0.0,0.0
paznic,www.comisarul.ro,0,1,0,1,-1.0,1.0
Sri Lanka,www.comisarul.ro,0,0,1,1,0.0,0.0
ea,www.comisarul.ro,0,1,0,1,-1.0,1.0
ziarist,www.comisarul.ro,0,0,1,1,0.0,0.0
conres,www.b1tv.ro,0,0,1,1,0.0,0.0
ales,www.b1tv.ro,0,0,1,1,0.0,0.0
chelneriță,recorder.ro,0,1,0,1,-1.0,1.0
Bush,www.activenews.ro,0,1,0,1,-1.0,1.0
Gorbaciov,www.activenews.ro,0,0,1,1,0.0,0.0
Hunor Kelemen,www.activenews.ro,0,1,0,1,-1.0,1.0
Mitterrand,www.activenews.ro,0,0,1,1,0.0,0.0
înțelept,www.activenews.ro,0,0,1,1,0.0,0.0
austriac,stirileprotv.ro,0,1,1,2,-0.5,0.5
Viena,stirileprotv.ro,0,0,2,2,0.0,0.0
Adrian Ungureanu,www.activenews.ro,0,1,0,1,-1.0,1.0
Brebu,www.activenews.ro,0,1,0,1,-1.0,1.0
Cătălin Ilioiu,www.activenews.ro,0,0,1,1,0.0,0.0
Daniel Iordache,www.activenews.ro,0,0,1,1,0.0,0.0
Florin Stăncescu,www.activenews.ro,0,0,1,1,0.0,0.0
Florin Șinca,www.activenews.ro,0,0,1,1,0.0,0.0
Cristian Stavriu,www.activenews.ro,1,0,0,1,1.0,1.0
Părintele Stavriu,www.activenews.ro,0,1,0,1,-1.0,1.0
Ungureanu,www.activenews.ro,0,2,0,2,-1.0,1.0
breb,www.activenews.ro,0,1,1,2,-0.5,0.5
bucureștean,www.activenews.ro,0,1,0,1,-1.0,1.0
coordonator,www.activenews.ro,0,0,1,1,0.0,0.0
domnie,www.activenews.ro,0,1,0,1,-1.0,1.0
Emanuel Ungureanu,www.activenews.ro,0,1,0,1,-1.0,1.0
viceprimar,www.activenews.ro,0,0,1,1,0.0,0.0
Matei Basarab,www.activenews.ro,0,0,1,1,0.0,0.0
Șinca,www.activenews.ro,0,0,1,1,0.0,0.0
Bode,www.mediafax.ro,0,0,1,1,0.0,0.0
Teodosie,www.romaniatv.net,0,2,0,2,-1.0,1.0
ÎPS Teodosie,www.romaniatv.net,0,0,1,1,0.0,0.0
Ministru,www.digi24.ro,0,0,1,1,0.0,0.0
Italia,www.digi24.ro,0,0,1,1,0.0,0.0
Japonia,www.digi24.ro,1,0,1,2,0.5,0.5
Varșovia,www.digi24.ro,0,0,1,1,0.0,0.0
consul,www.digi24.ro,0,0,1,1,0.0,0.0
Riad,www.gandul.ro,0,0,2,2,0.0,0.0
Dan Șova,www.digi24.ro,0,3,0,3,-1.0,1.0
Roșia,www.digi24.ro,0,0,1,1,0.0,0.0
Roșia Montană,www.digi24.ro,0,1,0,1,-1.0,1.0
minier,www.digi24.ro,0,1,0,1,-1.0,1.0
Karl Nehamer,stirileprotv.ro,0,0,1,1,0.0,0.0
Gabriel Zetea,www.comisarul.ro,0,0,2,2,0.0,0.0
Gheorghe Șoldan,www.comisarul.ro,0,0,1,1,0.0,0.0
Ionuț-Florin Pucheanu,www.comisarul.ro,0,0,1,1,0.0,0.0
Olguța,www.comisarul.ro,0,0,1,1,0.0,0.0
Sâmbăta de Sus,www.comisarul.ro,0,0,1,1,0.0,0.0
Dragoș Benea,observatornews.ro,0,0,1,1,0.0,0.0
Thierry Breton,observatornews.ro,0,0,1,1,0.0,0.0
Dragoș Anastasiu,www.digi24.ro,0,0,1,1,0.0,0.0
Atanasiu,www.mediafax.ro,0,0,1,1,0.0,0.0
Teodor Atanasiu,www.mediafax.ro,0,0,1,1,0.0,0.0
Nicu,www.g4media.ro,0,0,1,1,0.0,0.0
Szabó,www.g4media.ro,0,0,1,1,0.0,0.0
Angel Tîlvăr,stirileprotv.ro,0,0,2,2,0.0,0.0
Angelo Mitchievici,recorder.ro,0,0,1,1,0.0,0.0
Cluj Napoca,recorder.ro,0,0,1,1,0.0,0.0
Cristian Vlădescu,recorder.ro,0,0,1,1,0.0,0.0
Csaszar Karoly Zsolt,recorder.ro,0,0,1,1,0.0,0.0
Csep-Eva Andrea,recorder.ro,0,0,1,1,0.0,0.0
Câmpu Cetății,recorder.ro,0,0,1,1,0.0,0.0
Deda,recorder.ro,0,0,1,1,0.0,0.0
Dumitrița Gliga,recorder.ro,0,0,1,1,0.0,0.0
Elena Vijulie,recorder.ro,0,0,1,1,0.0,0.0
Emil Marius Pașcan,recorder.ro,0,0,1,1,0.0,0.0
Ervin Molnar,recorder.ro,0,2,2,4,-0.5,0.5
Florin Buicu,recorder.ro,0,0,1,1,0.0,0.0
Ioan Cristian Chirteș,recorder.ro,0,0,1,1,0.0,0.0
Ioan Stanomir,recorder.ro,0,0,1,1,0.0,0.0
Ion Manolescu,recorder.ro,0,0,1,1,0.0,0.0
John Bridges,recorder.ro,0,0,1,1,0.0,0.0
John Grisham,recorder.ro,1,0,0,1,1.0,1.0
Kolcsar Anquetil Karoly,recorder.ro,0,0,1,1,0.0,0.0
Leonard Azamfirei,recorder.ro,0,0,1,1,0.0,0.0
Marguerite Yourcenar,recorder.ro,0,0,1,1,0.0,0.0
Mihai Himcinschi,recorder.ro,0,0,1,1,0.0,0.0
Molnar,recorder.ro,0,0,1,1,0.0,0.0
Normandia,recorder.ro,0,0,1,1,0.0,0.0
Novak Csaba Zoltan,recorder.ro,0,0,1,1,0.0,0.0
Paul Cernat,recorder.ro,0,0,1,1,0.0,0.0
Profesorul Vlădescu,recorder.ro,0,0,1,1,0.0,0.0
Reghin,recorder.ro,1,0,0,1,1.0,1.0
Răzvan Brudiu,recorder.ro,0,0,1,1,0.0,0.0
Sebastian Gabriel Toncean,recorder.ro,0,0,1,1,0.0,0.0
Sighișoara,recorder.ro,0,0,1,1,0.0,0.0
Stanislav Belkovski,recorder.ro,0,0,1,1,0.0,0.0
Tom Hockaday,recorder.ro,0,0,1,1,0.0,0.0
Andrea Tompa,recorder.ro,0,0,1,1,0.0,0.0
Vasile Gliga,recorder.ro,0,0,1,1,0.0,0.0
beligerant,recorder.ro,0,1,0,1,-1.0,1.0
biciclist,recorder.ro,0,0,1,1,0.0,0.0
brutar,recorder.ro,0,1,0,1,-1.0,1.0
bunic,recorder.ro,1,0,3,4,0.25,0.25
dascăl,recorder.ro,0,0,4,4,0.0,0.0
inginer-șef,recorder.ro,0,0,1,1,0.0,0.0
merceolog,recorder.ro,0,0,2,2,0.0,0.0
moștenitor,recorder.ro,0,1,0,1,-1.0,1.0
scriitoare,recorder.ro,1,0,2,3,0.3333333333333333,0.3333333333333333
Dumitru Dragomir,www.romaniatv.net,0,0,1,1,0.0,0.0
Gigi,www.romaniatv.net,0,0,1,1,0.0,0.0
Mitică,www.romaniatv.net,0,0,1,1,0.0,0.0
amândoi,www.romaniatv.net,1,0,0,1,1.0,1.0
tirano,www.romaniatv.net,0,1,0,1,-1.0,1.0
Calin Georgescu,www.luju.ro,0,1,0,1,-1.0,1.0
MUSK,www.luju.ro,0,0,1,1,0.0,0.0
Elon Musk,www.luju.ro,0,1,1,2,-0.5,0.5
Filip Havârneanu,recorder.ro,0,0,1,1,0.0,0.0
Ligia Deca,recorder.ro,0,2,1,3,-0.6666666666666666,0.6666666666666666
Marius Nistor,recorder.ro,0,1,0,1,-1.0,1.0
Octavian Dan,recorder.ro,0,0,1,1,0.0,0.0
Roxana Mînzatu,recorder.ro,0,0,1,1,0.0,0.0
Sean Combs,recorder.ro,0,0,1,1,0.0,0.0
domnul președinte,stirileprotv.ro,1,0,0,1,1.0,1.0
elită,stirileprotv.ro,0,0,1,1,0.0,0.0
viceprimar,stirileprotv.ro,0,0,2,2,0.0,0.0
Cristi Danileț,www.gandul.ro,0,0,1,1,0.0,0.0
Danileț,www.gandul.ro,0,0,1,1,0.0,0.0
Cristi Dănileț,www.gandul.ro,0,1,0,1,-1.0,1.0
personal BEC,www.gandul.ro,0,0,1,1,0.0,0.0
prieteni,www.gandul.ro,0,2,0,2,-1.0,1.0
Ion Georgescu,recorder.ro,0,1,0,1,-1.0,1.0
Mioveni,recorder.ro,0,1,2,3,-0.3333333333333333,0.3333333333333333
Tenerife,recorder.ro,0,0,1,1,0.0,0.0
Veneția,recorder.ro,0,0,1,1,0.0,0.0
Keir Starmer,www.luju.ro,0,0,1,1,0.0,0.0
Marea Britanie,www.luju.ro,0,0,1,1,0.0,0.0
Statele,www.luju.ro,0,0,1,1,0.0,0.0
Barcelona,www.comisarul.ro,0,0,1,1,0.0,0.0
Basarabia,www.comisarul.ro,0,1,0,1,-1.0,1.0
Căușeni,www.comisarul.ro,0,0,1,1,0.0,0.0
Dublin,www.comisarul.ro,0,0,1,1,0.0,0.0
Elche,www.comisarul.ro,0,0,1,1,0.0,0.0
Hâncești,www.comisarul.ro,0,1,0,1,-1.0,1.0
Ialoveni,www.comisarul.ro,0,0,1,1,0.0,0.0
Innsbruck,www.comisarul.ro,0,0,1,1,0.0,0.0
Liverpool,www.comisarul.ro,0,0,1,1,0.0,0.0
Palmas de Gran Canaria,www.comisarul.ro,0,0,1,1,0.0,0.0
Jarosław Kaczyński,www.antena3.ro,0,0,1,1,0.0,0.0
regizor,www.antena3.ro,0,0,1,1,0.0,0.0
Cartarescu,www.aktual24.ro,0,1,0,1,-1.0,1.0
Emil Cioran,www.aktual24.ro,0,0,1,1,0.0,0.0
Mihai Eminescu,www.aktual24.ro,0,0,1,1,0.0,0.0
Mircea Cartarescu,www.aktual24.ro,0,1,1,2,-0.5,0.5
Multi,www.aktual24.ro,0,1,0,1,-1.0,1.0
scriitor,www.aktual24.ro,0,1,0,1,-1.0,1.0
tirano,www.aktual24.ro,0,1,0,1,-1.0,1.0
Romașcanu,www.g4media.ro,0,1,0,1,-1.0,1.0
Toma,www.g4media.ro,0,0,3,3,0.0,0.0
Guy Verhofstadt,stirileprotv.ro,0,0,2,2,0.0,0.0
Oprea,adevarul.ro,0,2,1,3,-0.6666666666666666,0.6666666666666666
Vlad Oprea,adevarul.ro,0,1,0,1,-1.0,1.0
Vladimir Ciorbă,adevarul.ro,0,0,1,1,0.0,0.0
Bădulescu,stirileprotv.ro,0,1,0,1,-1.0,1.0
Mutu,stirileprotv.ro,0,1,0,1,-1.0,1.0
Budapesta,www.b1tv.ro,0,0,1,1,0.0,0.0
Răzvan Munteanu,www.b1tv.ro,0,0,1,1,0.0,0.0
Ungarie,www.b1tv.ro,0,0,1,1,0.0,0.0
Viktor Orban,www.b1tv.ro,0,0,1,1,0.0,0.0
Kiseleff,www.comisarul.ro,0,0,1,1,0.0,0.0
Aleksander Kwaśniewski,www.digi24.ro,0,0,1,1,0.0,0.0
Barack Obama,www.digi24.ro,0,0,2,2,0.0,0.0
China,www.digi24.ro,0,0,2,2,0.0,0.0
Ehud Barak,www.digi24.ro,0,0,1,1,0.0,0.0
Emil Constantinescu,www.digi24.ro,0,0,1,1,0.0,0.0
François Mitterrand,www.digi24.ro,1,0,0,1,1.0,1.0
Jacques Seguela,www.digi24.ro,0,0,1,1,0.0,0.0
Petre Roman,www.digi24.ro,0,0,2,2,0.0,0.0
boxer,www.digi24.ro,0,0,1,1,0.0,0.0
concurent,www.digi24.ro,0,1,0,1,-1.0,1.0
guru,www.digi24.ro,1,0,0,1,1.0,1.0
soldat,www.digi24.ro,0,1,0,1,-1.0,1.0
Cosmin Tabără,www.gandul.ro,0,0,2,2,0.0,0.0
Ilie Sârbu,www.gandul.ro,0,2,0,2,-1.0,1.0
Matei Creiveanu,www.gandul.ro,0,0,1,1,0.0,0.0
Tabără,www.gandul.ro,0,0,1,1,0.0,0.0
administrator,www.gandul.ro,0,0,1,1,0.0,0.0
agitator,www.gandul.ro,0,1,0,1,-1.0,1.0
interlop,www.gandul.ro,0,1,0,1,-1.0,1.0
interpuși,www.gandul.ro,0,1,0,1,-1.0,1.0
Caius Șuli,www.gandul.ro,0,0,1,1,0.0,0.0
viceprimar,www.gandul.ro,0,1,1,2,-0.5,0.5
Ruben Lațcău,www.gandul.ro,0,1,0,1,-1.0,1.0
Ionuț Aichimioaie,www.romaniatv.net,0,0,1,1,0.0,0.0
funcționar public,www.romaniatv.net,0,1,0,1,-1.0,1.0
politruc,www.romaniatv.net,0,2,0,2,-1.0,1.0
sinecurist,www.romaniatv.net,0,1,0,1,-1.0,1.0
înlocuitor,www.antena3.ro,0,2,0,2,-1.0,1.0
Afganistan,www.comisarul.ro,0,0,1,1,0.0,0.0
Auckland,www.comisarul.ro,0,0,1,1,0.0,0.0
Bistrița,www.comisarul.ro,0,0,1,1,0.0,0.0
Canada,www.comisarul.ro,0,1,2,3,-0.3333333333333333,0.3333333333333333
Caraș,www.comisarul.ro,0,0,1,1,0.0,0.0
Călărași,www.comisarul.ro,0,0,1,1,0.0,0.0
Eugen Tomac,www.comisarul.ro,0,0,1,1,0.0,0.0
Făgăraș,www.comisarul.ro,0,0,1,1,0.0,0.0
Giurgiu,www.comisarul.ro,0,0,1,1,0.0,0.0
Insulele Canare,www.comisarul.ro,0,0,1,1,0.0,0.0
Libia,www.comisarul.ro,0,0,1,1,0.0,0.0
Malta,www.comisarul.ro,0,0,1,1,0.0,0.0
Odesa,www.comisarul.ro,0,0,1,1,0.0,0.0
Phenian,www.comisarul.ro,0,0,1,1,0.0,0.0
Principatul Monaco,www.comisarul.ro,0,0,1,1,0.0,0.0
Raluca Modova,www.comisarul.ro,0,0,1,1,0.0,0.0
regie,www.comisarul.ro,0,0,1,1,0.0,0.0
Sudan,www.comisarul.ro,0,0,1,1,0.0,0.0
Tunis,www.comisarul.ro,0,0,1,1,0.0,0.0
Viorica Dăncilă,www.comisarul.ro,0,0,1,1,0.0,0.0
câine,www.comisarul.ro,0,0,1,1,0.0,0.0
Diego Maradona,pressone.ro,0,1,0,1,-1.0,1.0
dânș,pressone.ro,0,2,0,2,-1.0,1.0
dânșor,pressone.ro,0,1,0,1,-1.0,1.0
Bianca Iacob,a1.ro,1,0,2,3,0.3333333333333333,0.3333333333333333
Washington,a1.ro,0,0,1,1,0.0,0.0
conducător,a1.ro,0,1,0,1,-1.0,1.0
Canadei,adevarul.ro,0,0,1,1,0.0,0.0
Regatul Unit al Marii Britanii și Irlandei de Nord,adevarul.ro,0,0,1,1,0.0,0.0
Tunisia,adevarul.ro,0,0,1,1,0.0,0.0
cei,adevarul.ro,0,1,2,3,-0.3333333333333333,0.3333333333333333
participant,adevarul.ro,0,0,5,5,0.0,0.0
Estonia,www.gandul.ro,0,0,1,1,0.0,0.0
Glenn Micallef,www.gandul.ro,0,0,1,1,0.0,0.0
Helena Dalli,www.gandul.ro,0,0,1,1,0.0,0.0
Jéromine Andolfatto,www.gandul.ro,0,0,1,1,0.0,0.0
Kajei Kallas,www.gandul.ro,0,0,1,1,0.0,0.0
Maltei,www.gandul.ro,0,0,1,1,0.0,0.0
Robert Abela,www.gandul.ro,0,0,1,1,0.0,0.0
Slovenia,www.gandul.ro,0,0,1,1,0.0,0.0
Mirabelei Grădinaru,www.cotidianul.ro,0,1,0,1,-1.0,1.0
Partenera,www.cotidianul.ro,0,1,0,1,-1.0,1.0
Sorinei Matei,www.cotidianul.ro,0,0,1,1,0.0,0.0
Bode,agerpres.ro,0,0,1,1,0.0,0.0
credincios,www.romaniatv.net,1,0,1,2,0.5,0.5
neam,www.romaniatv.net,1,0,0,1,1.0,1.0
Basarabean,recorder.ro,0,1,0,1,-1.0,1.0
Costel Cuibari,recorder.ro,0,0,1,1,0.0,0.0
Crina Goarnă,recorder.ro,0,0,1,1,0.0,0.0
Căciulă,recorder.ro,0,1,0,1,-1.0,1.0
Dorohoi,recorder.ro,0,1,1,2,-0.5,0.5
Flămânzi,recorder.ro,0,1,1,2,-0.5,0.5
Ghiță,recorder.ro,0,2,0,2,-1.0,1.0
Goțiu,recorder.ro,0,1,0,1,-1.0,1.0
Huși,recorder.ro,1,0,0,1,1.0,1.0
Malga Millegrobbe,recorder.ro,0,0,1,1,0.0,0.0
Marco Massimi,recorder.ro,0,1,0,1,-1.0,1.0
Mimi Ovidia Gogu,recorder.ro,0,0,1,1,0.0,0.0
Mânjești,recorder.ro,0,0,1,1,0.0,0.0
pescar,recorder.ro,0,1,0,1,-1.0,1.0
Popa Attila Kiss,recorder.ro,1,0,0,1,1.0,1.0
Rodna,recorder.ro,1,0,0,1,1.0,1.0
Rovinari,recorder.ro,0,1,0,1,-1.0,1.0
Sângeroz,recorder.ro,0,1,0,1,-1.0,1.0
Traian Ogâgău,recorder.ro,1,0,0,1,1.0,1.0
Valeriu Zgonea,recorder.ro,0,2,2,4,-0.5,0.5
amărăciune,recorder.ro,0,1,0,1,-1.0,1.0
botoșănean,recorder.ro,0,3,1,4,-0.75,0.75
celălalt,recorder.ro,0,1,0,1,-1.0,1.0
cucoană,recorder.ro,0,1,0,1,-1.0,1.0
călărăș,recorder.ro,1,0,0,1,1.0,1.0
dorohoian,recorder.ro,0,1,0,1,-1.0,1.0
ieșeancă,recorder.ro,0,1,0,1,-1.0,1.0
liceență,recorder.ro,0,0,1,1,0.0,0.0
moș,recorder.ro,0,2,0,2,-1.0,1.0
mândră,recorder.ro,0,1,0,1,-1.0,1.0
neamț,recorder.ro,0,1,0,1,-1.0,1.0
oaspete,recorder.ro,0,1,0,1,-1.0,1.0
pușcăriaș,recorder.ro,0,2,0,2,-1.0,1.0
tâmplar,recorder.ro,0,0,1,1,0.0,0.0
Șendriceni,recorder.ro,0,1,0,1,-1.0,1.0
anchetator,www.realitatea.net,0,2,0,2,-1.0,1.0
ciorbă,www.realitatea.net,0,0,1,1,0.0,0.0
Dan Trifu,www.realitatea.net,0,2,0,2,-1.0,1.0
Sinaia,www.realitatea.net,0,0,1,1,0.0,0.0
Vlad Oprea,www.realitatea.net,0,0,1,1,0.0,0.0
Vladimir Ciorbă,www.realitatea.net,0,1,1,2,-0.5,0.5
Gerhard Karner,recorder.ro,0,0,1,1,0.0,0.0
Marin Țole,recorder.ro,0,0,2,2,0.0,0.0
Mario Iorgulescu,recorder.ro,0,0,1,1,0.0,0.0
Ștefan Busnatu,recorder.ro,0,0,1,1,0.0,0.0
Mihai Apostolache,recorder.ro,0,0,1,1,0.0,0.0
omolog,recorder.ro,0,1,2,3,-0.3333333333333333,0.3333333333333333
Karl Nehammer,recorder.ro,0,1,0,1,-1.0,1.0
ecologist,recorder.ro,0,0,1,1,0.0,0.0
Pîrvulescu,recorder.ro,0,0,1,1,0.0,0.0
Adam Crăciunescu,pressone.ro,0,1,0,1,-1.0,1.0
Alexandra Herțanu,pressone.ro,0,0,1,1,0.0,0.0
Alexandru Nazare,pressone.ro,0,0,2,2,0.0,0.0
Alin Gheorghe Ciucu,pressone.ro,0,0,1,1,0.0,0.0
Anca Boagiu,pressone.ro,0,0,1,1,0.0,0.0
Andra,pressone.ro,0,0,1,1,0.0,0.0
Andra Vela,pressone.ro,0,0,2,2,0.0,0.0
Armeniș,pressone.ro,0,0,1,1,0.0,0.0
Avramescu,pressone.ro,0,1,0,1,-1.0,1.0
Bogdan Man,pressone.ro,0,0,1,1,0.0,0.0
Buda,pressone.ro,0,0,2,2,0.0,0.0
Ciucu,pressone.ro,0,0,1,1,0.0,0.0
Corlățean,pressone.ro,0,0,2,2,0.0,0.0
Cristea,pressone.ro,0,0,1,1,0.0,0.0
Cristina Semănaru,pressone.ro,0,0,1,1,0.0,0.0
Crăciunescu,pressone.ro,0,0,1,1,0.0,0.0
Cătălina Crăciunescu,pressone.ro,0,1,0,1,-1.0,1.0
Daciana Sârbu,pressone.ro,0,0,2,2,0.0,0.0
Daniel Chițoiu,pressone.ro,0,0,1,1,0.0,0.0
Eduard Hellvig,pressone.ro,0,0,2,2,0.0,0.0
George Scripcaru,pressone.ro,0,1,0,1,-1.0,1.0
Ioan Cristian Vela,pressone.ro,0,0,1,1,0.0,0.0
Ioana Rus,pressone.ro,0,0,1,1,0.0,0.0
Laurențiu Gavra,pressone.ro,0,0,1,1,0.0,0.0
Man,pressone.ro,0,0,1,1,0.0,0.0
Manuel Avramescu,pressone.ro,0,1,0,1,-1.0,1.0
Marian Zlotea,pressone.ro,0,0,1,1,0.0,0.0
Martin Schulz,pressone.ro,0,0,1,1,0.0,0.0
Mircea Man,pressone.ro,0,1,2,3,-0.3333333333333333,0.3333333333333333
Mănescu,pressone.ro,0,2,0,2,-1.0,1.0
Raluca Băgărean,pressone.ro,0,0,1,1,0.0,0.0
Rareș Mănescu,pressone.ro,0,0,1,1,0.0,0.0
Titus Corlățean,pressone.ro,0,0,3,3,0.0,0.0
Tudor Mataragiu,pressone.ro,0,0,1,1,0.0,0.0
cumnat,pressone.ro,0,0,2,2,0.0,0.0
Andi Cristea,pressone.ro,0,0,2,2,0.0,0.0
Traian Ungureanu,pressone.ro,0,0,1,1,0.0,0.0
ființă,pressone.ro,0,1,0,1,-1.0,1.0
neam,pressone.ro,0,1,0,1,-1.0,1.0
noră,pressone.ro,0,1,1,2,-0.5,0.5
nuror,pressone.ro,0,0,1,1,0.0,0.0
stagiar,pressone.ro,0,0,2,2,0.0,0.0
Dumitru Borțun,www.digi24.ro,0,0,2,2,0.0,0.0
Guvernul Cîțu,www.digi24.ro,0,1,0,1,-1.0,1.0
Antal Arpad,www.g4media.ro,0,0,1,1,0.0,0.0
Baraolt,www.g4media.ro,0,0,1,1,0.0,0.0
Benedek Huszár János,www.g4media.ro,0,0,1,1,0.0,0.0
Bokor Tibor,www.g4media.ro,0,0,1,1,0.0,0.0
György József,www.g4media.ro,0,0,1,1,0.0,0.0
Oana Mălina Negrea,www.g4media.ro,0,0,1,1,0.0,0.0
Raul Urdă,www.g4media.ro,0,0,2,2,0.0,0.0
Sfântu Gheorghe,www.g4media.ro,0,0,1,1,0.0,0.0
Târgu Secuiesc,www.g4media.ro,0,0,1,1,0.0,0.0
adult,www.g4media.ro,0,0,1,1,0.0,0.0
Mhai Gâdea,www.antena3.ro,0,1,0,1,-1.0,1.0
Adam Bodnar,pressone.ro,0,1,0,1,-1.0,1.0
Belarus,pressone.ro,0,1,1,2,-0.5,0.5
Cracovia,pressone.ro,0,0,1,1,0.0,0.0
Donald Tusk,pressone.ro,0,1,0,1,-1.0,1.0
Jarosław Kaczyński,pressone.ro,0,1,0,1,-1.0,1.0
Jarosław Sellin,pressone.ro,0,1,0,1,-1.0,1.0
Jastrzębie-Zdrój,pressone.ro,0,0,1,1,0.0,0.0
Kaczyński,pressone.ro,0,1,0,1,-1.0,1.0
Kmita,pressone.ro,0,0,1,1,0.0,0.0
Marcin Romanowski,pressone.ro,0,1,0,1,-1.0,1.0
Małopolska,pressone.ro,0,0,1,1,0.0,0.0
Michał Woś,pressone.ro,0,1,0,1,-1.0,1.0
Rafał Trzaskowski,pressone.ro,0,0,1,1,0.0,0.0
Voievodatul Podlaskie,pressone.ro,0,1,0,1,-1.0,1.0
Zbigniew Ziobro,pressone.ro,0,1,0,1,-1.0,1.0
Zdrój,pressone.ro,0,0,1,1,0.0,0.0
comentator,pressone.ro,0,6,1,7,-0.8571428571428571,0.8571428571428571
Krzysztof Jurgiel,pressone.ro,0,0,1,1,0.0,0.0
ministru adjunct,pressone.ro,0,1,0,1,-1.0,1.0
rebel,pressone.ro,0,2,0,2,-1.0,1.0
Łukasz Kmita,pressone.ro,0,1,0,1,-1.0,1.0
Łukasz Prokorym,pressone.ro,0,0,1,1,0.0,0.0
tu,snoop.ro,0,0,1,1,0.0,0.0
Cristi Diaconescu,www.digi24.ro,0,0,1,1,0.0,0.0
Duvăz,www.digi24.ro,0,1,0,1,-1.0,1.0
Eugen Tomac,www.digi24.ro,0,0,1,1,0.0,0.0
jurnalistă,www.digi24.ro,0,0,1,1,0.0,0.0
Ludovic,www.digi24.ro,1,0,0,1,1.0,1.0
Oradea,www.digi24.ro,0,0,1,1,0.0,0.0
persona non grata,www.digi24.ro,0,1,0,1,-1.0,1.0
păsărică,www.digi24.ro,0,1,0,1,-1.0,1.0
Sebastian Burduja,www.b1tv.ro,0,0,1,1,0.0,0.0
reporter,www.b1tv.ro,0,0,1,1,0.0,0.0
Alexandru Bucălău,recorder.ro,0,0,1,1,0.0,0.0
Alexandru Popa,recorder.ro,0,0,1,1,0.0,0.0
Antoaneta Ioniță,recorder.ro,0,0,1,1,0.0,0.0
George Marius Caranica,recorder.ro,0,1,0,1,-1.0,1.0
Doinița Ciocan,recorder.ro,0,0,1,1,0.0,0.0
George Adrian Paladi,recorder.ro,0,0,1,1,0.0,0.0
Henri Charrière,recorder.ro,0,0,1,1,0.0,0.0
Horeca,recorder.ro,0,1,2,3,-0.3333333333333333,0.3333333333333333
Ianca,recorder.ro,0,0,1,1,0.0,0.0
Ionuț Cătălin Stancu,recorder.ro,0,0,1,1,0.0,0.0
Kevin Dutton,recorder.ro,0,0,1,1,0.0,0.0
Nicu Nița,recorder.ro,0,1,0,1,-1.0,1.0
Sărac,recorder.ro,0,1,0,1,-1.0,1.0
Vasile Varga,recorder.ro,0,0,1,1,0.0,0.0
brăilean,recorder.ro,0,0,1,1,0.0,0.0
cadru militar,recorder.ro,0,0,1,1,0.0,0.0
comerciant,recorder.ro,0,1,0,1,-1.0,1.0
gestionar,recorder.ro,0,0,2,2,0.0,0.0
motociclist,recorder.ro,0,0,1,1,0.0,0.0
recepționer,recorder.ro,0,0,1,1,0.0,0.0
Ciprian Ciucu,www.gandul.ro,0,0,1,1,0.0,0.0
George Cristian Tuță,www.gandul.ro,0,0,1,1,0.0,0.0
Radu Mihaiu,www.gandul.ro,0,2,0,2,-1.0,1.0
prefect,www.gandul.ro,0,0,1,1,0.0,0.0
Alexandru Dobre,www.gandul.ro,0,1,4,5,-0.2,0.2
Silviu Vexler,agerpres.ro,0,0,2,2,0.0,0.0
Statul Israel,agerpres.ro,0,0,1,1,0.0,0.0
Coreea de Nord,www.b1tv.ro,0,0,2,2,0.0,0.0
Coreea de Sud,www.b1tv.ro,0,0,1,1,0.0,0.0
Lulea,www.b1tv.ro,0,1,0,1,-1.0,1.0
Marius Lulea,www.b1tv.ro,0,0,1,1,0.0,0.0
Republica Moldova,www.b1tv.ro,0,2,1,3,-0.6666666666666666,0.6666666666666666
Maia Sandu,www.b1tv.ro,0,1,0,1,-1.0,1.0
Irina,observatornews.ro,1,0,0,1,1.0,1.0
Irina Tănase,observatornews.ro,1,0,1,2,0.5,0.5
Iubita,observatornews.ro,1,0,0,1,1.0,1.0
deținut,observatornews.ro,0,1,0,1,-1.0,1.0
iubit,observatornews.ro,2,0,1,3,0.6666666666666666,0.6666666666666666
Adonis Cezar Mihalache,a1.ro,0,0,1,1,0.0,0.0
Adrian Edu,a1.ro,0,0,1,1,0.0,0.0
Adrian Popescu,a1.ro,0,0,1,1,0.0,0.0
Adrian Stoica,a1.ro,0,0,1,1,0.0,0.0
Alexandru Onofrei,a1.ro,0,0,1,1,0.0,0.0
Andrei Ioan Chiliman,a1.ro,0,0,1,1,0.0,0.0
Aurel Stochita,a1.ro,0,0,1,1,0.0,0.0
Attila Alexandru Baniay,a1.ro,0,0,1,1,0.0,0.0
Bencze Josef,a1.ro,0,0,1,1,0.0,0.0
Bogdan Alexandru Capota,a1.ro,0,0,1,1,0.0,0.0
Bogdan Nicolae Constantin Bratu,a1.ro,0,0,1,1,0.0,0.0
Carmen Nonica Alistar,a1.ro,0,0,1,1,0.0,0.0
Cătălin Lucian Iliescu,a1.ro,0,0,1,1,0.0,0.0
Catalin Zamfira,a1.ro,0,0,1,1,0.0,0.0
Claudia Mirela Costescu,a1.ro,0,0,1,1,0.0,0.0
Constantin Tomescu,a1.ro,0,0,1,1,0.0,0.0
Corin Romanescu,a1.ro,0,0,1,1,0.0,0.0
Cornel Chiuaru,a1.ro,0,0,1,1,0.0,0.0
Cornel Costea,a1.ro,0,0,1,1,0.0,0.0
Cornelia Lalu,a1.ro,0,0,1,1,0.0,0.0
Cristian Ciocea,a1.ro,0,0,1,1,0.0,0.0
Cristian Constantin Poteras,a1.ro,0,0,1,1,0.0,0.0
Cristian Marius Bălăneanu,a1.ro,0,0,1,1,0.0,0.0
Cristian Popescu Piedone,a1.ro,0,0,1,1,0.0,0.0
Cristian Trasca,a1.ro,0,0,1,1,0.0,0.0
Cristiana Matei,a1.ro,0,0,1,1,0.0,0.0
Cristinel Eftimie,a1.ro,0,0,1,1,0.0,0.0
Daniel Schmid,a1.ro,0,0,1,1,0.0,0.0
Denes Aron,a1.ro,0,0,1,1,0.0,0.0
Dragos Frumosu,a1.ro,0,0,1,1,0.0,0.0
Dumitrescu Danut Octavian,a1.ro,0,0,1,1,0.0,0.0
Emil Nae,a1.ro,0,0,1,1,0.0,0.0
Flor Pomponiu,a1.ro,0,0,1,1,0.0,0.0
Florian Cristache,a1.ro,0,0,1,1,0.0,0.0
Florian Udrea,a1.ro,0,0,1,1,0.0,0.0
Florin Rusu,a1.ro,0,0,1,1,0.0,0.0
Gabriel Tiberian,a1.ro,0,0,1,1,0.0,0.0
Dragoș Eugen Gasca,a1.ro,0,0,1,1,0.0,0.0
Gheorghe Balcan,a1.ro,0,0,1,1,0.0,0.0
Gheorghe Mazilu,a1.ro,0,0,1,1,0.0,0.0
Gheorghe Nedelcu,a1.ro,0,0,1,1,0.0,0.0
Gheorghe Ovidiu Emil Stoenescu,a1.ro,0,0,1,1,0.0,0.0
Gheorghe Ursa,a1.ro,0,0,1,1,0.0,0.0
Gheorghe Ilie,a1.ro,0,0,1,1,0.0,0.0
Gheorghita Liviu Goncea,a1.ro,0,0,1,1,0.0,0.0
Ghita Richard Vicentiu,a1.ro,0,0,1,1,0.0,0.0
Gigel Andrabulea,a1.ro,0,0,1,1,0.0,0.0
Ilie Gramescu,a1.ro,0,0,1,1,0.0,0.0
Ilie Pepenel,a1.ro,0,0,1,1,0.0,0.0
Ioan Chiru,a1.ro,0,0,1,1,0.0,0.0
Ioan Dinu,a1.ro,0,0,1,1,0.0,0.0
Ioan Rusu,a1.ro,0,0,1,1,0.0,0.0
Ion Sarbu,a1.ro,0,0,1,1,0.0,0.0
Ion Uta,a1.ro,0,0,1,1,0.0,0.0
Iosif Eugen Vucicu,a1.ro,0,0,1,1,0.0,0.0
Iulian Popescu,a1.ro,0,0,1,1,0.0,0.0
Laurentiu Iordache Sile,a1.ro,0,0,1,1,0.0,0.0
Luminița Erghide,a1.ro,0,0,1,1,0.0,0.0
Marian Daniel Vanghelie,a1.ro,0,0,1,1,0.0,0.0
Mariana Șerban,a1.ro,0,0,1,1,0.0,0.0
Marin Răzvan Cătăna,a1.ro,0,0,1,1,0.0,0.0
Marinica Bunea,a1.ro,0,0,1,1,0.0,0.0
Marton Illyes,a1.ro,0,0,1,1,0.0,0.0
Mihael Zorzini,a1.ro,0,0,1,1,0.0,0.0
Mihai Alexandru Iorgulescu,a1.ro,0,0,1,1,0.0,0.0
Mihai Atanasoaei,a1.ro,0,0,1,1,0.0,0.0
Mihai Caciula,a1.ro,0,0,1,1,0.0,0.0
Mihai Emil Popescu,a1.ro,0,0,1,1,0.0,0.0
Mihai Hrynczuk,a1.ro,0,0,1,1,0.0,0.0
Mugur Mihaescu,a1.ro,0,0,1,1,0.0,0.0
Natalia Solomon,a1.ro,0,0,1,1,0.0,0.0
Nicolae Apostolescu,a1.ro,0,0,1,1,0.0,0.0
Nicolae Petre,a1.ro,0,0,1,1,0.0,0.0
Nicușor Gigartu,a1.ro,0,0,1,1,0.0,0.0
Ovidiu Ioan,a1.ro,0,0,1,1,0.0,0.0
Parpala Gabi,a1.ro,0,0,1,1,0.0,0.0
Rares Manescu Serban,a1.ro,0,0,1,1,0.0,0.0
Razvan Valentin Costache,a1.ro,0,0,1,1,0.0,0.0
Robert Sorin Negoita,a1.ro,0,0,1,1,0.0,0.0
Romeo Tarhon,a1.ro,0,0,1,1,0.0,0.0
Sergiu Fendrihan,a1.ro,0,0,1,1,0.0,0.0
Sorin Cristian Nica,a1.ro,0,0,1,1,0.0,0.0
Sorina Hanea,a1.ro,0,0,1,1,0.0,0.0
Sorina Constantin,a1.ro,0,0,1,1,0.0,0.0
Stefan Badara,a1.ro,0,0,1,1,0.0,0.0
Theodor Paleologu,a1.ro,0,0,3,3,0.0,0.0
Tudor Florian Ivan,a1.ro,0,0,1,1,0.0,0.0
Victor Dan Dumitrescu,a1.ro,0,0,1,1,0.0,0.0
Viorel Danut Constantin,a1.ro,0,0,1,1,0.0,0.0
Zaharia Nicolau,a1.ro,0,0,1,1,0.0,0.0
Constantin Titian Filip,a1.ro,0,0,1,1,0.0,0.0
Viorel-Stefan Florescu,a1.ro,0,0,1,1,0.0,0.0
elev,www.antena3.ro,2,0,0,2,1.0,1.0
student,www.antena3.ro,1,0,0,1,1.0,1.0
Cătălin Predoiu,a1.ro,0,0,1,1,0.0,0.0
Ionel Blanculescu,a1.ro,0,0,1,1,0.0,0.0
Lucian Croitoru,a1.ro,0,0,1,1,0.0,0.0
Mihai Tănăsescu,a1.ro,0,0,1,1,0.0,0.0
actriță,a1.ro,0,1,0,1,-1.0,1.0
guvernator,a1.ro,0,0,1,1,0.0,0.0
inlocuitor,a1.ro,0,0,1,1,0.0,0.0
Dunăre,pressone.ro,1,0,0,1,1.0,1.0
Dolj County,pressone.ro,1,0,0,1,1.0,1.0
Galati County,pressone.ro,1,0,0,1,1.0,1.0
Romanian,pressone.ro,0,0,1,1,0.0,0.0
noi,pressone.ro,1,0,1,2,0.5,0.5
Axios,www.g4media.ro,0,1,0,1,-1.0,1.0
Carlton Huffman,www.g4media.ro,0,1,0,1,-1.0,1.0
Czarnecki,www.g4media.ro,0,1,0,1,-1.0,1.0
Dirk Totten,www.g4media.ro,0,0,1,1,0.0,0.0
Huffman,www.g4media.ro,0,1,0,1,-1.0,1.0
Matt Schlapp,www.g4media.ro,0,1,0,1,-1.0,1.0
Mercedes,www.g4media.ro,0,0,1,1,0.0,0.0
Ryszard Czarnecki,www.g4media.ro,0,1,0,1,-1.0,1.0
Schlapp,www.g4media.ro,0,1,0,1,-1.0,1.0
Varșovia,www.g4media.ro,1,0,1,2,0.5,0.5
anchetator,www.g4media.ro,0,1,0,1,-1.0,1.0
catolic,www.g4media.ro,0,0,1,1,0.0,0.0
nepot,www.g4media.ro,0,3,0,3,-1.0,1.0
ofițer,www.g4media.ro,0,0,2,2,0.0,0.0
George W. Bush,www.g4media.ro,0,0,1,1,0.0,0.0
sponsor,www.g4media.ro,0,1,0,1,-1.0,1.0
Emil Hurezeanu,www.b1tv.ro,0,1,3,4,-0.25,0.25
Munchen,www.b1tv.ro,0,0,1,1,0.0,0.0
Hurezeanu,www.b1tv.ro,0,0,1,1,0.0,0.0
Budapesta,primanews.ro,0,0,1,1,0.0,0.0
Pete Szijjarto,primanews.ro,0,0,1,1,0.0,0.0
Péter Szijjártó,primanews.ro,0,0,1,1,0.0,0.0
Radoslaw Sikorski,primanews.ro,0,0,1,1,0.0,0.0
Szijjarto,primanews.ro,0,0,1,1,0.0,0.0
Andronescu,www.mediafax.ro,0,1,1,2,-0.5,0.5
Funeriu,www.mediafax.ro,0,1,0,1,-1.0,1.0
Deca,adevarul.ro,0,0,1,1,0.0,0.0
Marius Deca,adevarul.ro,0,0,1,1,0.0,0.0
Rast,adevarul.ro,0,0,1,1,0.0,0.0
Dmitri Peskov,observatornews.ro,0,0,1,1,0.0,0.0
Dîncu,observatornews.ro,0,0,1,1,0.0,0.0
Jens Stoltenberg,observatornews.ro,0,0,1,1,0.0,0.0
Olaf Scholz,observatornews.ro,0,0,1,1,0.0,0.0
Stoltenberg,observatornews.ro,0,0,1,1,0.0,0.0
cancelar,observatornews.ro,0,1,0,1,-1.0,1.0
dânș,www.euronews.ro,0,0,1,1,0.0,0.0
Daniel Godei,observatornews.ro,0,0,1,1,0.0,0.0
Godei,observatornews.ro,0,1,0,1,-1.0,1.0
Marian Neacșu,observatornews.ro,0,0,1,1,0.0,0.0
Mădălina Turza,observatornews.ro,0,1,0,1,-1.0,1.0
Ștefan Godei,observatornews.ro,0,5,0,5,-1.0,1.0
coordonator,observatornews.ro,0,1,1,2,-0.5,0.5
frate,observatornews.ro,0,0,1,1,0.0,0.0
funcționar,observatornews.ro,0,3,1,4,-0.75,0.75
furnizor,observatornews.ro,0,0,1,1,0.0,0.0
lăutar,observatornews.ro,0,1,0,1,-1.0,1.0
prostituată,observatornews.ro,0,2,0,2,-1.0,1.0
înlocuitor,observatornews.ro,0,0,2,2,0.0,0.0
șofer,observatornews.ro,0,1,0,1,-1.0,1.0
Cristian Tudor Popescu,www.b1tv.ro,0,2,3,5,-0.4,0.4
gazetar,www.b1tv.ro,0,0,3,3,0.0,0.0
Marcel,www.b1tv.ro,0,1,0,1,-1.0,1.0
Vicol,www.b1tv.ro,0,1,0,1,-1.0,1.0
Washington,www.b1tv.ro,0,0,1,1,0.0,0.0
domn,www.b1tv.ro,0,0,1,1,0.0,0.0
emisar,www.b1tv.ro,0,2,0,2,-1.0,1.0
neapărat,www.b1tv.ro,0,1,0,1,-1.0,1.0
scriitor,www.b1tv.ro,0,1,2,3,-0.3333333333333333,0.3333333333333333
Voineag,www.luju.ro,0,1,1,2,-0.5,0.5
aliat,www.luju.ro,1,0,0,1,1.0,1.0
când,www.luju.ro,0,0,1,1,0.0,0.0
gazdă,www.luju.ro,1,0,0,1,1.0,1.0
investigator,www.luju.ro,1,0,1,2,0.5,0.5
invitat,www.luju.ro,2,0,0,2,1.0,1.0
Victor Negrescu,www.news.ro,0,0,7,7,0.0,0.0
Negrescu,www.news.ro,0,0,2,2,0.0,0.0
Andrei Năstase,pressone.ro,0,0,1,1,0.0,0.0
Cattani,pressone.ro,0,0,1,1,0.0,0.0
Costinești,pressone.ro,0,0,1,1,0.0,0.0
Horia Constantinescu,pressone.ro,0,0,1,1,0.0,0.0
Horia Miron Constantinescu,pressone.ro,0,1,0,1,-1.0,1.0
Miron Constantinescu,pressone.ro,0,0,1,1,0.0,0.0
Moga,pressone.ro,0,1,0,1,-1.0,1.0
Nicolae Manea,pressone.ro,0,0,1,1,0.0,0.0
Panama,pressone.ro,0,0,1,1,0.0,0.0
Piovra,pressone.ro,0,0,1,1,0.0,0.0
Răzvan Moga,pressone.ro,0,1,0,1,-1.0,1.0
Sorin Strutinsky,pressone.ro,0,0,1,1,0.0,0.0
Corrado Cattani,pressone.ro,0,0,2,2,0.0,0.0
constănțean,pressone.ro,0,0,1,1,0.0,0.0
Lavinia Betea,pressone.ro,0,0,1,1,0.0,0.0
Șerban Constantin,pressone.ro,0,0,1,1,0.0,0.0
țar,pressone.ro,0,1,0,1,-1.0,1.0
Botoșani,stirileprotv.ro,0,0,1,1,0.0,0.0
Maramureș,stirileprotv.ro,0,0,1,1,0.0,0.0
Mehedinți,stirileprotv.ro,0,0,1,1,0.0,0.0
Olt,stirileprotv.ro,0,0,1,1,0.0,0.0
Vaslui,stirileprotv.ro,0,0,1,1,0.0,0.0
Vâlcea,stirileprotv.ro,0,0,1,1,0.0,0.0
crescător,stirileprotv.ro,0,0,1,1,0.0,0.0
gestionar,stirileprotv.ro,0,0,1,1,0.0,0.0
medic veterinar,stirileprotv.ro,0,0,2,2,0.0,0.0
operator,stirileprotv.ro,0,0,1,1,0.0,0.0
ordonator,stirileprotv.ro,0,1,0,1,-1.0,1.0
pescar,stirileprotv.ro,0,0,1,1,0.0,0.0
producător,stirileprotv.ro,0,0,1,1,0.0,0.0
vânător,stirileprotv.ro,0,0,1,1,0.0,0.0
Kovesi,observatornews.ro,0,1,0,1,-1.0,1.0
Năstase,observatornews.ro,0,1,0,1,-1.0,1.0
bețivă,observatornews.ro,0,1,0,1,-1.0,1.0
corupt,observatornews.ro,0,1,0,1,-1.0,1.0
Monica Macovei,observatornews.ro,0,1,0,1,-1.0,1.0
otrepe,observatornews.ro,0,1,0,1,-1.0,1.0
satana,observatornews.ro,0,1,0,1,-1.0,1.0
swingeri,observatornews.ro,0,1,0,1,-1.0,1.0
țoapă,observatornews.ro,0,1,0,1,-1.0,1.0
Cotroceni,www.news.ro,0,0,4,4,0.0,0.0
bătrân,www.news.ro,0,2,0,2,-1.0,1.0
Victoria Furtuna,www.luju.ro,0,2,0,2,-1.0,1.0
Victoriei Furtuna,www.luju.ro,0,0,1,1,0.0,0.0
Andrzej Duda,www.comisarul.ro,0,0,2,2,0.0,0.0
Donald Tusk,www.comisarul.ro,0,0,3,3,0.0,0.0
Nawrocki,www.comisarul.ro,0,1,2,3,-0.3333333333333333,0.3333333333333333
Rafal Trzaskowski,www.comisarul.ro,0,0,4,4,0.0,0.0
Slawomir Mentzen,www.comisarul.ro,0,0,1,1,0.0,0.0
Trzaskowski,www.comisarul.ro,0,0,2,2,0.0,0.0
Tusk,www.comisarul.ro,0,0,2,2,0.0,0.0
Cristian Bușoi,www.aktual24.ro,0,0,1,1,0.0,0.0
Adrian Țuțuianu,observatornews.ro,0,0,1,1,0.0,0.0
Botoșani,observatornews.ro,0,0,1,1,0.0,0.0
Răzvan Rotaru,observatornews.ro,0,0,1,1,0.0,0.0
Țuțuianu,observatornews.ro,0,0,1,1,0.0,0.0
Nicolae Popescu,stirileprotv.ro,0,0,1,1,0.0,0.0
Reșița,www.news.ro,0,0,1,1,0.0,0.0
dansator,www.news.ro,0,0,1,1,0.0,0.0
Cristina Neagu,www.euronews.ro,0,0,1,1,0.0,0.0
David Popovici,www.euronews.ro,0,0,1,1,0.0,0.0
Hadi Matar,www.euronews.ro,0,1,0,1,-1.0,1.0
Mayville,www.euronews.ro,0,0,1,1,0.0,0.0
Salman Rushdie,www.euronews.ro,0,0,2,2,0.0,0.0
Sebastian Stan,www.euronews.ro,0,0,1,1,0.0,0.0
Tudor Chirilă,www.euronews.ro,0,0,1,1,0.0,0.0
Vladimir Medinski,www.euronews.ro,0,0,1,1,0.0,0.0
efect,www.euronews.ro,0,0,1,1,0.0,0.0
jurator,www.euronews.ro,0,0,1,1,0.0,0.0
prizonier,www.euronews.ro,0,0,1,1,0.0,0.0
scriitor,www.euronews.ro,0,0,1,1,0.0,0.0
Ciprian Ciucu,www.b1tv.ro,1,0,0,1,1.0,1.0
Ciucu,www.b1tv.ro,1,0,0,1,1.0,1.0
Ardelean,www.news.ro,0,0,1,1,0.0,0.0
Ben-Oni Ardelean,www.news.ro,0,0,1,1,0.0,0.0
ales,www.news.ro,0,1,1,2,-0.5,0.5
Laura Vicol,www.comisarul.ro,0,1,1,2,-0.5,0.5
Coțofenești,www.activenews.ro,0,0,1,1,0.0,0.0
Doamna Turcan,www.activenews.ro,0,1,0,1,-1.0,1.0
Roma,www.activenews.ro,0,2,0,2,-1.0,1.0
Toma Tataru,www.activenews.ro,0,0,1,1,0.0,0.0
Turcan,www.activenews.ro,0,4,1,5,-0.8,0.8
dumneaei,www.activenews.ro,0,0,1,1,0.0,0.0
neavenit,www.activenews.ro,0,1,0,1,-1.0,1.0
Piatra Neamț,stirileprotv.ro,0,0,1,1,0.0,0.0
Liban,stirileprotv.ro,0,0,1,1,0.0,0.0
fetiță,www.antena3.ro,0,0,1,1,0.0,0.0
Adrian Veștea,www.comisarul.ro,0,0,1,1,0.0,0.0
Sebastian Burduja,www.mediafax.ro,0,0,1,1,0.0,0.0
solicitant,www.mediafax.ro,0,2,3,5,-0.4,0.4
Adrian Ursu,www.cotidianul.ro,0,0,1,1,0.0,0.0
independență,www.cotidianul.ro,0,1,0,1,-1.0,1.0
Mihaela Geoană,www.cotidianul.ro,0,0,1,1,0.0,0.0
Mircea Geoană,www.cotidianul.ro,0,0,5,5,0.0,0.0
Oana Stancu,www.cotidianul.ro,0,2,0,2,-1.0,1.0
Oanei Stancu,www.cotidianul.ro,0,1,0,1,-1.0,1.0
Zamfir,www.cotidianul.ro,0,1,0,1,-1.0,1.0
zeiță,www.cotidianul.ro,0,1,0,1,-1.0,1.0
arbitru,www.cotidianul.ro,0,0,1,1,0.0,0.0
deontolog,www.cotidianul.ro,0,1,0,1,-1.0,1.0
jucător,www.cotidianul.ro,0,1,1,2,-0.5,0.5
mandatar,www.cotidianul.ro,0,1,0,1,-1.0,1.0
navetist,www.cotidianul.ro,0,1,0,1,-1.0,1.0
redactor,www.cotidianul.ro,0,1,0,1,-1.0,1.0
sponsor,www.cotidianul.ro,0,1,0,1,-1.0,1.0
telespectator,www.cotidianul.ro,0,0,1,1,0.0,0.0
vinovat,www.cotidianul.ro,0,1,0,1,-1.0,1.0
Alexandru Vasile,www.comisarul.ro,0,1,2,3,-0.3333333333333333,0.3333333333333333
Ana Birchall,www.comisarul.ro,0,0,1,1,0.0,0.0
Augustin Zegrean,www.comisarul.ro,0,0,1,1,0.0,0.0
Florin Iordache,www.comisarul.ro,0,0,1,1,0.0,0.0
Gheorghița Popescu,www.comisarul.ro,0,0,1,1,0.0,0.0
Mateescu,www.comisarul.ro,0,0,1,1,0.0,0.0
Ploiești,www.comisarul.ro,0,0,1,1,0.0,0.0
Raluca Alexandra Prună,www.comisarul.ro,0,0,1,1,0.0,0.0
Robert Marius Cazanciuc,www.comisarul.ro,0,0,1,1,0.0,0.0
Tudorel Toader,www.comisarul.ro,0,0,1,1,0.0,0.0
Vasile,www.comisarul.ro,0,0,1,1,0.0,0.0
Bogdan Mateescu,www.comisarul.ro,0,0,1,1,0.0,0.0
personal,www.comisarul.ro,0,0,1,1,0.0,0.0
Alexandru Rafila,www.comisarul.ro,0,0,1,1,0.0,0.0
Angel Tîlvăr,www.comisarul.ro,0,0,1,1,0.0,0.0
Ciprian Șerban,www.comisarul.ro,0,0,2,2,0.0,0.0
Attila Cseke,www.comisarul.ro,0,0,1,1,0.0,0.0
Florin Barbu,www.comisarul.ro,0,0,1,1,0.0,0.0
minister,www.comisarul.ro,0,0,1,1,0.0,0.0
Marcel Boloș,www.comisarul.ro,0,0,1,1,0.0,0.0
Mircea Fechet,www.comisarul.ro,0,0,1,1,0.0,0.0
Natalia Intotero,www.comisarul.ro,0,0,1,1,0.0,0.0
Radu Marinescu,www.comisarul.ro,0,0,1,1,0.0,0.0
Radu Oprea,www.comisarul.ro,0,0,1,1,0.0,0.0
Tanczos Barna,www.comisarul.ro,0,0,1,1,0.0,0.0
vicepremier,www.comisarul.ro,0,0,1,1,0.0,0.0
tehnocrat,www.comisarul.ro,0,0,1,1,0.0,0.0
Codrin Ștefănescu,www.antena3.ro,0,0,1,1,0.0,0.0
gropar,www.luju.ro,0,1,0,1,-1.0,1.0
Fechet,www.digi24.ro,0,0,1,1,0.0,0.0
Mircea Fechet,www.digi24.ro,0,0,2,2,0.0,0.0
Vaslui,www.digi24.ro,0,0,1,1,0.0,0.0
Beirut,recorder.ro,0,1,0,1,-1.0,1.0
incendiator,recorder.ro,0,1,0,1,-1.0,1.0
siderurgist,recorder.ro,0,0,1,1,0.0,0.0
Ana,www.romaniatv.net,0,0,1,1,0.0,0.0
Ana Maria Cătăuță,www.romaniatv.net,0,0,1,1,0.0,0.0
Anei Cătăuță,www.romaniatv.net,0,0,1,1,0.0,0.0
Anei Maria Cătăuță,www.romaniatv.net,0,0,1,1,0.0,0.0
Mihaela,www.romaniatv.net,0,0,1,1,0.0,0.0
vecin,www.romaniatv.net,0,1,0,1,-1.0,1.0
președinte interimar,www.antena3.ro,0,0,2,2,0.0,0.0
Boc,www.euronews.ro,0,1,0,1,-1.0,1.0
analfabet,www.euronews.ro,0,1,0,1,-1.0,1.0
Belarus,www.gandul.ro,0,1,0,1,-1.0,1.0
Minsk,www.gandul.ro,0,1,0,1,-1.0,1.0
Cătălin Avramescu,www.mediafax.ro,0,0,1,1,0.0,0.0
Galac,www.g4media.ro,0,0,1,1,0.0,0.0
Giurgiu,www.g4media.ro,0,0,2,2,0.0,0.0
Gyula Winkler,www.g4media.ro,0,0,1,1,0.0,0.0
Ialomița,www.g4media.ro,0,0,1,1,0.0,0.0
Mehedinți,www.g4media.ro,0,0,1,1,0.0,0.0
Transcarpatia,www.g4media.ro,0,0,1,1,0.0,0.0
Alice Weidel,recorder.ro,0,0,1,1,0.0,0.0
Dorian,recorder.ro,0,0,1,1,0.0,0.0
Olaf Scholz,recorder.ro,0,1,0,1,-1.0,1.0
migrant,recorder.ro,0,1,0,1,-1.0,1.0
Dan Suciu,pressone.ro,0,0,2,2,0.0,0.0
Mugur Isărescu,pressone.ro,0,0,3,3,0.0,0.0
Radu Oprea,pressone.ro,1,0,1,2,0.5,0.5
analist economic,pressone.ro,0,0,1,1,0.0,0.0
critic,pressone.ro,0,2,0,2,-1.0,1.0
posesor,pressone.ro,0,2,0,2,-1.0,1.0
Daniel Zamfir,pressone.ro,0,1,0,1,-1.0,1.0
împrumutător,pressone.ro,0,1,0,1,-1.0,1.0
Botond Nagy,www.luju.ro,0,1,0,1,-1.0,1.0
Eliasz Klimowicz,www.luju.ro,0,1,0,1,-1.0,1.0
Hristos,www.luju.ro,1,2,0,3,-0.3333333333333333,0.3333333333333333
Iulian Bulai,www.luju.ro,0,1,0,1,-1.0,1.0
Mântuitor,www.luju.ro,0,1,0,1,-1.0,1.0
Iisus Hristos,www.luju.ro,0,1,0,1,-1.0,1.0
Ilya,www.luju.ro,0,1,0,1,-1.0,1.0
Sfânta Fecioară Maria,www.luju.ro,0,0,1,1,0.0,0.0
Tadeusz Slobodzianek,www.luju.ro,0,0,1,1,0.0,0.0
Tadeusz Słobodzianek,www.luju.ro,0,1,0,1,-1.0,1.0
actriță,www.luju.ro,0,1,0,1,-1.0,1.0
credincios,www.luju.ro,0,1,0,1,-1.0,1.0
profet,www.luju.ro,0,1,0,1,-1.0,1.0
spectator,www.luju.ro,0,2,0,2,-1.0,1.0
Ioan Sima,www.romaniatv.net,0,0,1,1,0.0,0.0
Sima,www.romaniatv.net,0,0,1,1,0.0,0.0
Victor Vlad Delamarina,www.romaniatv.net,0,0,1,1,0.0,0.0
Dan Vilceanu,www.aktual24.ro,0,2,0,2,-1.0,1.0
Florin Roman,www.aktual24.ro,0,2,0,2,-1.0,1.0
Vilceanu,www.aktual24.ro,0,2,0,2,-1.0,1.0
aleș,agerpres.ro,0,0,1,1,0.0,0.0
Buta,a1.ro,0,1,0,1,-1.0,1.0
Campulung,a1.ro,0,0,1,1,0.0,0.0
Sorin Buta,a1.ro,0,1,0,1,-1.0,1.0
Claudiu Manda,www.gandul.ro,0,0,1,1,0.0,0.0
Ramona Chiriac,www.gandul.ro,0,0,1,1,0.0,0.0
Mugur Isărescu,www.euronews.ro,0,0,1,1,0.0,0.0
Radu Vasile,www.euronews.ro,0,0,2,2,0.0,0.0
Theodor Stolojan,www.euronews.ro,0,0,2,2,0.0,0.0
Victor Babiuc,www.euronews.ro,0,0,1,1,0.0,0.0
Victor Ciorbea,www.euronews.ro,0,0,1,1,0.0,0.0
Radu F. Alexandru,www.euronews.ro,0,0,1,1,0.0,0.0
Eugen Nicolicea,www.mediafax.ro,0,1,1,2,-0.5,0.5
Marian Neacșu,www.mediafax.ro,0,0,1,1,0.0,0.0
Oprea,www.mediafax.ro,0,0,2,2,0.0,0.0
Teodorovici,www.mediafax.ro,0,0,1,1,0.0,0.0
copreședinte,www.mediafax.ro,0,1,4,5,-0.2,0.2
investitor,www.mediafax.ro,1,0,0,1,1.0,1.0
reprezentanți,www.mediafax.ro,0,0,1,1,0.0,0.0
Andrei Iugan,www.luju.ro,0,0,1,1,0.0,0.0
Andrei Viorel Iugan,www.luju.ro,0,0,1,1,0.0,0.0
Cami,www.luju.ro,0,1,1,2,-0.5,0.5
GRIVCO,www.luju.ro,0,1,0,1,-1.0,1.0
Mihai Sabina,www.luju.ro,0,2,2,4,-0.5,0.5
Sterica Toma,www.luju.ro,0,0,1,1,0.0,0.0
Voiculescu,www.luju.ro,0,2,0,2,-1.0,1.0
actionar,www.luju.ro,0,1,0,1,-1.0,1.0
altuia,www.luju.ro,0,1,0,1,-1.0,1.0
cititor,www.luju.ro,0,1,1,2,-0.5,0.5
Vlad Voiculescu,www.luju.ro,0,1,0,1,-1.0,1.0
Dan Voiculescu,www.luju.ro,0,2,1,3,-0.6666666666666666,0.6666666666666666
Adina Florea,www.luju.ro,0,0,1,1,0.0,0.0
Aurelia Nicolae,www.luju.ro,0,0,1,1,0.0,0.0
Mihai Lazăr,www.luju.ro,0,1,1,2,-0.5,0.5
Iugan,www.luju.ro,0,0,1,1,0.0,0.0
Camelia Bogdan,www.luju.ro,0,1,2,3,-0.3333333333333333,0.3333333333333333
expert,www.luju.ro,0,1,0,1,-1.0,1.0
fiică,www.luju.ro,0,0,1,1,0.0,0.0
imputernicit,www.luju.ro,0,1,0,1,-1.0,1.0
mostenitor,www.luju.ro,0,2,0,2,-1.0,1.0
Baraolt,snoop.ro,0,0,1,1,0.0,0.0
Butimanu,snoop.ro,0,0,1,1,0.0,0.0
Cezar Dragnea,snoop.ro,0,0,1,1,0.0,0.0
Constantin Barbu,snoop.ro,0,0,1,1,0.0,0.0
Crevedia,snoop.ro,0,0,1,1,0.0,0.0
Dâmbovița,snoop.ro,0,0,3,3,0.0,0.0
Dăeni,snoop.ro,0,0,1,1,0.0,0.0
Gheorghe Doldurea,snoop.ro,0,1,0,1,-1.0,1.0
Benedek Huszar,snoop.ro,0,0,1,1,0.0,0.0
Olt,snoop.ro,0,0,3,3,0.0,0.0
Salcia,snoop.ro,0,0,1,1,0.0,0.0
Stoica Jr,snoop.ro,0,0,1,1,0.0,0.0
Viorica,snoop.ro,0,0,1,1,0.0,0.0
agent de poliție,snoop.ro,0,0,1,1,0.0,0.0
familia Gherghe,snoop.ro,0,0,1,1,0.0,0.0
Cristian Stoica,snoop.ro,0,0,1,1,0.0,0.0
Alan Blaine Stone,adevarul.ro,0,0,2,2,0.0,0.0
Beniamin Netanyahu,adevarul.ro,0,0,1,1,0.0,0.0
Dragoș Dobrescu,adevarul.ro,0,1,1,2,-0.5,0.5
Eugen Sechila,adevarul.ro,0,0,3,3,0.0,0.0
Frank Timiș,adevarul.ro,0,2,0,2,-1.0,1.0
Madagascar,adevarul.ro,0,2,0,2,-1.0,1.0
Marshall Comins,adevarul.ro,0,0,3,3,0.0,0.0
Papa Francisc,adevarul.ro,0,0,1,1,0.0,0.0
Silviu Predoi,adevarul.ro,0,0,1,1,0.0,0.0
Sudan,adevarul.ro,0,2,2,4,-0.5,0.5
Vatican,adevarul.ro,0,0,1,1,0.0,0.0
consultant politic,adevarul.ro,0,0,2,2,0.0,0.0
Mohamed Hamdan Dagalo,adevarul.ro,0,2,0,2,-1.0,1.0
informație,adevarul.ro,0,0,1,1,0.0,0.0
lup,adevarul.ro,0,1,0,1,-1.0,1.0
Horia Potra,adevarul.ro,0,0,1,1,0.0,0.0
turnător,www.news.ro,0,1,0,1,-1.0,1.0
favorit,www.realitatea.net,0,1,0,1,-1.0,1.0
pensionar,www.mediafax.ro,0,0,1,1,0.0,0.0
Adrian Câciu,agerpres.ro,0,0,1,1,0.0,0.0
Câciu,agerpres.ro,0,0,1,1,0.0,0.0
Bogdan Popescu,pressone.ro,0,0,1,1,0.0,0.0
cavaler,pressone.ro,1,0,0,1,1.0,1.0
Cornișteanu,pressone.ro,0,0,1,1,0.0,0.0
Cosmin Manolescu,pressone.ro,0,0,1,1,0.0,0.0
Creatoarea,pressone.ro,0,0,1,1,0.0,0.0
Cristina Modreanu,pressone.ro,0,0,1,1,0.0,0.0
Henri Matisse,pressone.ro,0,0,1,1,0.0,0.0
Irina Cornișteanu,pressone.ro,0,0,1,1,0.0,0.0
Krizbai Bela Dan,pressone.ro,0,0,1,1,0.0,0.0
Liliana Țuroiu,pressone.ro,0,0,1,1,0.0,0.0
Lilianei Țuroiu,pressone.ro,0,0,1,1,0.0,0.0
Matisse,pressone.ro,1,0,0,1,1.0,1.0
Mirel Taloș,pressone.ro,0,0,1,1,0.0,0.0
Pallady,pressone.ro,1,0,0,1,1.0,1.0
Radu Boroianu,pressone.ro,0,0,1,1,0.0,0.0
Radu Carp,pressone.ro,0,0,1,1,0.0,0.0
Theodor Pallady,pressone.ro,0,0,1,1,0.0,0.0
creatoare,pressone.ro,0,0,1,1,0.0,0.0
om de cultură,pressone.ro,0,0,1,1,0.0,0.0
teoretician,pressone.ro,0,0,1,1,0.0,0.0
trainer,pressone.ro,0,0,2,2,0.0,0.0
Țuroiu,pressone.ro,0,0,1,1,0.0,0.0
Bogdan Lefter,www.news.ro,0,0,1,1,0.0,0.0
Mugur Mihăescu,observatornews.ro,1,0,1,2,0.5,0.5
Adrian Popa,observatornews.ro,0,0,1,1,0.0,0.0
Adriana Cârligeanu,observatornews.ro,0,0,1,1,0.0,0.0
Ana Gavrilă,observatornews.ro,0,0,1,1,0.0,0.0
Andrei Baciu,observatornews.ro,0,0,1,1,0.0,0.0
Bihor,observatornews.ro,0,0,2,2,0.0,0.0
Cătălin Țone,observatornews.ro,0,0,1,1,0.0,0.0
Ene Gabriela Corina,observatornews.ro,0,0,1,1,0.0,0.0
Lidia Vadim,observatornews.ro,0,0,1,1,0.0,0.0
Liviu Moșteanu,observatornews.ro,0,0,1,1,0.0,0.0
Sergiu Matei,observatornews.ro,0,2,1,3,-0.6666666666666666,0.6666666666666666
Silvia Mihalcea,observatornews.ro,0,0,1,1,0.0,0.0
boboc,observatornews.ro,0,1,0,1,-1.0,1.0
Crin,www.luju.ro,0,1,0,1,-1.0,1.0
Mariana Glavan,www.luju.ro,0,2,0,2,-1.0,1.0
Mihaila,www.luju.ro,0,0,1,1,0.0,0.0
Moncea,www.luju.ro,0,1,0,1,-1.0,1.0
Nicolae Ciucă,www.luju.ro,0,1,0,1,-1.0,1.0
Dumitru Dumbrava,www.luju.ro,0,0,1,1,0.0,0.0
Alexandru Bordian,snoop.ro,0,0,1,1,0.0,0.0
Ariadna Cîrligeanu,snoop.ro,0,0,1,1,0.0,0.0
Claudia Postelnicescu,snoop.ro,0,0,1,1,0.0,0.0
Coldea,snoop.ro,0,1,0,1,-1.0,1.0
Cosmin Iosub,snoop.ro,0,0,1,1,0.0,0.0
Cristina,snoop.ro,0,0,1,1,0.0,0.0
Cristina Mihaela Oancea,snoop.ro,0,0,1,1,0.0,0.0
Cristina Oancea,snoop.ro,0,0,1,1,0.0,0.0
Cătălin Gheorghe,snoop.ro,0,0,1,1,0.0,0.0
Dumitru Spau,snoop.ro,0,0,1,1,0.0,0.0
Florian Coldea,snoop.ro,0,0,1,1,0.0,0.0
Ialomița,snoop.ro,0,0,4,4,0.0,0.0
Ion Oancea,snoop.ro,0,0,1,1,0.0,0.0
Lulea,snoop.ro,0,0,1,1,0.0,0.0
Marina Gheorghe,snoop.ro,0,0,1,1,0.0,0.0
Oancea,snoop.ro,0,0,2,2,0.0,0.0
Ponta,snoop.ro,0,2,0,2,-1.0,1.0
Silviu Oancea,snoop.ro,0,0,2,2,0.0,0.0
Slobozia,snoop.ro,0,0,1,1,0.0,0.0
suspect,snoop.ro,0,0,1,1,0.0,0.0
Tiberiu Claudiu Barstan,snoop.ro,0,0,1,1,0.0,0.0
Tunari,snoop.ro,0,0,1,1,0.0,0.0
Vicepreședintele,snoop.ro,0,0,1,1,0.0,0.0
inginer,snoop.ro,0,1,0,1,-1.0,1.0
Ștefan Constantinescu,snoop.ro,0,0,1,1,0.0,0.0
locțiitor,pressone.ro,0,0,1,1,0.0,0.0
Corneliu Sălișteanu,www.antena3.ro,0,0,1,1,0.0,0.0
Corneliu Ștefan,www.antena3.ro,0,0,1,1,0.0,0.0
Felix Georgescu,www.antena3.ro,0,0,1,1,0.0,0.0
Ioana Radu,www.antena3.ro,0,0,1,1,0.0,0.0
Ionuț Săvoiu,www.antena3.ro,0,0,1,1,0.0,0.0
Laurențiu Neculaescu,www.antena3.ro,0,0,1,1,0.0,0.0
Mihai Istrate,www.antena3.ro,0,0,1,1,0.0,0.0
Niculești,www.antena3.ro,0,0,1,1,0.0,0.0
Titus Corlățean,www.antena3.ro,0,0,1,1,0.0,0.0
Dumitru Barbu,www.antena3.ro,0,0,1,1,0.0,0.0
consilier județean,www.antena3.ro,0,0,1,1,0.0,0.0
delegat,www.antena3.ro,0,0,1,1,0.0,0.0
Carmen Holban,www.antena3.ro,0,0,1,1,0.0,0.0
Radu Popa,www.antena3.ro,0,0,1,1,0.0,0.0
Claudia Gilia,www.antena3.ro,0,0,1,1,0.0,0.0
Florin Georgescu,www.antena3.ro,0,0,1,1,0.0,0.0
Laurențiu Plăeșu,agerpres.ro,0,0,1,1,0.0,0.0
Sebastian Burduja,agerpres.ro,0,0,2,2,0.0,0.0
Macron,www.mediafax.ro,0,0,1,1,0.0,0.0
Claudiu Tarziu,www.aktual24.ro,0,1,2,3,-0.3333333333333333,0.3333333333333333
Dan Dungaciu,www.aktual24.ro,0,0,1,1,0.0,0.0
Dan Puric,www.aktual24.ro,0,0,2,2,0.0,0.0
voievoz,www.aktual24.ro,0,1,0,1,-1.0,1.0
Moldovan,agerpres.ro,0,0,1,1,0.0,0.0
Radu Moldovan,agerpres.ro,0,0,1,1,0.0,0.0
Gheorghe Carciu,www.aktual24.ro,0,1,0,1,-1.0,1.0
Șerban Valeca,www.mediafax.ro,0,0,2,2,0.0,0.0
chestionar,adevarul.ro,0,0,1,1,0.0,0.0
Bogdan Ciucă,observatornews.ro,0,0,1,1,0.0,0.0
Chelaru,observatornews.ro,0,0,1,1,0.0,0.0
Florin Iordache,observatornews.ro,0,0,1,1,0.0,0.0
Ioan Chelaru,observatornews.ro,0,0,1,1,0.0,0.0
Mate Andras,observatornews.ro,0,0,1,1,0.0,0.0
Valeria Schelean,observatornews.ro,0,0,1,1,0.0,0.0
Cristela Georgescu,primanews.ro,0,0,1,1,0.0,0.0
soție,primanews.ro,0,0,3,3,0.0,0.0
participanț,www.news.ro,0,0,2,2,0.0,0.0
Dani Sandu,pressone.ro,0,0,3,3,0.0,0.0
Ioan Muntean,www.mediafax.ro,0,0,1,1,0.0,0.0
Marin Iancu,www.mediafax.ro,0,0,1,1,0.0,0.0
deținut,www.mediafax.ro,0,1,0,1,-1.0,1.0
deținut politic,www.mediafax.ro,0,0,1,1,0.0,0.0
torționar,www.mediafax.ro,0,1,0,1,-1.0,1.0
Bogdan Teodorescu,www.mediafax.ro,0,0,2,2,0.0,0.0
constituționalist,www.mediafax.ro,0,1,0,1,-1.0,1.0
Emil Constantinescu,www.mediafax.ro,1,0,0,1,1.0,1.0
analist politic,www.mediafax.ro,0,0,1,1,0.0,0.0
multor,www.mediafax.ro,0,1,0,1,-1.0,1.0
Dan Jørgensen,www.mediafax.ro,0,0,1,1,0.0,0.0
comisar,www.mediafax.ro,0,0,2,2,0.0,0.0
Cristina Prună,www.news.ro,0,0,1,1,0.0,0.0
Prună,www.news.ro,0,0,1,1,0.0,0.0
John Ion Banu Muscel,www.gandul.ro,0,0,1,1,0.0,0.0
Neagu,www.romaniatv.net,0,0,1,1,0.0,0.0
Petre Emanoil Neagu,www.romaniatv.net,0,1,0,1,-1.0,1.0
Adrian Foghiș,adevarul.ro,0,0,1,1,0.0,0.0
Ancuța Șchiop,adevarul.ro,0,0,1,1,0.0,0.0
Beiuș,adevarul.ro,0,0,1,1,0.0,0.0
Birta Florin,adevarul.ro,0,0,1,1,0.0,0.0
Cociuba Mare,adevarul.ro,0,0,1,1,0.0,0.0
Cristian Buzlea,adevarul.ro,0,0,1,1,0.0,0.0
Călin Gal,adevarul.ro,0,0,1,1,0.0,0.0
Florin Birta,adevarul.ro,0,0,1,1,0.0,0.0
Gabriel Popa,adevarul.ro,0,0,1,1,0.0,0.0
Gheorghe Bota,adevarul.ro,0,0,1,1,0.0,0.0
Ioan Mărcuș,adevarul.ro,0,0,1,1,0.0,0.0
Iulian Balaj,adevarul.ro,0,0,1,1,0.0,0.0
Marcela Prada,adevarul.ro,0,0,1,1,0.0,0.0
Mihai Sferle,adevarul.ro,0,0,1,1,0.0,0.0
Mirca Mălan,adevarul.ro,0,0,1,1,0.0,0.0
Mircea Mălan,adevarul.ro,0,0,2,2,0.0,0.0
Rieni,adevarul.ro,0,0,1,1,0.0,0.0
Sântandrei,adevarul.ro,0,0,1,1,0.0,0.0
Teofil Filimon,adevarul.ro,0,0,1,1,0.0,0.0
Kiss Janos,adevarul.ro,0,0,1,1,0.0,0.0
Gheorghe Carp,adevarul.ro,0,0,1,1,0.0,0.0
Dumitru Țiplea,adevarul.ro,0,0,1,1,0.0,0.0
Arina Moș,adevarul.ro,0,0,2,2,0.0,0.0
Ștei,adevarul.ro,0,0,1,1,0.0,0.0
Angel Tâlvar,www.digi24.ro,0,0,1,1,0.0,0.0
Florin Barbu,www.digi24.ro,0,0,1,1,0.0,0.0
Natalia Intotero,www.digi24.ro,0,0,1,1,0.0,0.0
Simona Bucura-Oprescu,www.digi24.ro,0,0,1,1,0.0,0.0
Avram,adevarul.ro,0,0,1,1,0.0,0.0
Carmen Avram,adevarul.ro,0,0,1,1,0.0,0.0
Johansson,adevarul.ro,0,0,1,1,0.0,0.0
istor,adevarul.ro,0,0,1,1,0.0,0.0
Pedro Sanchez,adevarul.ro,1,0,0,1,1.0,1.0
Ylva Johansson,adevarul.ro,0,0,1,1,0.0,0.0
Vlad Nistor,adevarul.ro,0,1,1,2,-0.5,0.5
Ion Vargau,stirileprotv.ro,0,0,1,1,0.0,0.0
Gavrila,www.romaniatv.net,0,1,0,1,-1.0,1.0
Lucian Mândruță,www.romaniatv.net,0,0,1,1,0.0,0.0
agresor,stirileprotv.ro,0,1,0,1,-1.0,1.0
Carmen Iohannis,a1.ro,0,0,1,1,0.0,0.0
reporter,a1.ro,0,1,1,2,-0.5,0.5
Lucian Viziteu,adevarul.ro,0,0,4,4,0.0,0.0
Viziteu,adevarul.ro,0,0,2,2,0.0,0.0
Bianca Drăgușanu,www.b1tv.ro,0,1,0,1,-1.0,1.0
Victor Slav,www.b1tv.ro,0,0,1,1,0.0,0.0
prezentator,www.b1tv.ro,0,0,1,1,0.0,0.0
Mureșan,www.antena3.ro,0,0,1,1,0.0,0.0
Siegfried Mureșan,www.antena3.ro,0,0,1,1,0.0,0.0
rude,www.antena3.ro,0,0,1,1,0.0,0.0
Alin Stoica,www.antena3.ro,0,0,1,1,0.0,0.0
Păun,www.antena3.ro,0,0,2,2,0.0,0.0
Tudor Polak,www.antena3.ro,0,0,1,1,0.0,0.0
negociator,www.antena3.ro,0,1,0,1,-1.0,1.0
Elena,www.mediafax.ro,0,0,1,1,0.0,0.0
unit,www.mediafax.ro,0,1,0,1,-1.0,1.0
Theodor Paleologu,www.mediafax.ro,0,0,1,1,0.0,0.0
Violeta Alexandru,www.mediafax.ro,0,0,1,1,0.0,0.0
respondent,www.mediafax.ro,0,0,2,2,0.0,0.0
Beniamin Todosiu,recorder.ro,0,0,1,1,0.0,0.0
Ciuruleasa,recorder.ro,0,0,1,1,0.0,0.0
Clement Negruț,recorder.ro,0,0,1,1,0.0,0.0
Corneliu Olar,recorder.ro,0,0,1,1,0.0,0.0
Călin Matieș,recorder.ro,0,0,1,1,0.0,0.0
Elveție,recorder.ro,1,0,0,1,1.0,1.0
Felix,recorder.ro,0,0,1,1,0.0,0.0
Honoré de Balzac,recorder.ro,0,0,1,1,0.0,0.0
Ioan Alin Ignat,recorder.ro,0,0,1,1,0.0,0.0
Ioan Lazăr,recorder.ro,0,0,1,1,0.0,0.0
Mircea Eliade,recorder.ro,0,0,2,2,0.0,0.0
Moț,recorder.ro,0,1,0,1,-1.0,1.0
Petroșani,recorder.ro,0,0,1,1,0.0,0.0
Poieni,recorder.ro,0,0,1,1,0.0,0.0
Radu Marcel Tuhuț,recorder.ro,0,0,1,1,0.0,0.0
Sorin Ioan Bumb,recorder.ro,0,0,1,1,0.0,0.0
gospodar,recorder.ro,1,0,0,1,1.0,1.0
masterand,recorder.ro,0,0,1,1,0.0,0.0
Țara Moților,recorder.ro,0,1,0,1,-1.0,1.0
Anna Akhalkatsi,www.luju.ro,0,0,1,1,0.0,0.0
Biden,adevarul.ro,0,1,0,1,-1.0,1.0
publicist,adevarul.ro,0,1,0,1,-1.0,1.0
Sabin Sărmaș,www.gandul.ro,0,0,1,1,0.0,0.0
Bichineț,www.digi24.ro,0,0,1,1,0.0,0.0
Bacalbașa,www.digi24.ro,0,0,1,1,0.0,0.0
Florin Iordache,www.digi24.ro,0,0,1,1,0.0,0.0
Mihai Călin,www.digi24.ro,0,0,3,3,0.0,0.0
domnul ăsta,www.digi24.ro,0,1,0,1,-1.0,1.0
ăla,www.digi24.ro,0,1,0,1,-1.0,1.0
Șerban Nicolae,www.digi24.ro,0,0,2,2,0.0,0.0
Costoiu,www.comisarul.ro,0,1,0,1,-1.0,1.0
Mihnea Costoiu,www.comisarul.ro,0,0,1,1,0.0,0.0
rector,www.comisarul.ro,0,0,1,1,0.0,0.0
Didrik de Schaetzen,pressone.ro,0,0,1,1,0.0,0.0
Georg Brockmeyer,pressone.ro,0,0,1,1,0.0,0.0
Hans van Baalen,pressone.ro,0,0,1,1,0.0,0.0
Orla Hav,pressone.ro,0,0,1,1,0.0,0.0
Christian Kern,pressone.ro,0,0,1,1,0.0,0.0
om de știință,www.cotidianul.ro,2,0,0,2,1.0,1.0
Uliana Dmitrieva,www.cotidianul.ro,0,0,1,1,0.0,0.0
cercetătoare,www.cotidianul.ro,0,0,1,1,0.0,0.0
cercetător,www.cotidianul.ro,1,0,0,1,1.0,1.0
Câmpulung Muscel,pressone.ro,0,0,1,1,0.0,0.0
"Mateei Petrescu, directoare",www.romaniatv.net,0,0,1,1,0.0,0.0
conspiraționist,www.romaniatv.net,0,1,0,1,-1.0,1.0
Tate,www.romaniatv.net,0,0,1,1,0.0,0.0
toți,www.romaniatv.net,0,1,0,1,-1.0,1.0
Andrei Năstase,adevarul.ro,0,0,1,1,0.0,0.0
Bădescu,adevarul.ro,0,0,1,1,0.0,0.0
Dughin,adevarul.ro,0,0,1,1,0.0,0.0
Ilie Bădescu,adevarul.ro,0,0,1,1,0.0,0.0
Malița,adevarul.ro,0,0,1,1,0.0,0.0
Mihai Ghimpu,adevarul.ro,0,0,1,1,0.0,0.0
Mircea Malița,adevarul.ro,0,0,2,2,0.0,0.0
Plahotniuc,adevarul.ro,0,1,0,1,-1.0,1.0
discipol,adevarul.ro,0,0,1,1,0.0,0.0
hacker,adevarul.ro,0,2,0,2,-1.0,1.0
ideolog,adevarul.ro,0,3,0,3,-1.0,1.0
Vladimir Plahotniuc,adevarul.ro,0,1,0,1,-1.0,1.0
propagandist,adevarul.ro,0,1,0,1,-1.0,1.0
Români,adevarul.ro,0,0,1,1,0.0,0.0
Botezatu,adevarul.ro,0,0,1,1,0.0,0.0
bugetar,adevarul.ro,0,1,0,1,-1.0,1.0
Can Can,adevarul.ro,0,0,1,1,0.0,0.0
Codin Matciuc,adevarul.ro,0,0,1,1,0.0,0.0
Codin Maticiuc,adevarul.ro,0,1,0,1,-1.0,1.0
Costel Cașuneanu,adevarul.ro,0,0,1,1,0.0,0.0
Costel Cășuneanu,adevarul.ro,0,0,1,1,0.0,0.0
Dan Cristian Popescu,adevarul.ro,0,0,1,1,0.0,0.0
Dragos Sprînceană,adevarul.ro,0,0,1,1,0.0,0.0
Hawaii,adevarul.ro,0,0,1,1,0.0,0.0
Matei Dima,adevarul.ro,0,0,1,1,0.0,0.0
Mihai Gabriel Popescu,adevarul.ro,0,0,1,1,0.0,0.0
Misu,adevarul.ro,0,0,1,1,0.0,0.0
Mișu,adevarul.ro,0,0,1,1,0.0,0.0
Mișu Popescu,adevarul.ro,0,0,1,1,0.0,0.0
Mișu Pricopsitu,adevarul.ro,0,1,0,1,-1.0,1.0
Pricopsitu,adevarul.ro,0,1,0,1,-1.0,1.0
pricopsit,adevarul.ro,0,1,0,1,-1.0,1.0
model,adevarul.ro,0,0,1,1,0.0,0.0
naș,adevarul.ro,0,0,1,1,0.0,0.0
Y,www.antena3.ro,0,0,1,1,0.0,0.0
adversar,www.euronews.ro,0,1,0,1,-1.0,1.0
Florina,www.realitatea.net,0,1,0,1,-1.0,1.0
Florinei,www.realitatea.net,0,1,0,1,-1.0,1.0
Mihai Tudose,www.realitatea.net,0,1,0,1,-1.0,1.0
Strasbourg,www.realitatea.net,0,0,1,1,0.0,0.0
ales,www.realitatea.net,0,1,0,1,-1.0,1.0
asistent,www.realitatea.net,0,0,2,2,0.0,0.0
asistent parlamentar,www.realitatea.net,0,1,0,1,-1.0,1.0
colegă,www.realitatea.net,0,0,1,1,0.0,0.0
cunoștință,www.realitatea.net,0,0,1,1,0.0,0.0
fată,www.realitatea.net,0,0,1,1,0.0,0.0
secretar,www.realitatea.net,0,1,0,1,-1.0,1.0
nouă,www.comisarul.ro,0,1,0,1,-1.0,1.0
Mihailo Podoliak,primanews.ro,0,0,2,2,0.0,0.0
Alba,www.b1tv.ro,0,0,1,1,0.0,0.0
Buzău,www.b1tv.ro,0,0,1,1,0.0,0.0
Giurgiu,www.b1tv.ro,0,0,1,1,0.0,0.0
Ialomița,www.b1tv.ro,0,0,1,1,0.0,0.0
Mureș,www.b1tv.ro,0,1,1,2,-0.5,0.5
locțiitor,www.b1tv.ro,0,0,1,1,0.0,0.0
Agota,agerpres.ro,0,0,1,1,0.0,0.0
realizatoare,pressone.ro,0,1,0,1,-1.0,1.0
tehnocrat,stirileprotv.ro,0,1,1,2,-0.5,0.5
Nicole Ciucă,www.gandul.ro,0,1,0,1,-1.0,1.0
colegiu,www.gandul.ro,0,0,1,1,0.0,0.0
Augustin Zegrean,primanews.ro,0,0,1,1,0.0,0.0
Zegrean,primanews.ro,0,0,1,1,0.0,0.0
De Potra,www.antena3.ro,0,1,0,1,-1.0,1.0
Elene Lasconi,www.antena3.ro,0,0,1,1,0.0,0.0
Horia Potra,www.antena3.ro,0,1,0,1,-1.0,1.0
Boc,primanews.ro,0,0,1,1,0.0,0.0
clujen,primanews.ro,0,0,1,1,0.0,0.0
Anaheim,adevarul.ro,0,0,1,1,0.0,0.0
Las Vegas,adevarul.ro,0,0,1,1,0.0,0.0
Los Angeles,adevarul.ro,0,0,1,1,0.0,0.0
Portland,adevarul.ro,0,0,1,1,0.0,0.0
Sacramento,adevarul.ro,0,0,1,1,0.0,0.0
San Diego,adevarul.ro,0,0,1,1,0.0,0.0
San Francisco,adevarul.ro,0,0,1,1,0.0,0.0
Seattle,adevarul.ro,0,0,1,1,0.0,0.0
Vancouver,adevarul.ro,0,0,1,1,0.0,0.0
celor,a1.ro,0,1,0,1,-1.0,1.0
observator,a1.ro,0,0,1,1,0.0,0.0
doamnă,www.romaniatv.net,1,0,1,2,0.5,0.5
Geroge Simion,www.romaniatv.net,0,1,0,1,-1.0,1.0
Cotroceni,www.luju.ro,0,1,0,1,-1.0,1.0
OMUL,www.luju.ro,0,1,0,1,-1.0,1.0
Anglia,www.digi24.ro,0,0,1,1,0.0,0.0
Anonescu,www.digi24.ro,0,1,0,1,-1.0,1.0
Imperiul Oman,www.digi24.ro,0,0,1,1,0.0,0.0
domnie,www.digi24.ro,0,1,0,1,-1.0,1.0
critic,www.comisarul.ro,0,2,0,2,-1.0,1.0
moștenitor,www.comisarul.ro,0,1,0,1,-1.0,1.0
Vasile Blaga,primanews.ro,0,0,2,2,0.0,0.0
lume,primanews.ro,0,1,0,1,-1.0,1.0
Hunor,www.mediafax.ro,0,0,1,1,0.0,0.0
Adrian Claudiu Prisnel,pressone.ro,0,0,1,1,0.0,0.0
Allen Coliban,pressone.ro,0,0,1,1,0.0,0.0
Prisnel,pressone.ro,0,0,1,1,0.0,0.0
Întorsura Buzăului,pressone.ro,0,0,1,1,0.0,0.0
OAMENI,recorder.ro,0,1,0,1,-1.0,1.0
teleormăneni,recorder.ro,0,1,0,1,-1.0,1.0
Calistru,pressone.ro,0,0,1,1,0.0,0.0
Cipru,pressone.ro,0,0,1,1,0.0,0.0
Dragoș Pîslaru,pressone.ro,0,0,2,2,0.0,0.0
Elena Calistru,pressone.ro,0,0,2,2,0.0,0.0
Isărescu,pressone.ro,0,0,1,1,0.0,0.0
Marius Necula,adevarul.ro,0,0,1,1,0.0,0.0
Mircea Toader,adevarul.ro,0,1,0,1,-1.0,1.0
subprefect,adevarul.ro,0,1,1,2,-0.5,0.5
Africa,observatornews.ro,1,0,0,1,1.0,1.0
Africă,observatornews.ro,0,0,1,1,0.0,0.0
Austelino Tavares Correia,observatornews.ro,0,0,1,1,0.0,0.0
Capul Verde,observatornews.ro,0,0,1,1,0.0,0.0
Francisco Avelino Carvalho,observatornews.ro,0,0,1,1,0.0,0.0
José Maria Neves,observatornews.ro,0,0,1,1,0.0,0.0
José Ulisses Correia e Silva,observatornews.ro,0,0,1,1,0.0,0.0
Macky Sall,observatornews.ro,0,0,2,2,0.0,0.0
Praia,observatornews.ro,0,0,1,1,0.0,0.0
Republica Capului Verde,observatornews.ro,0,0,1,1,0.0,0.0
Republica Kenya,observatornews.ro,0,0,1,1,0.0,0.0
Republica Senegal,observatornews.ro,0,0,1,1,0.0,0.0
Republica Unită Tanzania,observatornews.ro,0,0,1,1,0.0,0.0
Senegal,observatornews.ro,0,0,2,2,0.0,0.0
Președintele Macky Sall,observatornews.ro,0,0,1,1,0.0,0.0
Samia Suluhu Hassan,observatornews.ro,0,0,1,1,0.0,0.0
William Ruto,observatornews.ro,0,0,1,1,0.0,0.0
Adrian Cozma,stirileprotv.ro,0,0,1,1,0.0,0.0
Buble,www.comisarul.ro,0,0,1,1,0.0,0.0
Cristian Vasile Terheș,www.comisarul.ro,0,0,1,1,0.0,0.0
Elena Valerica Lasconi,www.comisarul.ro,0,0,1,1,0.0,0.0
George Crin Laurențiu Antonescu,www.comisarul.ro,0,0,1,1,0.0,0.0
John Ion Banu Muscel,www.comisarul.ro,0,0,1,1,0.0,0.0
Laurențiu Andrei Vasile,www.comisarul.ro,0,0,1,1,0.0,0.0
Marcela Lavinia Șandru,www.comisarul.ro,0,0,1,1,0.0,0.0
Petru Daniel Funeriu,www.comisarul.ro,0,0,1,1,0.0,0.0
Sebastian Constantin Popescu,www.comisarul.ro,0,0,1,1,0.0,0.0
Sebastian Popescu,www.comisarul.ro,0,0,3,3,0.0,0.0
Silviu Predoiu,www.comisarul.ro,0,0,4,4,0.0,0.0
Marius Pieleanu,www.comisarul.ro,0,0,1,1,0.0,0.0
Stolojan,primanews.ro,0,0,1,1,0.0,0.0
Theodor Stolojan,primanews.ro,0,0,1,1,0.0,0.0
Călin Geogescu,adevarul.ro,0,0,1,1,0.0,0.0
Călin Gerogescu,adevarul.ro,0,0,1,1,0.0,0.0
Dan Jurcan,adevarul.ro,0,0,2,2,0.0,0.0
Paleologu,adevarul.ro,0,0,2,2,0.0,0.0
Theordor Paleologu,adevarul.ro,0,0,1,1,0.0,0.0
Marcel Ciucu,www.aktual24.ro,0,0,1,1,0.0,0.0
Ciadud,www.aktual24.ro,0,0,1,1,0.0,0.0
Grok,www.aktual24.ro,0,0,1,1,0.0,0.0
inș,adevarul.ro,0,1,0,1,-1.0,1.0
Diana Stoica,adevarul.ro,0,0,2,2,0.0,0.0
nepoftit,adevarul.ro,0,1,0,1,-1.0,1.0
Andrzej Duda,www.euronews.ro,0,1,0,1,-1.0,1.0
Karol Nawrocki,www.euronews.ro,0,0,1,1,0.0,0.0
Nawrocki,www.euronews.ro,0,0,1,1,0.0,0.0
Rafal Trzaskowski,www.euronews.ro,0,0,1,1,0.0,0.0
Slawomir Mentzen,www.euronews.ro,0,0,1,1,0.0,0.0
Trzaskowski,www.euronews.ro,0,0,1,1,0.0,0.0
Tusk,www.euronews.ro,0,0,1,1,0.0,0.0
Varșovia,www.euronews.ro,0,0,3,3,0.0,0.0
admirator,www.euronews.ro,0,1,0,1,-1.0,1.0
Alexe,snoop.ro,0,0,1,1,0.0,0.0
Balint Porcsalmi,snoop.ro,0,0,1,1,0.0,0.0
Costel Alexe,snoop.ro,0,0,1,1,0.0,0.0
Malina Norocea,snoop.ro,0,0,1,1,0.0,0.0
Mircea Roșca,snoop.ro,0,2,0,2,-1.0,1.0
Mureș,snoop.ro,0,0,3,3,0.0,0.0
Viktor Orban,snoop.ro,0,0,2,2,0.0,0.0
Tuca,www.realitatea.net,0,0,1,1,0.0,0.0
Alexandru Berechet,www.g4media.ro,0,0,1,1,0.0,0.0
Bogdan Mihuți,www.g4media.ro,0,0,1,1,0.0,0.0
Corina Sulger,www.g4media.ro,0,0,1,1,0.0,0.0
Emil Albotă,www.g4media.ro,0,0,1,1,0.0,0.0
Florin Ciocan,www.g4media.ro,0,0,1,1,0.0,0.0
Forin Barbu,www.g4media.ro,0,0,1,1,0.0,0.0
Ionuț Ivan,www.g4media.ro,0,0,1,1,0.0,0.0
Liviu Voiculescu,www.g4media.ro,0,0,2,2,0.0,0.0
Mariana Leanca,www.g4media.ro,0,0,1,1,0.0,0.0
Marius Iancu,www.g4media.ro,0,0,1,1,0.0,0.0
Marius Oprescu,www.g4media.ro,0,0,1,1,0.0,0.0
Oprescu,www.g4media.ro,0,0,1,1,0.0,0.0
Daniela Popescu,www.g4media.ro,0,0,1,1,0.0,0.0
Răzvan Costel Bățăgui,www.g4media.ro,0,0,1,1,0.0,0.0
Siminica Mirea,www.g4media.ro,0,0,1,1,0.0,0.0
Voiculescu,www.g4media.ro,0,2,0,2,-1.0,1.0
donatoare,www.g4media.ro,0,0,1,1,0.0,0.0
finalist,primanews.ro,0,0,1,1,0.0,0.0
Dinu Patriciu,www.news.ro,0,0,1,1,0.0,0.0
Eduard Hellvig,www.news.ro,0,0,4,4,0.0,0.0
Stelian Tănase,www.news.ro,0,0,1,1,0.0,0.0
impostor,www.news.ro,0,1,0,1,-1.0,1.0
trădător,www.news.ro,0,1,0,1,-1.0,1.0
Corneliu Bjola,www.euronews.ro,0,0,1,1,0.0,0.0
Iulian Fota,www.euronews.ro,0,0,1,1,0.0,0.0
Valentin Naumescu,www.euronews.ro,0,0,1,1,0.0,0.0
Ivica Dacic,www.realitatea.net,0,1,0,1,-1.0,1.0
demonstrant,www.realitatea.net,0,0,1,1,0.0,0.0
huligan,www.realitatea.net,0,1,0,1,-1.0,1.0
manifestant,www.realitatea.net,0,0,1,1,0.0,0.0
student,www.realitatea.net,1,0,1,2,0.5,0.5
Ciprian Dobre,primanews.ro,0,0,1,1,0.0,0.0
Dinu Iancu Sălăjanu,primanews.ro,0,0,1,1,0.0,0.0
Daniel Buda,primanews.ro,0,1,0,1,-1.0,1.0
Hrebenciuc,primanews.ro,0,0,3,3,0.0,0.0
continuator,primanews.ro,0,1,0,1,-1.0,1.0
doamna Lasconi,primanews.ro,0,1,0,1,-1.0,1.0
Cîrstoiu,www.euronews.ro,0,0,1,1,0.0,0.0
judecătoare,www.euronews.ro,0,0,2,2,0.0,0.0
mai,www.euronews.ro,0,0,1,1,0.0,0.0
Vlad Pascu,www.euronews.ro,0,0,1,1,0.0,0.0
Alexandrina Culea,adevarul.ro,0,0,1,1,0.0,0.0
Alexandru Culea,adevarul.ro,0,0,1,1,0.0,0.0
Amalia Șerban,adevarul.ro,0,0,2,2,0.0,0.0
Andreea Moldovan,adevarul.ro,0,0,1,1,0.0,0.0
Liliana Bunaciu,adevarul.ro,0,0,1,1,0.0,0.0
Moldovan,adevarul.ro,0,0,1,1,0.0,0.0
Monica Negovan,adevarul.ro,0,0,1,1,0.0,0.0
Negovan,adevarul.ro,0,0,1,1,0.0,0.0
Nicoleta Rusu,adevarul.ro,0,0,1,1,0.0,0.0
Nicolete Rusu,adevarul.ro,0,1,0,1,-1.0,1.0
Voiculescu,adevarul.ro,0,0,1,1,0.0,0.0
directoare,adevarul.ro,0,1,0,1,-1.0,1.0
farmacist,adevarul.ro,0,0,2,2,0.0,0.0
jurist,adevarul.ro,0,1,2,3,-0.3333333333333333,0.3333333333333333
Șerban,adevarul.ro,0,0,1,1,0.0,0.0
Târziu,agerpres.ro,0,0,1,1,0.0,0.0
exponenț,agerpres.ro,0,1,0,1,-1.0,1.0
Barbu,a1.ro,0,0,1,1,0.0,0.0
Gheorghe Barbu,a1.ro,0,0,1,1,0.0,0.0
Manfred Weber,www.cotidianul.ro,0,0,2,2,0.0,0.0
Mureșan,www.cotidianul.ro,0,0,1,1,0.0,0.0
Weber,www.cotidianul.ro,0,0,1,1,0.0,0.0
Funar,www.mediafax.ro,0,0,1,1,0.0,0.0
Gheorghe Funar,www.mediafax.ro,0,0,1,1,0.0,0.0
Transilvania,www.mediafax.ro,0,1,0,1,-1.0,1.0
Ungaria,www.mediafax.ro,0,2,1,3,-0.6666666666666666,0.6666666666666666
Ungaria Mare,www.mediafax.ro,0,1,0,1,-1.0,1.0
etnic,www.mediafax.ro,0,1,0,1,-1.0,1.0
Adrian Niculescu,www.cotidianul.ro,0,1,0,1,-1.0,1.0
Bogdan Peșchir,www.cotidianul.ro,0,1,0,1,-1.0,1.0
Nicușor Darn,www.cotidianul.ro,0,1,0,1,-1.0,1.0
inamic,www.cotidianul.ro,0,1,0,1,-1.0,1.0
opozant,www.cotidianul.ro,0,1,0,1,-1.0,1.0
Adam Kobeissi,www.comisarul.ro,1,0,0,1,1.0,1.0
Carlo De Luca,www.comisarul.ro,0,0,1,1,0.0,0.0
Chinei,www.comisarul.ro,0,0,1,1,0.0,0.0
Londra,www.comisarul.ro,0,0,2,2,0.0,0.0
Aheea,a1.ro,0,0,1,1,0.0,0.0
Antim,a1.ro,1,0,0,1,1.0,1.0
Antim Antim,a1.ro,0,0,1,1,0.0,0.0
Grecia antică,a1.ro,1,0,0,1,1.0,1.0
Mirabela Grădinaru,a1.ro,0,0,1,1,0.0,0.0
Sfântul Antim Ivireanul,a1.ro,1,0,0,1,1.0,1.0
a,a1.ro,0,2,0,2,-1.0,1.0
băiețel,a1.ro,1,0,0,1,1.0,1.0
fetiță,a1.ro,0,0,1,1,0.0,0.0
micuță,a1.ro,1,0,0,1,1.0,1.0
mitropolit,a1.ro,0,0,1,1,0.0,0.0
personalitate,a1.ro,2,0,0,2,1.0,1.0
strămoș,a1.ro,0,0,1,1,0.0,0.0
Krasnodar,recorder.ro,0,0,1,1,0.0,0.0
nimănui,recorder.ro,0,1,0,1,-1.0,1.0
Regatul Unit,recorder.ro,0,0,1,1,0.0,0.0
succesor,recorder.ro,0,2,1,3,-0.6666666666666666,0.6666666666666666
URSS,recorder.ro,0,1,0,1,-1.0,1.0
occidental,recorder.ro,0,1,0,1,-1.0,1.0
Daniel Zamfir,www.digi24.ro,0,0,1,1,0.0,0.0
Nicolae Vlahu,www.digi24.ro,0,0,1,1,0.0,0.0
cumpărător,www.digi24.ro,0,0,1,1,0.0,0.0
dezvoltator,www.digi24.ro,0,0,3,3,0.0,0.0
Ion Mircescu,www.digi24.ro,0,0,1,1,0.0,0.0
Netanyahu,www.aktual24.ro,0,1,1,2,-0.5,0.5
militanți,www.aktual24.ro,0,1,0,1,-1.0,1.0
Dâncu,www.comisarul.ro,0,0,1,1,0.0,0.0
El,www.comisarul.ro,0,1,0,1,-1.0,1.0
Eu,www.comisarul.ro,0,1,0,1,-1.0,1.0
Multi,www.comisarul.ro,0,1,0,1,-1.0,1.0
Terheș,www.comisarul.ro,0,0,1,1,0.0,0.0
dansator,www.comisarul.ro,0,0,1,1,0.0,0.0
Turcan,agerpres.ro,0,1,0,1,-1.0,1.0
Garcea,www.digi24.ro,0,0,1,1,0.0,0.0
Mihail Neamțu,www.digi24.ro,0,1,0,1,-1.0,1.0
Marcel Colacu,adevarul.ro,0,0,1,1,0.0,0.0
Constantin Buchet,www.gandul.ro,0,0,1,1,0.0,0.0
Crin,www.gandul.ro,0,0,1,1,0.0,0.0
UPDATE,www.gandul.ro,0,0,1,1,0.0,0.0
Valentina Sarosi,www.gandul.ro,0,0,1,1,0.0,0.0
ai,www.gandul.ro,0,1,0,1,-1.0,1.0
Bogdan Mihai,snoop.ro,0,0,1,1,0.0,0.0
călăraș,snoop.ro,0,0,1,1,0.0,0.0
Dan Cosma,snoop.ro,0,0,1,1,0.0,0.0
Donbas,snoop.ro,0,0,1,1,0.0,0.0
Florin Coșarcă,snoop.ro,0,0,1,1,0.0,0.0
Iagăr,snoop.ro,0,0,1,1,0.0,0.0
Ioan Dumitru,snoop.ro,0,0,1,1,0.0,0.0
Ionuț Ursei,snoop.ro,0,0,1,1,0.0,0.0
Iulică Munteanu,snoop.ro,0,0,1,1,0.0,0.0
Kovacs,snoop.ro,0,0,1,1,0.0,0.0
Marinela Iacob,snoop.ro,0,0,1,1,0.0,0.0
Mehedinți,snoop.ro,0,1,2,3,-0.3333333333333333,0.3333333333333333
Mihai,snoop.ro,0,1,1,2,-0.5,0.5
Monica Iagăr,snoop.ro,0,0,1,1,0.0,0.0
Valer Kovacs,snoop.ro,0,0,1,1,0.0,0.0
Vasile Zărnescu,snoop.ro,0,1,0,1,-1.0,1.0
bunică,snoop.ro,0,0,1,1,0.0,0.0
campioană,snoop.ro,0,0,1,1,0.0,0.0
e,snoop.ro,0,0,1,1,0.0,0.0
fost,snoop.ro,0,1,1,2,-0.5,0.5
Mariana Gabriela Stuparu,snoop.ro,0,0,1,1,0.0,0.0
magistrat,snoop.ro,0,0,1,1,0.0,0.0
medaliat,snoop.ro,0,0,1,1,0.0,0.0
Sfântul Gheorghe,snoop.ro,0,0,1,1,0.0,0.0
Victor Boștinaru,www.mediafax.ro,0,1,0,1,-1.0,1.0
Elena Udrea,www.aktual24.ro,0,1,0,1,-1.0,1.0
Funeriu,www.aktual24.ro,0,0,2,2,0.0,0.0
Nicolae Vacaroiu,www.aktual24.ro,0,0,1,1,0.0,0.0
Snagov,www.aktual24.ro,0,0,1,1,0.0,0.0
Mitrea,adevarul.ro,0,1,0,1,-1.0,1.0
Adrian Buduroi,www.b1tv.ro,0,0,1,1,0.0,0.0
Alexandru Dimitriu,www.b1tv.ro,0,0,2,2,0.0,0.0
Alexandru Roșu,www.b1tv.ro,0,0,1,1,0.0,0.0
Alin Stoica,www.b1tv.ro,0,0,1,1,0.0,0.0
Anamaria Reniuț,www.b1tv.ro,0,0,1,1,0.0,0.0
Andrei Nicolaescu,www.b1tv.ro,0,0,1,1,0.0,0.0
Andrei Stan,www.b1tv.ro,0,0,1,1,0.0,0.0
Bogdan Chivu,www.b1tv.ro,0,0,1,1,0.0,0.0
Claudiu Năsui,www.b1tv.ro,0,0,2,2,0.0,0.0
Clotilde Armand,www.b1tv.ro,1,0,1,2,0.5,0.5
Cristian Laslo,www.b1tv.ro,0,0,1,1,0.0,0.0
delegat,www.b1tv.ro,0,2,0,2,-1.0,1.0
Dragoș Radu,www.b1tv.ro,0,0,1,1,0.0,0.0
Gabriela Dinu,www.b1tv.ro,0,0,1,1,0.0,0.0
Iustin Roșca,www.b1tv.ro,0,0,1,1,0.0,0.0
Lucian,www.b1tv.ro,0,0,1,1,0.0,0.0
Lucian Gavril,www.b1tv.ro,0,0,1,1,0.0,0.0
Naomi,www.b1tv.ro,0,0,1,1,0.0,0.0
Simona Spătaru,www.b1tv.ro,0,0,1,1,0.0,0.0
Ștefania Danciu,www.b1tv.ro,0,0,1,1,0.0,0.0
Ancăi Alexandrescu,www.news.ro,0,1,0,1,-1.0,1.0
Georgiei Meloni,www.news.ro,0,1,0,1,-1.0,1.0
Alin Coleșa,www.digi24.ro,0,1,0,1,-1.0,1.0
turist,www.digi24.ro,0,1,0,1,-1.0,1.0
Kovesi,stirileprotv.ro,0,1,1,2,-0.5,0.5
Nicolae Dan,adevarul.ro,0,0,1,1,0.0,0.0
Secretar General,adevarul.ro,0,0,1,1,0.0,0.0
Albrecht von Lucke,www.antena3.ro,0,0,1,1,0.0,0.0
Angela Merkel,www.antena3.ro,0,0,1,1,0.0,0.0
Friedrich Merz,www.antena3.ro,0,0,2,2,0.0,0.0
cancelar,www.antena3.ro,0,1,2,3,-0.3333333333333333,0.3333333333333333
Andrew,adevarul.ro,0,0,1,1,0.0,0.0
Andrew Tate,adevarul.ro,0,0,1,1,0.0,0.0
Emiratele Arabe Unite,adevarul.ro,0,0,2,2,0.0,0.0
Frații,adevarul.ro,0,1,0,1,-1.0,1.0
Frații Tate,adevarul.ro,0,0,1,1,0.0,0.0
Palm Beach,adevarul.ro,0,0,1,1,0.0,0.0
Tate,adevarul.ro,0,0,1,1,0.0,0.0
Tristan Tate,adevarul.ro,0,0,1,1,0.0,0.0
frați,adevarul.ro,0,0,1,1,0.0,0.0
Luana Păvălucă,www.digi24.ro,0,0,1,1,0.0,0.0
Mădălina Dobrovolschi,www.digi24.ro,0,0,1,1,0.0,0.0
Theodor Paleologu,www.digi24.ro,0,0,2,2,0.0,0.0
prezidențiabil,www.digi24.ro,0,0,1,1,0.0,0.0
Doinei Mînzatu,snoop.ro,0,0,1,1,0.0,0.0
Dăncilă,snoop.ro,0,1,1,2,-0.5,0.5
Familia Mînzatu,snoop.ro,0,1,0,1,-1.0,1.0
George Scripcaru,snoop.ro,0,0,1,1,0.0,0.0
Mânzatu,snoop.ro,0,1,0,1,-1.0,1.0
Roxana Manzatu,snoop.ro,0,0,1,1,0.0,0.0
Soții Mînzatu,snoop.ro,0,1,0,1,-1.0,1.0
Ursula von der Leyen,snoop.ro,0,0,1,1,0.0,0.0
nominalizat,snoop.ro,0,0,1,1,0.0,0.0
nominalizator,snoop.ro,0,0,1,1,0.0,0.0
soacră,snoop.ro,0,1,0,1,-1.0,1.0
soția Mînzatu,snoop.ro,0,1,0,1,-1.0,1.0
titular,snoop.ro,0,0,1,1,0.0,0.0
Primar General,www.realitatea.net,0,1,0,1,-1.0,1.0
Roșia Montantă,www.realitatea.net,0,1,0,1,-1.0,1.0
URSS,www.realitatea.net,0,0,1,1,0.0,0.0
magnat,www.realitatea.net,0,1,0,1,-1.0,1.0
Călin Geogescu,www.antena3.ro,0,1,0,1,-1.0,1.0
Dragi,www.antena3.ro,1,0,0,1,1.0,1.0
Dragii,www.antena3.ro,1,0,0,1,1.0,1.0
etnic,www.antena3.ro,1,0,0,1,1.0,1.0
mamă,www.antena3.ro,1,0,0,1,1.0,1.0
semințe,www.antena3.ro,1,0,0,1,1.0,1.0
soră,www.antena3.ro,0,0,1,1,0.0,0.0
Cupșa,pressone.ro,0,0,1,1,0.0,0.0
Ioan Cupșa,pressone.ro,0,0,1,1,0.0,0.0
Iuliana Scântei,pressone.ro,0,0,2,2,0.0,0.0
Marian Neacșu,pressone.ro,0,0,1,1,0.0,0.0
Marton Arpad,pressone.ro,0,1,0,1,-1.0,1.0
Márton Árpád,pressone.ro,0,0,4,4,0.0,0.0
Tudorel Toader,pressone.ro,0,0,3,3,0.0,0.0
Veneția,pressone.ro,0,0,1,1,0.0,0.0
afin,pressone.ro,0,0,1,1,0.0,0.0
Făurești,adevarul.ro,0,0,1,1,0.0,0.0
Bistrița,adevarul.ro,0,0,3,3,0.0,0.0
Oltean,adevarul.ro,0,0,1,1,0.0,0.0
boxer,adevarul.ro,0,0,1,1,0.0,0.0
cerșetoare,adevarul.ro,0,1,0,1,-1.0,1.0
duduie,adevarul.ro,0,0,1,1,0.0,0.0
șofer,adevarul.ro,0,0,1,1,0.0,0.0
Guineea,adevarul.ro,0,0,1,1,0.0,0.0
SA,adevarul.ro,0,0,1,1,0.0,0.0
afacere,adevarul.ro,0,1,0,1,-1.0,1.0
Aleksandr Lukașenko,adevarul.ro,0,1,0,1,-1.0,1.0
Buzdugan,adevarul.ro,0,1,0,1,-1.0,1.0
Caramitru,adevarul.ro,0,1,0,1,-1.0,1.0
Lukașenko,adevarul.ro,0,1,0,1,-1.0,1.0
Păun,adevarul.ro,0,1,0,1,-1.0,1.0
Viktor Khmarin,adevarul.ro,0,0,1,1,0.0,0.0
Vitalie Buzdugan,adevarul.ro,0,1,0,1,-1.0,1.0
intermediar,adevarul.ro,0,0,1,1,0.0,0.0
Băcia,observatornews.ro,0,0,1,1,0.0,0.0
Constanța,www.b1tv.ro,1,0,0,1,1.0,1.0
Iași,www.b1tv.ro,1,0,0,1,1.0,1.0
Ilfov,www.b1tv.ro,1,0,0,1,1.0,1.0
Romașcanu,agerpres.ro,0,0,1,1,0.0,0.0
Alex Bodi,observatornews.ro,0,1,0,1,-1.0,1.0
Craiova,observatornews.ro,0,0,2,2,0.0,0.0
Daniel David,observatornews.ro,0,0,2,2,0.0,0.0
Florin Barbu,observatornews.ro,0,0,1,1,0.0,0.0
bugetar,observatornews.ro,0,1,0,1,-1.0,1.0
jucător,observatornews.ro,0,0,1,1,0.0,0.0
primăriță,observatornews.ro,0,1,0,1,-1.0,1.0
Dan Trifu,www.comisarul.ro,0,0,2,2,0.0,0.0
Anca Boagiu,www.digi24.ro,0,0,1,1,0.0,0.0
Andreea Paul,www.digi24.ro,0,0,1,1,0.0,0.0
Beijing,www.digi24.ro,0,0,1,1,0.0,0.0
Mihai Macovei,www.digi24.ro,0,0,1,1,0.0,0.0
Shanghai,www.digi24.ro,0,0,1,1,0.0,0.0
Anca Gheorghiu,www.luju.ro,0,0,1,1,0.0,0.0
Gheorghiu,www.luju.ro,0,0,1,1,0.0,0.0
Majestatea Sa,www.luju.ro,0,1,0,1,-1.0,1.0
Răzvan Eva,www.luju.ro,0,0,1,1,0.0,0.0
Diaconescu,observatornews.ro,0,0,1,1,0.0,0.0
acolit,observatornews.ro,0,1,0,1,-1.0,1.0
Dorin Recean,www.gandul.ro,0,0,1,1,0.0,0.0
creatoare,www.romaniatv.net,0,1,0,1,-1.0,1.0
Geogesc,www.news.ro,0,0,1,1,0.0,0.0
cavaler,www.luju.ro,0,0,1,1,0.0,0.0
condoleant,www.luju.ro,1,0,0,1,1.0,1.0
Laurei Moagher,www.luju.ro,0,0,1,1,0.0,0.0
Maya,www.luju.ro,1,0,0,1,1.0,1.0
Maya Teodoroiu,www.luju.ro,1,0,0,1,1.0,1.0
Ploiești,www.luju.ro,0,0,1,1,0.0,0.0
Prahova,www.luju.ro,0,0,1,1,0.0,0.0
Simona Teodoroiu,www.luju.ro,0,0,1,1,0.0,0.0
Virgiliu Nanu,www.luju.ro,0,0,1,1,0.0,0.0
asistent universitar,www.luju.ro,0,0,1,1,0.0,0.0
Laura Moagher,www.luju.ro,0,0,2,2,0.0,0.0
Brandusa Novac,a1.ro,0,1,0,1,-1.0,1.0
Cezar Preda,a1.ro,0,1,1,2,-0.5,0.5
Sandro Gozi,adevarul.ro,0,0,1,1,0.0,0.0
Tandemul Ciucă-Bode,snoop.ro,0,1,0,1,-1.0,1.0
ales,snoop.ro,0,0,2,2,0.0,0.0
guvern,snoop.ro,0,2,0,2,-1.0,1.0
nimeni,stirileprotv.ro,0,1,0,1,-1.0,1.0
Pitești,stirileprotv.ro,0,0,1,1,0.0,0.0
Zalău,www.realitatea.net,0,0,1,1,0.0,0.0
Akos Birtalan,a1.ro,0,0,1,1,0.0,0.0
Cherecheș,www.comisarul.ro,0,1,0,1,-1.0,1.0
Cătălin Cherecheș,www.comisarul.ro,0,1,0,1,-1.0,1.0
Sile Pușcaș,www.comisarul.ro,0,1,0,1,-1.0,1.0
Diana Tușa,snoop.ro,0,1,0,1,-1.0,1.0
Iosif Buble,snoop.ro,0,1,0,1,-1.0,1.0
Liviu Iolu,snoop.ro,0,0,1,1,0.0,0.0
Mocanu Antonel,snoop.ro,0,0,1,1,0.0,0.0
Otto Vasile,snoop.ro,0,0,1,1,0.0,0.0
Sanda Nicola,snoop.ro,0,0,1,1,0.0,0.0
Adrian Negrescu,agerpres.ro,0,0,2,2,0.0,0.0
Negrescu,agerpres.ro,0,0,1,1,0.0,0.0
Recep Tayyip Erdogan,www.g4media.ro,0,0,1,1,0.0,0.0
Istanbul,www.g4media.ro,0,0,1,1,0.0,0.0
mogul,www.g4media.ro,0,1,0,1,-1.0,1.0
Nicușo Dan,www.digi24.ro,0,1,0,1,-1.0,1.0
Alexandru Gidiuta,www.aktual24.ro,0,0,1,1,0.0,0.0
Apjok Norbert,www.aktual24.ro,0,0,1,1,0.0,0.0
Daniel Florea,www.aktual24.ro,0,0,1,1,0.0,0.0
Florica Ica Calota,www.aktual24.ro,0,0,1,1,0.0,0.0
Gheba Daniel Sorin,www.aktual24.ro,0,0,1,1,0.0,0.0
Gheorghe Pecingina,www.aktual24.ro,0,0,1,1,0.0,0.0
Lazar Marian,www.aktual24.ro,0,0,1,1,0.0,0.0
Liviu Ioan Balint,www.aktual24.ro,0,0,1,1,0.0,0.0
Marian Lazar,www.aktual24.ro,0,0,1,1,0.0,0.0
Paul Cristian Ichim,www.aktual24.ro,0,0,1,1,0.0,0.0
Pruna,www.aktual24.ro,0,0,1,1,0.0,0.0
Radu Ciornei,www.aktual24.ro,0,0,2,2,0.0,0.0
Toda Daniel Liviu,www.aktual24.ro,0,0,1,1,0.0,0.0
Marcel Colacu,www.digi24.ro,0,0,1,1,0.0,0.0
Gheorghe Simion,adevarul.ro,0,0,2,2,0.0,0.0
Mihail Kogălniceanu,adevarul.ro,0,0,1,1,0.0,0.0
mulțime,www.g4media.ro,1,0,0,1,1.0,1.0
Ciprian,www.activenews.ro,0,0,1,1,0.0,0.0
Emilia Milutinovici,www.activenews.ro,0,0,1,1,0.0,0.0
Eugen Milutinovici,www.activenews.ro,0,0,1,1,0.0,0.0
Milutinovici,www.activenews.ro,0,0,1,1,0.0,0.0
om de afaceri,www.activenews.ro,0,0,3,3,0.0,0.0
Timișoara,www.activenews.ro,0,0,1,1,0.0,0.0
Turcia,www.activenews.ro,0,0,1,1,0.0,0.0
directoare,www.activenews.ro,0,0,1,1,0.0,0.0
Cristian Preda,www.b1tv.ro,0,1,0,1,-1.0,1.0
Funeriu,www.b1tv.ro,0,1,0,1,-1.0,1.0
Paleologu,www.b1tv.ro,0,2,0,2,-1.0,1.0
Preda,www.b1tv.ro,0,1,0,1,-1.0,1.0
ambii,www.b1tv.ro,0,1,0,1,-1.0,1.0
intelectual,www.b1tv.ro,0,4,0,4,-1.0,1.0
prim-vice,www.b1tv.ro,0,1,0,1,-1.0,1.0
Cristian Dițoiu,adevarul.ro,0,0,1,1,0.0,0.0
Cristian Roșu,adevarul.ro,0,0,1,1,0.0,0.0
David Constantin,adevarul.ro,0,0,1,1,0.0,0.0
Marin Burcea,adevarul.ro,0,0,1,1,0.0,0.0
conferențiar universitar,adevarul.ro,0,0,1,1,0.0,0.0
Cristine Andreson,www.digi24.ro,0,0,1,1,0.0,0.0
Luis Lazarus,www.digi24.ro,0,1,0,1,-1.0,1.0
Maximilian Krah,www.digi24.ro,0,0,1,1,0.0,0.0
Decimus Iunius Iuvenalis,pressone.ro,0,1,0,1,-1.0,1.0
Romă,pressone.ro,0,1,0,1,-1.0,1.0
funcționar public,pressone.ro,0,2,2,4,-0.5,0.5
gladiator,pressone.ro,0,1,0,1,-1.0,1.0
occident,www.euronews.ro,0,1,0,1,-1.0,1.0
Bixad,pressone.ro,0,0,1,1,0.0,0.0
Dragoș Benea,pressone.ro,0,0,1,1,0.0,0.0
Gheorghe Cârciu,pressone.ro,0,0,2,2,0.0,0.0
Liei Olguța Vasilescu,pressone.ro,0,0,1,1,0.0,0.0
Ligia Gheorghe,pressone.ro,0,1,0,1,-1.0,1.0
Lucian Muntean Grapini,pressone.ro,0,0,1,1,0.0,0.0
Negrescu,pressone.ro,0,0,1,1,0.0,0.0
Estonia,pressone.ro,0,0,1,1,0.0,0.0
Republica Lituania,pressone.ro,0,0,1,1,0.0,0.0
Ștefan Godei,pressone.ro,0,1,0,1,-1.0,1.0
Valeca,www.mediafax.ro,0,0,1,1,0.0,0.0
Alexandra,www.digi24.ro,0,0,1,1,0.0,0.0
Alexandra Măceșanu,www.digi24.ro,0,0,1,1,0.0,0.0
Caracal,www.digi24.ro,0,1,0,1,-1.0,1.0
Ecaterina Andronescu,www.digi24.ro,0,1,0,1,-1.0,1.0
Liviu Cojan,www.digi24.ro,0,0,3,3,0.0,0.0
Sorina Pintea,www.digi24.ro,0,0,1,1,0.0,0.0
Victor Costache,www.digi24.ro,0,1,1,2,-0.5,0.5
fete,www.digi24.ro,0,1,0,1,-1.0,1.0
Radu Câmpeanu,www.euronews.ro,0,0,1,1,0.0,0.0
Radu Cristescu,www.cotidianul.ro,0,0,1,1,0.0,0.0
Simona Gheorghe,www.romaniatv.net,2,0,0,2,1.0,1.0
Maria Stavrositu,a1.ro,0,1,0,1,-1.0,1.0
Clement Sava,www.b1tv.ro,0,0,2,2,0.0,0.0
Dansa,www.b1tv.ro,1,0,0,1,1.0,1.0
băiat,www.b1tv.ro,0,1,0,1,-1.0,1.0
Raisa Enache,www.b1tv.ro,0,1,0,1,-1.0,1.0
fetit,www.b1tv.ro,0,1,0,1,-1.0,1.0
fetiță,www.b1tv.ro,0,1,1,2,-0.5,0.5
infractor,www.b1tv.ro,0,1,0,1,-1.0,1.0
intermediar,www.b1tv.ro,0,0,1,1,0.0,0.0
șef de stat,www.news.ro,0,0,3,3,0.0,0.0
Lucian Feodorov,www.romaniatv.net,0,0,2,2,0.0,0.0
Feodorov,www.romaniatv.net,0,0,1,1,0.0,0.0
colegiu,www.romaniatv.net,1,0,0,1,1.0,1.0
drept,www.romaniatv.net,1,0,0,1,1.0,1.0
dumnealui,www.romaniatv.net,0,1,0,1,-1.0,1.0
Alex Florența,adevarul.ro,0,0,1,1,0.0,0.0
Corina Corbu,adevarul.ro,0,0,1,1,0.0,0.0
Elena Costache,adevarul.ro,0,0,2,2,0.0,0.0
Marian Neacșu,adevarul.ro,0,0,3,3,0.0,0.0
Cseke Attila,www.news.ro,0,1,0,1,-1.0,1.0
Albert Speer,www.comisarul.ro,0,0,1,1,0.0,0.0
Osówka,www.comisarul.ro,0,0,1,1,0.0,0.0
Praga,www.comisarul.ro,0,0,1,1,0.0,0.0
Al Treilea Reich,www.comisarul.ro,0,1,0,1,-1.0,1.0
Zdzisław Łazanowski,www.comisarul.ro,0,0,1,1,0.0,0.0
arhitect,www.comisarul.ro,0,0,2,2,0.0,0.0
deținut,www.comisarul.ro,0,0,1,1,0.0,0.0
ghid,www.comisarul.ro,0,0,1,1,0.0,0.0
prizonier,www.comisarul.ro,0,1,0,1,-1.0,1.0
visător,www.comisarul.ro,0,1,0,1,-1.0,1.0
vizitator,www.comisarul.ro,0,0,1,1,0.0,0.0
Łazanowski,www.comisarul.ro,0,0,1,1,0.0,0.0
Paris,www.cotidianul.ro,0,0,2,2,0.0,0.0
Pavel Durov,www.cotidianul.ro,0,0,1,1,0.0,0.0
miliardar,www.cotidianul.ro,0,0,1,1,0.0,0.0
Mureș,www.cotidianul.ro,0,0,2,2,0.0,0.0
Satu Mare,www.cotidianul.ro,0,2,1,3,-0.6666666666666666,0.6666666666666666
Simonis,www.cotidianul.ro,0,0,1,1,0.0,0.0
Meloni,www.aktual24.ro,0,1,0,1,-1.0,1.0
Salvini,www.aktual24.ro,0,1,0,1,-1.0,1.0
multor,www.aktual24.ro,0,1,0,1,-1.0,1.0
Madrid,www.activenews.ro,0,0,1,1,0.0,0.0
patron,www.activenews.ro,0,0,1,1,0.0,0.0
Roxana Ilie,www.activenews.ro,0,0,1,1,0.0,0.0
Sinaia,www.activenews.ro,0,0,1,1,0.0,0.0
Spania,www.activenews.ro,0,0,2,2,0.0,0.0
Vlad Oprea,www.activenews.ro,0,0,1,1,0.0,0.0
Vladimir Ciorbă,www.activenews.ro,0,3,1,4,-0.75,0.75
acționar,www.activenews.ro,0,0,1,1,0.0,0.0
amantă,www.activenews.ro,0,1,1,2,-0.5,0.5
Anton Rog,www.activenews.ro,0,1,0,1,-1.0,1.0
Eduard Helwig,www.activenews.ro,0,0,1,1,0.0,0.0
Hellvig,www.activenews.ro,0,0,2,2,0.0,0.0
Livia Stanciu,www.activenews.ro,0,0,1,1,0.0,0.0
Orban,www.activenews.ro,0,0,2,2,0.0,0.0
masel,www.activenews.ro,0,1,0,1,-1.0,1.0
Ludovic Orban,www.activenews.ro,0,1,1,2,-0.5,0.5
titular,www.activenews.ro,0,0,1,1,0.0,0.0
Alexandr Dughin,www.aktual24.ro,0,1,0,1,-1.0,1.0
strateg,www.activenews.ro,0,1,2,3,-0.3333333333333333,0.3333333333333333
Terheș,www.activenews.ro,0,2,1,3,-0.6666666666666666,0.6666666666666666
Tolontan,www.activenews.ro,0,0,1,1,0.0,0.0
Cristian Terheș,www.activenews.ro,0,1,1,2,-0.5,0.5
Maia Sandu,www.news.ro,0,0,1,1,0.0,0.0
prieten,www.news.ro,0,0,2,2,0.0,0.0
veteran,www.news.ro,2,0,0,2,1.0,1.0
Albania,www.comisarul.ro,0,0,1,1,0.0,0.0
Alexandru Ciobotea,www.comisarul.ro,0,0,1,1,0.0,0.0
Algeria,www.comisarul.ro,0,0,1,1,0.0,0.0
Andrei Vila,www.comisarul.ro,0,0,1,1,0.0,0.0
Azerbaijan,www.comisarul.ro,0,0,1,1,0.0,0.0
Bosnia și Herzegovina,www.comisarul.ro,0,0,1,1,0.0,0.0
David Ghibu,www.comisarul.ro,0,0,1,1,0.0,0.0
Emanuel,www.comisarul.ro,1,0,0,1,1.0,1.0
Emanuel Mazăre,www.comisarul.ro,2,0,0,2,1.0,1.0
Kazahstan,www.comisarul.ro,0,0,1,1,0.0,0.0
Kirgistan,www.comisarul.ro,0,0,1,1,0.0,0.0
Macedonia de Nord,www.comisarul.ro,0,0,1,1,0.0,0.0
Malaysia,www.comisarul.ro,0,0,1,1,0.0,0.0
Marian Haiducu,www.comisarul.ro,1,0,0,1,1.0,1.0
Muntenegru,www.comisarul.ro,0,0,1,1,0.0,0.0
Pavel Ciurea,www.comisarul.ro,0,0,1,1,0.0,0.0
Pitești,www.comisarul.ro,1,0,0,1,1.0,1.0
Radu Stoleriu,www.comisarul.ro,0,0,1,1,0.0,0.0
Sarajevo,www.comisarul.ro,0,0,1,1,0.0,0.0
Serbia,www.comisarul.ro,0,0,1,1,0.0,0.0
Turkmenistan,www.comisarul.ro,0,0,1,1,0.0,0.0
Uzbekistan,www.comisarul.ro,0,0,1,1,0.0,0.0
junior,www.comisarul.ro,1,0,0,1,1.0,1.0
olimpic,www.comisarul.ro,1,0,0,1,1.0,1.0
Franta,a1.ro,0,0,2,2,0.0,0.0
Ankara,www.euronews.ro,0,0,1,1,0.0,0.0
Marea Marmara,www.euronews.ro,0,0,1,1,0.0,0.0
Sankt Petersburg,www.euronews.ro,0,0,1,1,0.0,0.0
Scott Bessent,www.euronews.ro,0,0,1,1,0.0,0.0
Steve Witkoff,www.euronews.ro,0,0,1,1,0.0,0.0
magistrat,www.euronews.ro,0,1,3,4,-0.25,0.25
om de afaceri,www.euronews.ro,0,0,2,2,0.0,0.0
cadru militar,www.cotidianul.ro,0,0,1,1,0.0,0.0
revoluționar,www.cotidianul.ro,0,0,1,1,0.0,0.0
taximetrist,www.cotidianul.ro,0,0,1,1,0.0,0.0
Sorin Grindeanu,www.luju.ro,0,0,1,1,0.0,0.0
Lia Vasilescu,www.luju.ro,0,0,1,1,0.0,0.0
internaut,www.antena3.ro,0,1,0,1,-1.0,1.0
internat,www.antena3.ro,0,1,0,1,-1.0,1.0
Alvin Toffler,recorder.ro,0,0,1,1,0.0,0.0
Braniște,recorder.ro,0,0,1,1,0.0,0.0
Carmen Holban,recorder.ro,0,0,1,1,0.0,0.0
Claudia Gilia,recorder.ro,0,0,2,2,0.0,0.0
Coreea de Nord,recorder.ro,0,0,1,1,0.0,0.0
Cuba,recorder.ro,0,0,1,1,0.0,0.0
Doicești,recorder.ro,0,0,1,1,0.0,0.0
Fieni,recorder.ro,0,0,1,1,0.0,0.0
Gabriel Plăiașu,recorder.ro,0,0,1,1,0.0,0.0
Ionuț Vulpescu,recorder.ro,0,0,1,1,0.0,0.0
Liviu Balint,recorder.ro,0,0,1,1,0.0,0.0
Maria Tănase,recorder.ro,0,0,1,1,0.0,0.0
Marian Țachianu,recorder.ro,0,0,1,1,0.0,0.0
Michelangelo,recorder.ro,0,0,1,1,0.0,0.0
Michelle Obama,recorder.ro,0,0,1,1,0.0,0.0
Moroeni,recorder.ro,1,0,0,1,1.0,1.0
Oana Silvia Vlăducă,recorder.ro,0,0,1,1,0.0,0.0
Pucioasa,recorder.ro,0,0,3,3,0.0,0.0
Radu Mihai Popa,recorder.ro,0,0,1,1,0.0,0.0
Regina Maria,recorder.ro,1,0,0,1,1.0,1.0
Stejărel Olaru,recorder.ro,0,0,1,1,0.0,0.0
Titu,recorder.ro,0,0,1,1,0.0,0.0
Titus Corlățean,recorder.ro,0,0,2,2,0.0,0.0
Tocqueville,recorder.ro,0,0,1,1,0.0,0.0
Toffler,recorder.ro,0,0,1,1,0.0,0.0
Târgu,recorder.ro,0,0,1,1,0.0,0.0
Virgil Guran,recorder.ro,0,0,1,1,0.0,0.0
conferențiar universitar,recorder.ro,0,0,1,1,0.0,0.0
Dinu Zamfirescu,recorder.ro,1,0,0,1,1.0,1.0
învățătoare,recorder.ro,0,0,1,1,0.0,0.0
Țachianu,recorder.ro,0,0,1,1,0.0,0.0
participant,www.aktual24.ro,0,0,2,2,0.0,0.0
Dan Cojocaru,www.luju.ro,0,0,1,1,0.0,0.0
lucrător,www.luju.ro,0,1,0,1,-1.0,1.0
Maldea,www.luju.ro,0,0,1,1,0.0,0.0
Mudure Ioan,www.luju.ro,0,0,1,1,0.0,0.0
Torma Adrian,www.luju.ro,0,1,0,1,-1.0,1.0
Torma,www.luju.ro,0,0,1,1,0.0,0.0
Constantin Torma,www.luju.ro,0,0,1,1,0.0,0.0
Dana Visoiu,www.luju.ro,0,0,1,1,0.0,0.0
Robert Birsescu,www.luju.ro,0,0,1,1,0.0,0.0
Anca Alexandrescu,observatornews.ro,1,0,1,2,0.5,0.5
Hunor,observatornews.ro,0,0,1,1,0.0,0.0
artizan,www.news.ro,0,0,1,1,0.0,0.0
Bogdan Tiberiu Iacob,www.comisarul.ro,0,0,1,1,0.0,0.0
Winston Churchill,www.comisarul.ro,1,1,0,2,0.0,0.0
Iliescu,www.comisarul.ro,0,0,2,2,0.0,0.0
Nagasaki,www.comisarul.ro,0,0,1,1,0.0,0.0
Năstase,www.comisarul.ro,0,0,2,2,0.0,0.0
Titok,www.comisarul.ro,0,1,0,1,-1.0,1.0
cei,www.comisarul.ro,0,1,0,1,-1.0,1.0
omenire,www.comisarul.ro,0,1,0,1,-1.0,1.0
outsider,www.comisarul.ro,0,1,0,1,-1.0,1.0
secuime,www.comisarul.ro,0,1,0,1,-1.0,1.0
altul,www.aktual24.ro,0,1,0,1,-1.0,1.0
Albania,primanews.ro,0,0,1,1,0.0,0.0
Armenia,primanews.ro,0,0,1,1,0.0,0.0
Australia,primanews.ro,0,0,1,1,0.0,0.0
Azerbaidjan,primanews.ro,0,0,1,1,0.0,0.0
Basel,primanews.ro,0,0,1,1,0.0,0.0
Cehia,primanews.ro,0,0,1,1,0.0,0.0
Cipru,primanews.ro,0,0,3,3,0.0,0.0
Croația,primanews.ro,0,0,1,1,0.0,0.0
Danemarca,primanews.ro,0,0,2,2,0.0,0.0
Elveția,primanews.ro,0,0,1,1,0.0,0.0
Estonia,primanews.ro,0,0,2,2,0.0,0.0
Finlanda,primanews.ro,0,0,1,1,0.0,0.0
Georgia,primanews.ro,0,0,1,1,0.0,0.0
Irlanda,primanews.ro,0,0,1,1,0.0,0.0
Islanda,primanews.ro,0,0,1,1,0.0,0.0
Letonia,primanews.ro,0,0,1,1,0.0,0.0
Lituania,primanews.ro,0,0,1,1,0.0,0.0
Luca Hanni,primanews.ro,0,0,1,1,0.0,0.0
Luminița Anghel,primanews.ro,1,0,0,1,1.0,1.0
Luxemburg,primanews.ro,0,0,1,1,0.0,0.0
Malmö,primanews.ro,0,0,1,1,0.0,0.0
Malta,primanews.ro,0,0,1,1,0.0,0.0
Muntenegru,primanews.ro,0,0,1,1,0.0,0.0
Norvegia,primanews.ro,0,0,1,1,0.0,0.0
Olanda,primanews.ro,0,0,1,1,0.0,0.0
Portugalia,primanews.ro,0,0,4,4,0.0,0.0
San Marino,primanews.ro,0,0,1,1,0.0,0.0
Serbia,primanews.ro,0,0,1,1,0.0,0.0
Slovenia,primanews.ro,0,0,1,1,0.0,0.0
St. Jakobshalle,primanews.ro,0,0,1,1,0.0,0.0
Suedia,primanews.ro,0,0,1,1,0.0,0.0
artist,primanews.ro,0,0,1,1,0.0,0.0
concurent,primanews.ro,0,0,1,1,0.0,0.0
telespectator,primanews.ro,0,0,1,1,0.0,0.0
vedetel,primanews.ro,0,0,1,1,0.0,0.0
colectiv,stirileprotv.ro,0,1,0,1,-1.0,1.0
Vlad Gheorghe,stirileprotv.ro,0,0,1,1,0.0,0.0
Mircea Dinescu,stirileprotv.ro,0,0,1,1,0.0,0.0
Aleksandr Vucic,stirileprotv.ro,0,0,1,1,0.0,0.0
Dan Constantin Tudurache,a1.ro,0,0,1,1,0.0,0.0
Tudurache,a1.ro,0,0,1,1,0.0,0.0
Laszlo Boberly,a1.ro,0,0,1,1,0.0,0.0
domnul Igas,a1.ro,1,0,0,1,1.0,1.0
Gigi Becali,primanews.ro,0,0,4,4,0.0,0.0
Angustin Zegrean,www.news.ro,0,1,0,1,-1.0,1.0
Zegrean,www.news.ro,0,0,1,1,0.0,0.0
CTP,www.b1tv.ro,0,1,1,2,-0.5,0.5
adept,www.b1tv.ro,0,1,0,1,-1.0,1.0
Oana Tilică,agerpres.ro,0,0,1,1,0.0,0.0
Adina Vălean,www.gandul.ro,0,0,3,3,0.0,0.0
Anghel Stanciu,www.gandul.ro,0,0,1,1,0.0,0.0
Cezar Preda,www.gandul.ro,0,0,1,1,0.0,0.0
Constantin Tămagă,www.gandul.ro,0,0,1,1,0.0,0.0
Daniel Buda,www.gandul.ro,0,0,2,2,0.0,0.0
Daniel Oajdea,www.gandul.ro,0,0,1,1,0.0,0.0
Cristian Adomniței,www.gandul.ro,0,0,1,1,0.0,0.0
Iulian Iancu,www.gandul.ro,0,0,1,1,0.0,0.0
William Brînză,www.gandul.ro,0,0,1,1,0.0,0.0
Doina Silistru,www.gandul.ro,0,0,1,1,0.0,0.0
Dănuț Liga,www.gandul.ro,0,0,1,1,0.0,0.0
Eugen Nicolăescu,www.gandul.ro,0,0,1,1,0.0,0.0
Gabriel Oprea,www.gandul.ro,0,1,1,2,-0.5,0.5
Gheorghe Antochi,www.gandul.ro,0,0,1,1,0.0,0.0
Ioan Botiș,www.gandul.ro,0,0,1,1,0.0,0.0
Marius Spânu,www.gandul.ro,0,0,1,1,0.0,0.0
Mihai Radan,www.gandul.ro,0,0,1,1,0.0,0.0
Monica Iacob Ridzi,www.gandul.ro,0,0,1,1,0.0,0.0
Petru Gabriel Vlase,www.gandul.ro,0,0,1,1,0.0,0.0
Răzvan Mustea,www.gandul.ro,0,0,1,1,0.0,0.0
Stelian Fuia,www.gandul.ro,0,0,1,1,0.0,0.0
Tudor Chiuariu,www.gandul.ro,0,0,1,1,0.0,0.0
Vasile Nedelcu,www.gandul.ro,0,0,1,1,0.0,0.0
Emil Bostan,www.gandul.ro,0,0,1,1,0.0,0.0
Eugen Bădălan,www.gandul.ro,0,1,1,2,-0.5,0.5
Ion Dumitru,www.gandul.ro,0,0,1,1,0.0,0.0
Theodor Paleologu,www.gandul.ro,0,0,1,1,0.0,0.0
Tinel Gheorghe,www.gandul.ro,0,0,1,1,0.0,0.0
Valeriu Steriu,www.gandul.ro,0,0,1,1,0.0,0.0
Ștefan Beres,www.gandul.ro,0,0,1,1,0.0,0.0
Mircia Giurgiu,www.gandul.ro,0,0,1,1,0.0,0.0
doctorand,www.gandul.ro,0,0,2,2,0.0,0.0
Cătălin Voicu,www.gandul.ro,0,0,1,1,0.0,0.0
Marius Bota,www.gandul.ro,0,0,1,1,0.0,0.0
Nicolae Dobra,www.gandul.ro,0,0,1,1,0.0,0.0
Puiu Hașotti,www.gandul.ro,0,0,1,1,0.0,0.0
Verestoy Attila,www.gandul.ro,0,0,1,1,0.0,0.0
Borșa,www.g4media.ro,0,1,0,1,-1.0,1.0
Roman Dinu,www.g4media.ro,0,0,1,1,0.0,0.0
Irineu Darău,primanews.ro,0,0,2,2,0.0,0.0
brașovean,primanews.ro,1,0,0,1,1.0,1.0
Robert Negoiță,www.digi24.ro,0,0,1,1,0.0,0.0
Sorin Stanescu,www.aktual24.ro,0,0,1,1,0.0,0.0
Marcela Sandru,www.aktual24.ro,0,0,1,1,0.0,0.0
Paul Ispas,www.aktual24.ro,0,0,1,1,0.0,0.0
Carmen Iohannis,www.gandul.ro,0,0,1,1,0.0,0.0
Fumio Kishida,www.gandul.ro,0,0,1,1,0.0,0.0
Hidehisa Otsuji,www.gandul.ro,0,0,1,1,0.0,0.0
Hiroyuki Hosoda,www.gandul.ro,0,0,1,1,0.0,0.0
Masako,www.gandul.ro,0,0,1,1,0.0,0.0
Naruhito,www.gandul.ro,0,0,2,2,0.0,0.0
Prima Doamnă,www.gandul.ro,0,0,1,1,0.0,0.0
Tokyo,www.gandul.ro,0,0,1,1,0.0,0.0
interlocutor,www.gandul.ro,0,0,1,1,0.0,0.0
împărat,www.gandul.ro,0,0,1,1,0.0,0.0
împărăteasă,www.gandul.ro,0,0,1,1,0.0,0.0
Împărăteasa Masako,www.gandul.ro,0,0,1,1,0.0,0.0
George Gârbacea,www.b1tv.ro,0,0,1,1,0.0,0.0
Cristi Irimuș,www.romaniatv.net,0,0,1,1,0.0,0.0
participanți,www.romaniatv.net,0,1,0,1,-1.0,1.0
celor,www.romaniatv.net,0,1,0,1,-1.0,1.0
Chișinău,primanews.ro,0,0,1,1,0.0,0.0
Londra,primanews.ro,0,0,1,1,0.0,0.0
Viorel Hrebenciuc,primanews.ro,0,0,2,2,0.0,0.0
Barna,recorder.ro,0,2,0,2,-1.0,1.0
Cengher,recorder.ro,0,1,0,1,-1.0,1.0
Gabriel Stika,recorder.ro,0,1,0,1,-1.0,1.0
Ovidiu Cengher,recorder.ro,0,0,1,1,0.0,0.0
Sorin Lucaci,recorder.ro,0,0,1,1,0.0,0.0
Stika,recorder.ro,0,1,0,1,-1.0,1.0
Tanczos Barna,recorder.ro,0,1,1,2,-0.5,0.5
Tánczos Barna,recorder.ro,0,0,1,1,0.0,0.0
chelner,recorder.ro,0,2,0,2,-1.0,1.0
paroh,recorder.ro,0,0,1,1,0.0,0.0
acesta,www.digi24.ro,0,0,2,2,0.0,0.0
băcan,recorder.ro,0,1,1,2,-0.5,0.5
bătaie,recorder.ro,0,1,0,1,-1.0,1.0
Devei,recorder.ro,0,1,0,1,-1.0,1.0
radar,recorder.ro,0,1,0,1,-1.0,1.0
Secuiescu,recorder.ro,0,0,1,1,0.0,0.0
Sfânta Parascheva,recorder.ro,0,0,1,1,0.0,0.0
Sorin Lazăr,recorder.ro,0,1,0,1,-1.0,1.0
Terorist,recorder.ro,0,1,0,1,-1.0,1.0
incompetență,recorder.ro,0,1,0,1,-1.0,1.0
pitic,recorder.ro,0,1,0,1,-1.0,1.0
târgoviștean,recorder.ro,0,1,0,1,-1.0,1.0
Ștefan cel Mare și Sfânt,recorder.ro,0,0,1,1,0.0,0.0
Chișinău,www.mediafax.ro,0,0,1,1,0.0,0.0
Mureșan,www.mediafax.ro,0,0,1,1,0.0,0.0
eurodeputat,www.mediafax.ro,0,0,2,2,0.0,0.0
Cristian Georgescu,a1.ro,0,0,1,1,0.0,0.0
educator,a1.ro,0,0,1,1,0.0,0.0
Anghel,snoop.ro,0,1,0,1,-1.0,1.0
Bogdan Despescu,snoop.ro,0,0,1,1,0.0,0.0
China,snoop.ro,0,0,2,2,0.0,0.0
Cristi,snoop.ro,0,0,1,1,0.0,0.0
Gabriel Gorun,snoop.ro,0,0,2,2,0.0,0.0
Gino Iorgulescu,snoop.ro,0,1,0,1,-1.0,1.0
legist,snoop.ro,0,1,0,1,-1.0,1.0
Luxemburg,snoop.ro,0,0,1,1,0.0,0.0
Mario Iorgulescu,snoop.ro,0,2,0,2,-1.0,1.0
medic legist,snoop.ro,0,0,2,2,0.0,0.0
Gorun,snoop.ro,0,0,2,2,0.0,0.0
Mircea,snoop.ro,0,1,1,2,-0.5,0.5
Radu Țincu,snoop.ro,0,0,1,1,0.0,0.0
Vlad Pascu,snoop.ro,0,1,1,2,-0.5,0.5
Vlad Zaha,snoop.ro,0,0,1,1,0.0,0.0
drogat,snoop.ro,0,1,0,1,-1.0,1.0
Marius Gârlașiu,snoop.ro,0,0,1,1,0.0,0.0
traficant,snoop.ro,0,6,0,6,-1.0,1.0
Arad,www.news.ro,0,0,1,1,0.0,0.0
Bode,www.news.ro,0,0,1,1,0.0,0.0
Lucian Bode,www.news.ro,0,0,2,2,0.0,0.0
Roșia Montană,primanews.ro,0,1,0,1,-1.0,1.0
greblă,www.comisarul.ro,0,1,0,1,-1.0,1.0
Șerban,www.comisarul.ro,0,0,1,1,0.0,0.0
Aleșd,adevarul.ro,0,0,1,1,0.0,0.0
Arra,agerpres.ro,0,0,1,1,0.0,0.0
Zsuzsanna,agerpres.ro,0,0,1,1,0.0,0.0
Nicușor Dant,agerpres.ro,0,0,1,1,0.0,0.0
Ciprian Constantin Șerban,www.aktual24.ro,0,0,1,1,0.0,0.0
Dumitru Coarna,www.aktual24.ro,0,0,2,2,0.0,0.0
Serban,www.aktual24.ro,0,0,2,2,0.0,0.0
Serban Ciprian Constantin,www.aktual24.ro,0,0,1,1,0.0,0.0
Dumitru Coarma,www.aktual24.ro,0,0,1,1,0.0,0.0
Bragadiru,adevarul.ro,0,0,1,1,0.0,0.0
Ciolpani,adevarul.ro,0,0,1,1,0.0,0.0
Gogu Puiu,adevarul.ro,0,0,1,1,0.0,0.0
Tâncăbești,adevarul.ro,0,1,0,1,-1.0,1.0
duhovnic,adevarul.ro,0,0,1,1,0.0,0.0
legionar,adevarul.ro,0,2,1,3,-0.6666666666666666,0.6666666666666666
mercenar,adevarul.ro,0,2,0,2,-1.0,1.0
afacerist,www.realitatea.net,0,1,1,2,-0.5,0.5
cioban,www.realitatea.net,0,2,0,2,-1.0,1.0
Florin Camara,www.realitatea.net,0,0,1,1,0.0,0.0
Iași,www.realitatea.net,0,0,1,1,0.0,0.0
Israel,www.realitatea.net,0,1,0,1,-1.0,1.0
creditor,www.realitatea.net,0,1,0,1,-1.0,1.0
cumătrul,www.realitatea.net,0,0,1,1,0.0,0.0
familia Păcuraru,www.realitatea.net,0,1,0,1,-1.0,1.0
latifundiar,www.realitatea.net,0,1,1,2,-0.5,0.5
lichidator,www.realitatea.net,0,1,0,1,-1.0,1.0
Adrian Năstase,www.realitatea.net,0,0,1,1,0.0,0.0
pușcăriaș,www.realitatea.net,0,1,0,1,-1.0,1.0
mistrul,stirileprotv.ro,0,1,0,1,-1.0,1.0
subordonat,stirileprotv.ro,0,1,0,1,-1.0,1.0
Ankarei,adevarul.ro,0,1,0,1,-1.0,1.0
Constantin Noica,adevarul.ro,0,1,0,1,-1.0,1.0
Emil Cioran,adevarul.ro,0,0,1,1,0.0,0.0
Eugen Ionescu,adevarul.ro,0,0,1,1,0.0,0.0
Kiev,adevarul.ro,1,1,1,3,0.0,0.0
Mircea Eliade,adevarul.ro,0,0,1,1,0.0,0.0
altcineva,adevarul.ro,0,1,0,1,-1.0,1.0
creator,adevarul.ro,0,1,1,2,-0.5,0.5
gospodină,adevarul.ro,0,1,0,1,-1.0,1.0
tehnocrat,adevarul.ro,0,1,0,1,-1.0,1.0
Ștefan cel Mare,adevarul.ro,0,0,1,1,0.0,0.0
Ștefan cel Mare și Sfânt,adevarul.ro,0,0,1,1,0.0,0.0
țară,adevarul.ro,0,0,1,1,0.0,0.0
Victor Rebengiuc,www.digi24.ro,0,0,1,1,0.0,0.0
actorul Victor Rebengiuc,www.digi24.ro,0,0,1,1,0.0,0.0
Fifor,www.gandul.ro,0,1,0,1,-1.0,1.0
Mihai Fifor,www.gandul.ro,0,1,0,1,-1.0,1.0
Anamaria Gabrilă,adevarul.ro,0,0,1,1,0.0,0.0
Marie Marcu,adevarul.ro,0,0,1,1,0.0,0.0
Petru Mândru,adevarul.ro,0,1,0,1,-1.0,1.0
Klaus Schwab,www.activenews.ro,0,1,0,1,-1.0,1.0
Lui,www.activenews.ro,1,0,0,1,1.0,1.0
Nicușoros Dan,www.activenews.ro,0,0,1,1,0.0,0.0
hulitor,www.activenews.ro,0,1,0,1,-1.0,1.0
luptătorul Robert F. Kennedy ministru,www.activenews.ro,1,0,0,1,1.0,1.0
mame,www.activenews.ro,1,0,0,1,1.0,1.0
satana,www.activenews.ro,0,1,0,1,-1.0,1.0
sistem,www.activenews.ro,0,1,0,1,-1.0,1.0
Ursula,www.activenews.ro,0,1,0,1,-1.0,1.0
Robert Cazanciuc,agerpres.ro,0,0,1,1,0.0,0.0
pacient,agerpres.ro,1,0,0,1,1.0,1.0
șofer,agerpres.ro,0,0,2,2,0.0,0.0
Corina Atanasiu,www.euronews.ro,0,0,1,1,0.0,0.0
Cristina Prună,www.euronews.ro,0,0,1,1,0.0,0.0
Dan Nica,www.euronews.ro,0,0,1,1,0.0,0.0
Daniel Buda,www.euronews.ro,0,0,1,1,0.0,0.0
Diana Iovanovici,www.euronews.ro,0,0,1,1,0.0,0.0
Dragoș Benea,www.euronews.ro,0,0,1,1,0.0,0.0
Eugen Tomac,www.euronews.ro,0,0,1,1,0.0,0.0
Gheorghe,www.euronews.ro,0,0,1,1,0.0,0.0
Gheorghe Cârciu,www.euronews.ro,0,0,1,1,0.0,0.0
Gheorghe Falcă,www.euronews.ro,0,0,1,1,0.0,0.0
György Vincze,www.euronews.ro,0,0,1,1,0.0,0.0
Iuliu Winkler,www.euronews.ro,0,0,1,1,0.0,0.0
Laura Gherasim,www.euronews.ro,0,0,1,1,0.0,0.0
Lorant,www.euronews.ro,0,0,1,1,0.0,0.0
Maria Grapini,www.euronews.ro,0,0,1,1,0.0,0.0
Mircea Hava,www.euronews.ro,0,0,1,1,0.0,0.0
Vlad Voiculescu,www.euronews.ro,0,0,2,2,0.0,0.0
Ștefan Mușoiu,www.euronews.ro,0,0,1,1,0.0,0.0
Dan Capatos,a1.ro,0,0,1,1,0.0,0.0
Fata,a1.ro,1,0,0,1,1.0,1.0
Michael Jackson,a1.ro,0,0,1,1,0.0,0.0
imitatoare,a1.ro,0,1,0,1,-1.0,1.0
megastar,a1.ro,1,0,0,1,1.0,1.0
telespectator,a1.ro,1,0,0,1,1.0,1.0
Alexandru Ulici,observatornews.ro,0,0,1,1,0.0,0.0
Clotilde Armand,observatornews.ro,0,2,2,4,-0.5,0.5
Marian Burcea,observatornews.ro,0,0,1,1,0.0,0.0
Ramona Porumb,observatornews.ro,0,0,1,1,0.0,0.0
viceprimar,observatornews.ro,0,1,1,2,-0.5,0.5
dansă,observatornews.ro,0,0,1,1,0.0,0.0
Dan Dungaciu,www.g4media.ro,0,0,1,1,0.0,0.0
expert,www.g4media.ro,1,0,0,1,1.0,1.0
Regatul Unit al Marii Britanii și al Irlandei de Nord,www.euronews.ro,0,0,1,1,0.0,0.0
Adriana Pantea,pressone.ro,0,0,1,1,0.0,0.0
Crețu,pressone.ro,0,1,0,1,-1.0,1.0
Eugenia Șortan,pressone.ro,0,0,1,1,0.0,0.0
Gal,pressone.ro,0,1,0,1,-1.0,1.0
Luminița,pressone.ro,0,1,0,1,-1.0,1.0
Luminița Gheorghiu,pressone.ro,0,0,1,1,0.0,0.0
Marian Vanghelie,pressone.ro,0,1,0,1,-1.0,1.0
Oana Crețu,pressone.ro,0,1,1,2,-0.5,0.5
Oanei,pressone.ro,0,1,0,1,-1.0,1.0
Oanei Crețu,pressone.ro,0,1,0,1,-1.0,1.0
Titi Sultan,pressone.ro,0,1,0,1,-1.0,1.0
Valeri Kuzmin,pressone.ro,0,0,1,1,0.0,0.0
antreprenoare,pressone.ro,0,0,1,1,0.0,0.0
fană,pressone.ro,0,1,0,1,-1.0,1.0
asistent universitar,pressone.ro,0,1,0,1,-1.0,1.0
jurist,pressone.ro,0,3,4,7,-0.42857142857142855,0.42857142857142855
prezentator,pressone.ro,0,1,0,1,-1.0,1.0
refugiat,pressone.ro,0,1,1,2,-0.5,0.5
vraci,pressone.ro,0,1,0,1,-1.0,1.0
Nevada,adevarul.ro,0,0,1,1,0.0,0.0
Oana Pellea,www.gandul.ro,1,0,0,1,1.0,1.0
tuturor,www.gandul.ro,0,1,0,1,-1.0,1.0
Francisc Tobă,adevarul.ro,0,1,2,3,-0.3333333333333333,0.3333333333333333
Oana Leonte,adevarul.ro,0,0,1,1,0.0,0.0
Tobă,adevarul.ro,0,0,1,1,0.0,0.0
Eugen Teodorovici,www.antena3.ro,0,1,0,1,-1.0,1.0
Teodorovici,www.antena3.ro,0,0,1,1,0.0,0.0
Dumitrescu,www.gandul.ro,0,1,0,1,-1.0,1.0
Radu Ion,www.gandul.ro,0,1,0,1,-1.0,1.0
arbitru,www.gandul.ro,0,0,2,2,0.0,0.0
penal,www.gandul.ro,0,1,0,1,-1.0,1.0
Bârlad,pressone.ro,0,1,0,1,-1.0,1.0
Ion Cristoiu,pressone.ro,0,0,1,1,0.0,0.0
Livia Stanciu,pressone.ro,0,0,2,2,0.0,0.0
Modeste Schwartz,pressone.ro,0,1,0,1,-1.0,1.0
Raluca Prună,pressone.ro,0,1,1,2,-0.5,0.5
Soros,pressone.ro,0,2,0,2,-1.0,1.0
Angela Merkel,pressone.ro,0,1,0,1,-1.0,1.0
medicul Burnei,pressone.ro,0,1,0,1,-1.0,1.0
Ion Coja,pressone.ro,0,1,0,1,-1.0,1.0
succesor,pressone.ro,0,3,1,4,-0.75,0.75
Anatol Șalaru,www.mediafax.ro,0,1,0,1,-1.0,1.0
Valeriu Munteanu,www.mediafax.ro,0,1,0,1,-1.0,1.0
donator,agerpres.ro,0,1,0,1,-1.0,1.0
finanțator,agerpres.ro,0,1,0,1,-1.0,1.0
combatant,www.romaniatv.net,0,1,0,1,-1.0,1.0
voluntar,www.aktual24.ro,2,0,0,2,1.0,1.0
Aur,www.comisarul.ro,1,0,0,1,1.0,1.0
meteorolog,www.comisarul.ro,0,0,1,1,0.0,0.0
victima,www.comisarul.ro,0,1,0,1,-1.0,1.0
Katheleen Kavalec,stirileprotv.ro,0,0,1,1,0.0,0.0
Kathleen Kavalec,stirileprotv.ro,0,0,1,1,0.0,0.0
Kavalec,stirileprotv.ro,0,0,1,1,0.0,0.0
Barnier,www.aktual24.ro,0,1,0,1,-1.0,1.0
Michel Barnier,www.aktual24.ro,0,1,1,2,-0.5,0.5
Delicote,adevarul.ro,0,0,1,1,0.0,0.0
Radu,adevarul.ro,0,0,1,1,0.0,0.0
influențator,adevarul.ro,0,0,1,1,0.0,0.0
nehotărât,adevarul.ro,0,0,1,1,0.0,0.0
Marin Drăcea,www.gandul.ro,0,0,1,1,0.0,0.0
Mircea Fechet,www.gandul.ro,0,0,1,1,0.0,0.0
Dănuț Rotaru,www.realitatea.net,2,0,0,2,1.0,1.0
Gorban,www.realitatea.net,1,0,0,1,1.0,1.0
Gura Bohotin,www.realitatea.net,1,0,0,1,1.0,1.0
colegiu,www.realitatea.net,1,0,0,1,1.0,1.0
părinte,www.realitatea.net,1,0,0,1,1.0,1.0
sătean,www.realitatea.net,0,1,0,1,-1.0,1.0
Dan Apostol,www.antena3.ro,0,0,1,1,0.0,0.0
Daniei David,www.g4media.ro,0,0,1,1,0.0,0.0
Hodor,www.antena3.ro,0,0,2,2,0.0,0.0
Mădălin Hodor,www.antena3.ro,0,0,2,2,0.0,0.0
Dezsi Attila,a1.ro,0,0,1,1,0.0,0.0
Hunedoara,a1.ro,0,0,1,1,0.0,0.0
lume,a1.ro,0,1,0,1,-1.0,1.0
edil,www.b1tv.ro,0,1,0,1,-1.0,1.0
ofițer,www.news.ro,0,1,0,1,-1.0,1.0
Cataramă,www.cotidianul.ro,0,1,0,1,-1.0,1.0
Viorel Cataramă,www.cotidianul.ro,0,0,1,1,0.0,0.0
Brașov,www.g4media.ro,0,0,2,2,0.0,0.0
Dan Tăpălagă,www.g4media.ro,0,1,1,2,-0.5,0.5
Dragoș Pîslaru,www.g4media.ro,0,1,1,2,-0.5,0.5
Tanczos Barna,www.g4media.ro,0,0,1,1,0.0,0.0
Chikli,www.g4media.ro,0,1,0,1,-1.0,1.0
Karol Nawrocki,www.activenews.ro,0,0,1,1,0.0,0.0
Nawrocki,www.activenews.ro,0,0,1,1,0.0,0.0
Rafal Trzaskowski,www.activenews.ro,0,0,1,1,0.0,0.0
Republica Cehă,www.activenews.ro,0,0,1,1,0.0,0.0
Robert Fico,www.activenews.ro,0,1,0,1,-1.0,1.0
Slovacia,www.activenews.ro,0,0,1,1,0.0,0.0
Varșovia,www.activenews.ro,0,0,1,1,0.0,0.0
interimar,www.g4media.ro,0,0,1,1,0.0,0.0
Londra,www.news.ro,0,0,1,1,0.0,0.0
Madrid,www.news.ro,0,0,2,2,0.0,0.0
Marcel,www.news.ro,0,0,1,1,0.0,0.0
Monaco,www.news.ro,0,0,1,1,0.0,0.0
Nisa,www.news.ro,0,0,2,2,0.0,0.0
Recorder,www.news.ro,0,0,1,1,0.0,0.0
Simona,www.news.ro,0,0,1,1,0.0,0.0
Sinaia,www.news.ro,0,1,0,1,-1.0,1.0
altcineva,www.news.ro,0,1,0,1,-1.0,1.0
pasager,www.news.ro,0,0,3,3,0.0,0.0
generație,www.luju.ro,1,0,0,1,1.0,1.0
omolog,www.luju.ro,1,0,0,1,1.0,1.0
student,www.luju.ro,3,0,0,3,1.0,1.0
soră,www.luju.ro,1,0,0,1,1.0,1.0
Rotterdam,stirileprotv.ro,0,0,1,1,0.0,0.0
trezorier,stirileprotv.ro,0,0,1,1,0.0,0.0
Ciolos,stirileprotv.ro,0,0,1,1,0.0,0.0
Eugen Tomac,www.cotidianul.ro,0,0,1,1,0.0,0.0
observator,www.cotidianul.ro,0,0,1,1,0.0,0.0
Diaconescu,www.romaniatv.net,0,0,1,1,0.0,0.0
Adrian Maucher,pressone.ro,0,0,1,1,0.0,0.0
Adriana Maucher,pressone.ro,0,0,1,1,0.0,0.0
Adrianei Maucher,pressone.ro,0,0,1,1,0.0,0.0
Brad,pressone.ro,0,0,1,1,0.0,0.0
Maucher,pressone.ro,0,0,1,1,0.0,0.0
Moore,pressone.ro,0,0,1,1,0.0,0.0
Rovina,pressone.ro,0,0,1,1,0.0,0.0
Rovine,pressone.ro,0,1,0,1,-1.0,1.0
consăteni,pressone.ro,0,1,0,1,-1.0,1.0
ecologist,pressone.ro,0,1,0,1,-1.0,1.0
emisar,pressone.ro,0,1,0,1,-1.0,1.0
Georgia,www.gandul.ro,1,0,0,1,1.0,1.0
Codruț Șereș,www.mediafax.ro,0,0,2,2,0.0,0.0
Morega,www.mediafax.ro,0,1,0,1,-1.0,1.0
Norica Nicolai,www.mediafax.ro,0,1,1,2,-0.5,0.5
voi,www.euronews.ro,1,0,0,1,1.0,1.0
Cristian Popescu Piedone,www.mediafax.ro,0,1,0,1,-1.0,1.0
Cîrstoiu,www.mediafax.ro,0,0,1,1,0.0,0.0
bucureștean,www.mediafax.ro,0,1,0,1,-1.0,1.0
Mircea Dan Geoană,adevarul.ro,0,0,1,1,0.0,0.0
Sorin Ovidiu Vîntu,adevarul.ro,0,1,0,1,-1.0,1.0
Tal Hanan,adevarul.ro,0,0,1,1,0.0,0.0
mogul,adevarul.ro,0,1,0,1,-1.0,1.0
Chitic,www.luju.ro,0,2,1,3,-0.6666666666666666,0.6666666666666666
Cătălin Drula,www.luju.ro,0,1,0,1,-1.0,1.0
Elene Lasconi,www.luju.ro,0,1,0,1,-1.0,1.0
Ionut Mosteanu,www.luju.ro,0,1,0,1,-1.0,1.0
KW Johanis,www.luju.ro,0,0,2,2,0.0,0.0
subiect,www.luju.ro,0,0,4,4,0.0,0.0
Dan Chitic,www.luju.ro,0,0,6,6,0.0,0.0
Cosmin Ruscior,adevarul.ro,0,0,2,2,0.0,0.0
patriot,adevarul.ro,1,1,1,3,0.0,0.0
Florin Cîțu,www.news.ro,0,2,0,2,-1.0,1.0
Irina,recorder.ro,0,0,1,1,0.0,0.0
Iulia Marin,recorder.ro,0,0,1,1,0.0,0.0
scenarist,recorder.ro,0,1,0,1,-1.0,1.0
Natalia Intotero,www.b1tv.ro,0,0,1,1,0.0,0.0
dependent,www.b1tv.ro,0,1,0,1,-1.0,1.0
pacient,www.b1tv.ro,0,0,1,1,0.0,0.0
psihiatru,www.b1tv.ro,0,0,2,2,0.0,0.0
dușman,adevarul.ro,0,1,0,1,-1.0,1.0
Mario De Mezzo,www.news.ro,1,0,0,1,1.0,1.0
Slatina,www.news.ro,0,0,1,1,0.0,0.0
nepot,www.news.ro,0,1,1,2,-0.5,0.5
domnul,observatornews.ro,0,2,0,2,-1.0,1.0
Fechet,observatornews.ro,0,1,0,1,-1.0,1.0
Dan Popescu-Piedone,www.gandul.ro,0,0,1,1,0.0,0.0
Gușă,www.gandul.ro,0,2,1,3,-0.6666666666666666,0.6666666666666666
Negoiță,www.gandul.ro,0,1,0,1,-1.0,1.0
perdanț,www.gandul.ro,0,1,0,1,-1.0,1.0
Dominic,stirileprotv.ro,0,0,1,1,0.0,0.0
Elena,stirileprotv.ro,0,0,1,1,0.0,0.0
Moșteanu,stirileprotv.ro,0,0,1,1,0.0,0.0
dânș,stirileprotv.ro,0,1,0,1,-1.0,1.0
Ciprian Necula,stirileprotv.ro,0,0,1,1,0.0,0.0
Polițeanu,adevarul.ro,0,1,0,1,-1.0,1.0
adulți,www.news.ro,1,0,0,1,1.0,1.0
Alba Iulia,www.news.ro,0,0,1,1,0.0,0.0
Cincu,www.news.ro,0,0,1,1,0.0,0.0
NOI,www.news.ro,0,0,1,1,0.0,0.0
Mihai I,www.news.ro,0,0,1,1,0.0,0.0
unire,www.news.ro,1,0,0,1,1.0,1.0
comunicator politic,www.news.ro,0,0,1,1,0.0,0.0
Gheorghiță Vlad,www.news.ro,0,0,1,1,0.0,0.0
hotelier,www.news.ro,0,1,0,1,-1.0,1.0
localnic,www.news.ro,0,0,1,1,0.0,0.0
micuț,www.news.ro,0,0,1,1,0.0,0.0
organizator,www.news.ro,1,0,1,2,0.5,0.5
patriot,www.news.ro,0,0,1,1,0.0,0.0
Nicolae,www.news.ro,0,0,1,1,0.0,0.0
părinte,www.news.ro,0,0,1,1,0.0,0.0
turișt,www.news.ro,0,0,1,1,0.0,0.0
turiști,www.news.ro,0,1,0,1,-1.0,1.0
André Ventura,www.euronews.ro,0,0,1,1,0.0,0.0
Chega,www.euronews.ro,0,0,1,1,0.0,0.0
Luis Montenegro,www.euronews.ro,0,1,1,2,-0.5,0.5
Montenegro,www.euronews.ro,0,0,1,1,0.0,0.0
Pedro Nuno Santos,www.euronews.ro,0,0,1,1,0.0,0.0
comentator,www.euronews.ro,0,0,1,1,0.0,0.0
elită,www.euronews.ro,0,1,0,1,-1.0,1.0
imigrant,www.euronews.ro,0,2,0,2,-1.0,1.0
jurist,www.euronews.ro,0,0,1,1,0.0,0.0
lucrător,www.euronews.ro,0,1,0,1,-1.0,1.0
Marina Costa Lobo,www.euronews.ro,0,0,1,1,0.0,0.0
străin,www.euronews.ro,0,0,1,1,0.0,0.0
Dmitri Sviștev,www.gandul.ro,0,1,0,1,-1.0,1.0
Gheorghe Hagi,www.gandul.ro,0,0,1,1,0.0,0.0
Gutțait,www.gandul.ro,0,1,0,1,-1.0,1.0
Sviștev,www.gandul.ro,0,1,0,1,-1.0,1.0
fotbalist,www.gandul.ro,0,1,0,1,-1.0,1.0
Claudiu Iordache,observatornews.ro,1,0,0,1,1.0,1.0
Vasile Marcu,observatornews.ro,1,0,0,1,1.0,1.0
civil,observatornews.ro,1,0,0,1,1.0,1.0
compatriot,observatornews.ro,1,0,0,1,1.0,1.0
dușman,observatornews.ro,0,1,0,1,-1.0,1.0
revoluționar,observatornews.ro,0,0,1,1,0.0,0.0
amenință,www.romaniatv.net,0,1,0,1,-1.0,1.0
Alexandru Adamescu,pressone.ro,0,1,0,1,-1.0,1.0
Dan Adamescu,pressone.ro,0,1,0,1,-1.0,1.0
Jackson,pressone.ro,0,0,1,1,0.0,0.0
Cioloș,pressone.ro,1,0,0,1,1.0,1.0
Raluca Alexandra Prună,pressone.ro,0,0,1,1,0.0,0.0
Victor Ciorbea,pressone.ro,0,0,2,2,0.0,0.0
acoperiș,pressone.ro,0,1,0,1,-1.0,1.0
Iordache,pressone.ro,0,1,3,4,-0.25,0.25
rege,pressone.ro,1,1,0,2,0.0,0.0
restanțier,pressone.ro,0,2,0,2,-1.0,1.0
David Popovici,a1.ro,0,0,1,1,0.0,0.0
campion,a1.ro,0,0,1,1,0.0,0.0
Adrian Mititelu,a1.ro,0,0,1,1,0.0,0.0
Leonard Orban,a1.ro,0,0,1,1,0.0,0.0
Lucian Bolcas,a1.ro,0,0,1,1,0.0,0.0
subaltern,a1.ro,0,1,0,1,-1.0,1.0
Vadim,a1.ro,0,3,0,3,-1.0,1.0
Amalia,snoop.ro,0,1,0,1,-1.0,1.0
Amalia Păvălucă,snoop.ro,0,1,2,3,-0.3333333333333333,0.3333333333333333
Anatolii,snoop.ro,0,0,1,1,0.0,0.0
Andrei Corlan,snoop.ro,0,0,1,1,0.0,0.0
Berceanu,snoop.ro,0,0,1,1,0.0,0.0
Berlin,snoop.ro,0,0,1,1,0.0,0.0
Bistrița,snoop.ro,0,0,1,1,0.0,0.0
Caraș,snoop.ro,0,1,0,1,-1.0,1.0
Diana Grosu,snoop.ro,0,0,1,1,0.0,0.0
Dorohoi,snoop.ro,0,1,0,1,-1.0,1.0
Emre Gunay,snoop.ro,0,0,1,1,0.0,0.0
Fin Walravens,snoop.ro,0,0,1,1,0.0,0.0
Goma,snoop.ro,0,0,1,1,0.0,0.0
Ion Cupă,snoop.ro,0,0,2,2,0.0,0.0
Ionuț Constantin,snoop.ro,0,0,1,1,0.0,0.0
Jorge Gutierrez Marmol,snoop.ro,0,0,1,1,0.0,0.0
Maria,snoop.ro,0,0,1,1,0.0,0.0
Marie,snoop.ro,0,0,1,1,0.0,0.0
Mihaela Sofrone,snoop.ro,0,0,1,1,0.0,0.0
Montreal,snoop.ro,0,0,1,1,0.0,0.0
Octavian Berceanu,snoop.ro,0,0,1,1,0.0,0.0
Petea,snoop.ro,0,1,0,1,-1.0,1.0
Portugalia,snoop.ro,0,0,1,1,0.0,0.0
Păvălucă,snoop.ro,0,1,0,1,-1.0,1.0
reciclator,snoop.ro,0,3,0,3,-1.0,1.0
Steluța Popescu,snoop.ro,0,0,1,1,0.0,0.0
ucrainean,snoop.ro,0,0,1,1,0.0,0.0
Walravens,snoop.ro,0,0,1,1,0.0,0.0
investigator,snoop.ro,0,0,1,1,0.0,0.0
privați,snoop.ro,0,1,0,1,-1.0,1.0
samsar,snoop.ro,0,3,0,3,-1.0,1.0
tocător,snoop.ro,0,1,0,1,-1.0,1.0
vameș,snoop.ro,0,1,0,1,-1.0,1.0
vorbitor,snoop.ro,0,1,0,1,-1.0,1.0
Radu Umbreș,recorder.ro,0,0,1,1,0.0,0.0
excentric,recorder.ro,0,1,0,1,-1.0,1.0
Sorin Oprescu,www.b1tv.ro,0,1,0,1,-1.0,1.0
Videanu,www.b1tv.ro,0,1,0,1,-1.0,1.0
Andronescu,a1.ro,0,1,0,1,-1.0,1.0
Ecaterina Androneascu,a1.ro,0,0,1,1,0.0,0.0
Florian Popa,a1.ro,0,0,1,1,0.0,0.0
Nicolae Robu,a1.ro,0,0,1,1,0.0,0.0
Ștefan Dragulescu,a1.ro,0,0,1,1,0.0,0.0
masterand,a1.ro,0,0,1,1,0.0,0.0
ordonator,a1.ro,0,1,0,1,-1.0,1.0
Bogdan Popescu,snoop.ro,0,0,2,2,0.0,0.0
Brîndușa Andreea Vlanga,snoop.ro,0,0,1,1,0.0,0.0
Cezar Batog,snoop.ro,0,0,2,2,0.0,0.0
Laura Vicol,snoop.ro,0,0,1,1,0.0,0.0
Mihai Tănăsescu,snoop.ro,0,0,1,1,0.0,0.0
Năstase,snoop.ro,0,1,1,2,-0.5,0.5
Valeriu Zgonea,snoop.ro,0,0,1,1,0.0,0.0
adept,snoop.ro,0,1,0,1,-1.0,1.0
Ovidiu Vanghele,snoop.ro,0,0,1,1,0.0,0.0
semnatar,snoop.ro,0,1,1,2,-0.5,0.5
Sarbu,stirileprotv.ro,0,0,1,1,0.0,0.0
Dmitriy Makarov,www.news.ro,1,0,0,1,1.0,1.0
influencer,www.news.ro,0,1,0,1,-1.0,1.0
emisar,www.romaniatv.net,0,0,1,1,0.0,0.0
Adrian Negrescu,www.romaniatv.net,0,0,2,2,0.0,0.0
Augustin Zegrean,www.b1tv.ro,0,0,1,1,0.0,0.0
Zegrean,www.b1tv.ro,0,1,0,1,-1.0,1.0
decident,www.b1tv.ro,0,1,0,1,-1.0,1.0
Bianca Oanea,pressone.ro,0,0,1,1,0.0,0.0
Bicaz,pressone.ro,0,1,0,1,-1.0,1.0
Danirl Buda,pressone.ro,0,0,1,1,0.0,0.0
Gurlui,pressone.ro,0,1,0,1,-1.0,1.0
Gurlui Pavel,pressone.ro,0,0,1,1,0.0,0.0
Ionuț Simioncă,pressone.ro,0,0,1,1,0.0,0.0
Silviu Gurlui,pressone.ro,0,1,0,1,-1.0,1.0
stat,pressone.ro,0,0,1,1,0.0,0.0
licențiat,pressone.ro,0,0,1,1,0.0,0.0
penelist,pressone.ro,0,1,0,1,-1.0,1.0
salariat,www.gandul.ro,2,0,0,2,1.0,1.0
congresman,www.digi24.ro,0,0,1,1,0.0,0.0
decident,www.digi24.ro,0,0,1,1,0.0,0.0
dan,www.digi24.ro,0,0,1,1,0.0,0.0
Jefferson,pressone.ro,0,1,0,1,-1.0,1.0
Newton,pressone.ro,1,0,0,1,1.0,1.0
Sergiu Moroianu,pressone.ro,0,0,1,1,0.0,0.0
contabilă,pressone.ro,0,0,1,1,0.0,0.0
fetiță,pressone.ro,1,0,1,2,0.5,0.5
matematician,pressone.ro,1,1,2,4,0.0,0.0
om de știință,pressone.ro,0,1,0,1,-1.0,1.0
Koveși,www.realitatea.net,0,1,0,1,-1.0,1.0
Olguța Vasilescu,www.realitatea.net,0,1,0,1,-1.0,1.0
zeu,www.realitatea.net,0,1,0,1,-1.0,1.0
Coreea de Nord,adevarul.ro,0,0,1,1,0.0,0.0
Filat,adevarul.ro,0,1,0,1,-1.0,1.0
Marius Lulea,adevarul.ro,0,0,1,1,0.0,0.0
Adriana Ispas,www.luju.ro,0,0,2,2,0.0,0.0
Călin Popescu-Tăriceanu,www.luju.ro,1,1,0,2,0.0,0.0
Dan Andrei Enescu,www.luju.ro,0,0,1,1,0.0,0.0
Delia Ciurariu,www.luju.ro,0,0,1,1,0.0,0.0
Petru Berteanu,www.luju.ro,0,3,1,4,-0.75,0.75
Flavius Radu,www.luju.ro,0,0,1,1,0.0,0.0
Călin Popescu Tariceanu,www.luju.ro,0,0,1,1,0.0,0.0
Teodorescu Stefan Bogdan,www.luju.ro,0,0,1,1,0.0,0.0
Constanța,a1.ro,0,0,1,1,0.0,0.0
Ilfov,a1.ro,0,0,2,2,0.0,0.0
primăriță,a1.ro,0,1,0,1,-1.0,1.0
Gelu Tofan,adevarul.ro,0,0,2,2,0.0,0.0
istoric,www.euronews.ro,0,1,1,2,-0.5,0.5
Oliver Schmitt,www.euronews.ro,0,0,2,2,0.0,0.0
Magdeburg,www.euronews.ro,0,0,1,1,0.0,0.0
Mircea Abrudean,www.euronews.ro,0,0,2,2,0.0,0.0
Nancy Faeser,www.euronews.ro,0,0,1,1,0.0,0.0
Horst Walter Nopens,www.euronews.ro,0,0,1,1,0.0,0.0
anchetator,www.euronews.ro,0,3,3,6,-0.5,0.5
Adrian Cozma,www.gandul.ro,0,0,1,1,0.0,0.0
Ali Baba,pressone.ro,0,1,0,1,-1.0,1.0
Andra Bărbulescu,pressone.ro,0,1,0,1,-1.0,1.0
Andrei Bărbulescu,pressone.ro,0,0,1,1,0.0,0.0
Andrei Ovidiu Ramba,pressone.ro,0,1,0,1,-1.0,1.0
Andy Warhol,pressone.ro,0,0,1,1,0.0,0.0
Aurel Acasandrei,pressone.ro,0,0,1,1,0.0,0.0
Aurel Băeșu,pressone.ro,0,0,1,1,0.0,0.0
Berna,pressone.ro,0,0,1,1,0.0,0.0
Bărbulescu,pressone.ro,0,1,1,2,-0.5,0.5
Corneliu Baba,pressone.ro,0,0,1,1,0.0,0.0
Sandrei Stănescu,pressone.ro,0,0,1,1,0.0,0.0
Daniel Bărbulescu,pressone.ro,0,0,2,2,0.0,0.0
Edil al Slatinei,pressone.ro,0,0,1,1,0.0,0.0
Ion Petrică,pressone.ro,1,0,0,1,1.0,1.0
Jean Cocteau,pressone.ro,0,0,1,1,0.0,0.0
John Steinbeck,pressone.ro,0,0,1,1,0.0,0.0
Kino,pressone.ro,0,1,1,2,-0.5,0.5
Larisa Maria Popa,pressone.ro,0,0,1,1,0.0,0.0
Larisa Popa,pressone.ro,0,0,1,1,0.0,0.0
Lucian Sușală,pressone.ro,0,0,1,1,0.0,0.0
Marinică,pressone.ro,0,0,1,1,0.0,0.0
Marinică Strinu,pressone.ro,0,0,1,1,0.0,0.0
Minel Prina,pressone.ro,0,1,0,1,-1.0,1.0
miss,pressone.ro,0,0,1,1,0.0,0.0
Nicolae Grigorescu,pressone.ro,0,0,1,1,0.0,0.0
Nicolae Tonitza,pressone.ro,0,0,1,1,0.0,0.0
Nicolae Vermont,pressone.ro,0,0,1,1,0.0,0.0
Osica de Sus,pressone.ro,0,1,1,2,-0.5,0.5
Petrică,pressone.ro,1,0,0,1,1.0,1.0
Picasso,pressone.ro,0,0,1,1,0.0,0.0
Prina,pressone.ro,0,1,0,1,-1.0,1.0
Rafael Sanzio,pressone.ro,0,0,1,1,0.0,0.0
Ramba,pressone.ro,0,1,0,1,-1.0,1.0
Renoir,pressone.ro,0,0,1,1,0.0,0.0
Sandra Stănescu Langa,pressone.ro,0,1,0,1,-1.0,1.0
Socrul,pressone.ro,0,1,0,1,-1.0,1.0
Sușală,pressone.ro,0,1,0,1,-1.0,1.0
Thedor Berna,pressone.ro,0,0,1,1,0.0,0.0
Theodor Berna,pressone.ro,0,1,1,2,-0.5,0.5
Virgil Ramba,pressone.ro,0,1,0,1,-1.0,1.0
Vâșcov,pressone.ro,0,1,0,1,-1.0,1.0
denunțător,pressone.ro,0,1,0,1,-1.0,1.0
finalist,pressone.ro,0,1,0,1,-1.0,1.0
jurator,pressone.ro,0,1,0,1,-1.0,1.0
mijlocitor,pressone.ro,0,1,0,1,-1.0,1.0
musafir,pressone.ro,0,1,1,2,-0.5,0.5
socrul,pressone.ro,0,1,1,2,-0.5,0.5
soții Andra,pressone.ro,0,0,1,1,0.0,0.0
subaltern,pressone.ro,0,2,1,3,-0.6666666666666666,0.6666666666666666
văr,pressone.ro,0,0,1,1,0.0,0.0
Ștefan Luchian,pressone.ro,0,0,1,1,0.0,0.0
Falcă,www.romaniatv.net,0,0,1,1,0.0,0.0
Ionuț Stroe,www.romaniatv.net,0,0,1,1,0.0,0.0
bookmaker,www.comisarul.ro,0,1,0,1,-1.0,1.0
Andrei Marga,pressone.ro,0,0,1,1,0.0,0.0
Dana Constantinescu,pressone.ro,0,1,0,1,-1.0,1.0
Emil Hurezeanu,pressone.ro,0,0,2,2,0.0,0.0
Eunicia Trif,pressone.ro,0,1,0,1,-1.0,1.0
Filippov,pressone.ro,0,1,0,1,-1.0,1.0
George Copos,pressone.ro,0,0,1,1,0.0,0.0
Katherine Verdery,pressone.ro,0,0,1,1,0.0,0.0
Marga,pressone.ro,0,1,0,1,-1.0,1.0
Mediaș,pressone.ro,0,0,1,1,0.0,0.0
Mureșan,pressone.ro,0,0,1,1,0.0,0.0
Benito Mussolini,pressone.ro,0,1,0,1,-1.0,1.0
Roma,pressone.ro,0,0,1,1,0.0,0.0
Karen Attila Sebesi,pressone.ro,0,0,1,1,0.0,0.0
Trif,pressone.ro,0,1,0,1,-1.0,1.0
Verdery,pressone.ro,0,0,1,1,0.0,0.0
Vladimir Filippov,pressone.ro,0,0,1,1,0.0,0.0
Zoltán Györke,pressone.ro,0,0,1,1,0.0,0.0
arhivist,pressone.ro,0,0,1,1,0.0,0.0
confucianiști,pressone.ro,0,0,1,1,0.0,0.0
doctorandă,pressone.ro,0,0,1,1,0.0,0.0
domnul Marga,pressone.ro,0,0,1,1,0.0,0.0
ministru de externe,pressone.ro,0,1,0,1,-1.0,1.0
Barack Obama,www.gandul.ro,0,0,1,1,0.0,0.0
Florin Manole,www.mediafax.ro,0,0,1,1,0.0,0.0
moștenitor,adevarul.ro,0,1,0,1,-1.0,1.0
Ana Birchall Cristian Diaconescu,a1.ro,0,0,1,1,0.0,0.0
Mane Voicu,a1.ro,0,0,1,1,0.0,0.0
Ioanei State,a1.ro,0,0,1,1,0.0,0.0
mame,a1.ro,1,0,1,2,0.5,0.5
Terheș,www.realitatea.net,0,1,0,1,-1.0,1.0
Uniunea,www.realitatea.net,0,1,0,1,-1.0,1.0
Iliescu,www.realitatea.net,0,2,0,2,-1.0,1.0
conducător,www.realitatea.net,0,3,1,4,-0.75,0.75
cunoscător,www.realitatea.net,0,1,0,1,-1.0,1.0
doamna Lasconi,www.realitatea.net,0,0,1,1,0.0,0.0
familia Trump,www.realitatea.net,0,1,0,1,-1.0,1.0
informator,www.realitatea.net,0,1,0,1,-1.0,1.0
pierzător,www.realitatea.net,0,1,0,1,-1.0,1.0
respectiv,www.realitatea.net,0,1,0,1,-1.0,1.0
Corneliu Vadim Tudor,www.realitatea.net,0,1,0,1,-1.0,1.0
Adrian Câciu,www.b1tv.ro,0,1,1,2,-0.5,0.5
Gigel Știrbu,primanews.ro,0,0,1,1,0.0,0.0
Ambilly,www.aktual24.ro,0,1,0,1,-1.0,1.0
Dan Enache,www.aktual24.ro,0,0,1,1,0.0,0.0
Oberländer,www.comisarul.ro,0,0,1,1,0.0,0.0
Ligia Deca,www.euronews.ro,0,0,1,1,0.0,0.0
Alexandru,www.b1tv.ro,0,1,0,1,-1.0,1.0
Botoșani,www.b1tv.ro,0,1,0,1,-1.0,1.0
Ioan Gruia Bumbu,www.b1tv.ro,0,1,1,2,-0.5,0.5
localnic,www.b1tv.ro,0,1,0,1,-1.0,1.0
mămică,www.b1tv.ro,0,1,0,1,-1.0,1.0
Florin Călinescu,www.romaniatv.net,0,0,1,1,0.0,0.0
Oana Pellea,adevarul.ro,1,0,1,2,0.5,0.5
Dan Șova,pressone.ro,0,1,0,1,-1.0,1.0
Kafka,pressone.ro,0,1,0,1,-1.0,1.0
decanat,pressone.ro,0,1,0,1,-1.0,1.0
Cei,www.gandul.ro,0,0,1,1,0.0,0.0
Nawaf Salameh,www.gandul.ro,0,0,1,1,0.0,0.0
număr,www.gandul.ro,0,0,2,2,0.0,0.0
Carlo Fidanza,www.antena3.ro,0,0,1,1,0.0,0.0
Georgia Meloni,www.antena3.ro,0,0,1,1,0.0,0.0
Marion Marechal,www.antena3.ro,0,0,1,1,0.0,0.0
Mateusz Moravietki,www.antena3.ro,0,0,1,1,0.0,0.0
contracandidat,www.antena3.ro,0,6,3,9,-0.6666666666666666,0.6666666666666666
jandarm,a1.ro,0,0,1,1,0.0,0.0
Ludovic Orban,www.cotidianul.ro,0,1,1,2,-0.5,0.5
David,www.activenews.ro,0,1,0,1,-1.0,1.0
Goliat,www.activenews.ro,0,1,0,1,-1.0,1.0
Mielu,www.activenews.ro,0,0,1,1,0.0,0.0
bun,www.activenews.ro,0,1,0,1,-1.0,1.0
fan,www.activenews.ro,0,1,0,1,-1.0,1.0
Adrian Wiener,observatornews.ro,0,0,1,1,0.0,0.0
fost,observatornews.ro,0,1,0,1,-1.0,1.0
epidemiolog,observatornews.ro,0,1,0,1,-1.0,1.0
Moțteanu,www.news.ro,0,0,1,1,0.0,0.0
creator,www.luju.ro,0,1,0,1,-1.0,1.0
Cristian Preda,a1.ro,0,0,1,1,0.0,0.0
Giorgia Meloni,www.activenews.ro,0,0,1,1,0.0,0.0
Italia,www.activenews.ro,0,0,1,1,0.0,0.0
Maidan,www.activenews.ro,0,0,1,1,0.0,0.0
Matteo Salvini,www.activenews.ro,0,0,1,1,0.0,0.0
Alexandru Cumpănașu,pressone.ro,0,0,1,1,0.0,0.0
Constantin Degeratu,pressone.ro,0,0,2,2,0.0,0.0
Costin Georgescu,pressone.ro,0,0,1,1,0.0,0.0
Cumpănașu,pressone.ro,0,0,4,4,0.0,0.0
Domnul Cumpănașu,pressone.ro,0,0,1,1,0.0,0.0
Dumitru Coarnă,pressone.ro,0,0,1,1,0.0,0.0
Gigel Paraschiv,pressone.ro,0,0,1,1,0.0,0.0
Olimpiodor Antonescu,pressone.ro,0,1,0,1,-1.0,1.0
Vali Popa,pressone.ro,0,0,1,1,0.0,0.0
co-rector,pressone.ro,0,0,1,1,0.0,0.0
Dumitru,pressone.ro,0,0,1,1,0.0,0.0
Vasile Popa,pressone.ro,0,1,0,1,-1.0,1.0
ministru al Educației,pressone.ro,0,0,1,1,0.0,0.0
Tudor Ciuhodaru,pressone.ro,0,0,3,3,0.0,0.0
Maricela Cobuz,pressone.ro,0,0,1,1,0.0,0.0
Cătălin Scânteie,pressone.ro,0,0,1,1,0.0,0.0
Eugen Iancu,pressone.ro,0,0,1,1,0.0,0.0
ars,pressone.ro,0,1,0,1,-1.0,1.0
marelui,pressone.ro,0,0,1,1,0.0,0.0
rănit,pressone.ro,0,1,0,1,-1.0,1.0
George Stângă,www.g4media.ro,0,3,0,3,-1.0,1.0
Onuț Atanasiu,www.g4media.ro,0,0,1,1,0.0,0.0
Pauliuc,www.g4media.ro,0,0,1,1,0.0,0.0
Nicoleta Pauliuc,www.g4media.ro,0,0,2,2,0.0,0.0
Stângă,www.g4media.ro,0,1,0,1,-1.0,1.0
George Scarlat,www.g4media.ro,0,0,1,1,0.0,0.0
Silvia Dinică,www.b1tv.ro,0,0,1,1,0.0,0.0
Corina Crețu,www.g4media.ro,0,0,1,1,0.0,0.0
Secretar General,www.g4media.ro,0,1,1,2,-0.5,0.5
Bădălan,www.gandul.ro,0,2,0,2,-1.0,1.0
General Bădălan,www.gandul.ro,0,1,0,1,-1.0,1.0
Nassiriya,www.gandul.ro,0,1,0,1,-1.0,1.0
component,www.gandul.ro,0,0,1,1,0.0,0.0
Gheorghe Ciucă,www.gandul.ro,0,1,0,1,-1.0,1.0
impostor,www.gandul.ro,0,1,0,1,-1.0,1.0
încheiere,www.gandul.ro,0,1,0,1,-1.0,1.0
Stelian Ion,www.antena3.ro,0,0,2,2,0.0,0.0
Crin Antoenscu,www.mediafax.ro,0,0,1,1,0.0,0.0
doamna Lasconi,www.mediafax.ro,0,0,1,1,0.0,0.0
Ioan Mihalcea,www.aktual24.ro,0,0,1,1,0.0,0.0
Mihalcea,www.aktual24.ro,0,0,1,1,0.0,0.0
Petre Florin Manole,www.aktual24.ro,0,0,1,1,0.0,0.0
Robert Negoita,www.aktual24.ro,0,0,2,2,0.0,0.0
Rodica Nassar,www.aktual24.ro,0,0,1,1,0.0,0.0
Viorica Dăncilă,www.aktual24.ro,0,0,1,1,0.0,0.0
Vlad Piedone,www.aktual24.ro,0,0,1,1,0.0,0.0
familia Goleac,www.aktual24.ro,0,0,1,1,0.0,0.0
Marian Neacsu,www.aktual24.ro,0,0,2,2,0.0,0.0
Humelnicu,primanews.ro,0,0,1,1,0.0,0.0
Marius Humelnicu,primanews.ro,0,0,2,2,0.0,0.0
Natalia Elena Intotero,www.antena3.ro,0,0,1,1,0.0,0.0
absolvent,www.antena3.ro,0,0,1,1,0.0,0.0
brădeni,www.antena3.ro,0,1,0,1,-1.0,1.0
concetățean,www.antena3.ro,1,0,0,1,1.0,1.0
hunedorean,www.antena3.ro,0,0,1,1,0.0,0.0
institutor,www.antena3.ro,1,0,0,1,1.0,1.0
stat,www.antena3.ro,0,0,1,1,0.0,0.0
Nicolae Văcăroiu,www.news.ro,0,0,1,1,0.0,0.0
Snagov,www.news.ro,0,0,1,1,0.0,0.0
a,www.news.ro,0,0,1,1,0.0,0.0
Emil Boc,www.news.ro,0,0,2,2,0.0,0.0
Adela Mârza,www.gandul.ro,0,0,1,1,0.0,0.0
Gheorghe Noane,www.gandul.ro,1,0,0,1,1.0,1.0
Ana Birchall,recorder.ro,0,0,1,1,0.0,0.0
Anca Marcu,recorder.ro,0,0,2,2,0.0,0.0
Andreea Bragă,recorder.ro,0,0,1,1,0.0,0.0
Armand,recorder.ro,0,0,1,1,0.0,0.0
Boghiu,recorder.ro,0,0,1,1,0.0,0.0
Bragadiru,recorder.ro,0,0,1,1,0.0,0.0
Bragă,recorder.ro,0,0,1,1,0.0,0.0
Bădulescu,recorder.ro,0,1,0,1,-1.0,1.0
Chichirău,recorder.ro,0,0,1,1,0.0,0.0
Ciceală,recorder.ro,0,0,1,1,0.0,0.0
Cojocna,recorder.ro,0,0,1,1,0.0,0.0
Diana Mardarovici,recorder.ro,0,0,1,1,0.0,0.0
Diana Mărgărit,recorder.ro,0,0,2,2,0.0,0.0
Diana Oncioiu,recorder.ro,0,0,1,1,0.0,0.0
Dinu Gheorghe,recorder.ro,0,1,0,1,-1.0,1.0
Ene,recorder.ro,0,1,0,1,-1.0,1.0
Felicia Ienculescu,recorder.ro,0,0,1,1,0.0,0.0
Flavia Boghiu,recorder.ro,1,2,3,6,-0.16666666666666666,0.16666666666666666
Florin Octavian,recorder.ro,0,1,0,1,-1.0,1.0
Florinea,recorder.ro,0,1,0,1,-1.0,1.0
Ioan Micu,recorder.ro,0,0,1,1,0.0,0.0
Ionela Băluță,recorder.ro,0,0,2,2,0.0,0.0
Liviu Bojan,recorder.ro,0,0,1,1,0.0,0.0
Marcu,recorder.ro,0,0,1,1,0.0,0.0
Micu,recorder.ro,0,1,0,1,-1.0,1.0
Mogoșoaia,recorder.ro,0,0,1,1,0.0,0.0
mărgărit,recorder.ro,0,0,1,1,0.0,0.0
Negrea,recorder.ro,0,1,0,1,-1.0,1.0
Petronela Piticari,recorder.ro,0,0,1,1,0.0,0.0
Piticari,recorder.ro,0,1,0,1,-1.0,1.0
Raluca Teodor,recorder.ro,0,1,0,1,-1.0,1.0
Roma Gavrilă,recorder.ro,0,0,1,1,0.0,0.0
Răzvan Negrea,recorder.ro,0,1,0,1,-1.0,1.0
Scarlat,recorder.ro,0,1,0,1,-1.0,1.0
Teodor,recorder.ro,0,1,0,1,-1.0,1.0
Teodora Desagă,recorder.ro,0,0,2,2,0.0,0.0
Valentin Ene,recorder.ro,0,2,0,2,-1.0,1.0
Vlad Stoicescu,recorder.ro,0,0,1,1,0.0,0.0
agresor,recorder.ro,0,4,0,4,-1.0,1.0
casnică,recorder.ro,0,1,0,1,-1.0,1.0
Roxana Wring,recorder.ro,0,0,1,1,0.0,0.0
educator,recorder.ro,0,0,1,1,0.0,0.0
ene,recorder.ro,0,1,0,1,-1.0,1.0
frustrat,recorder.ro,0,1,0,1,-1.0,1.0
prostituată,recorder.ro,0,1,0,1,-1.0,1.0
vampă,recorder.ro,0,1,0,1,-1.0,1.0
Danivel David,www.news.ro,0,0,1,1,0.0,0.0
David,www.news.ro,0,0,2,2,0.0,0.0
profesor universitar,www.news.ro,0,0,1,1,0.0,0.0
Rector,www.news.ro,0,0,1,1,0.0,0.0
Alex Bodi,stirileprotv.ro,0,1,0,1,-1.0,1.0
Anghel Tîlvăr,stirileprotv.ro,0,0,1,1,0.0,0.0
Bogdan Ivan,stirileprotv.ro,0,0,2,2,0.0,0.0
Daniel David,stirileprotv.ro,0,0,2,2,0.0,0.0
Florin Barbu,stirileprotv.ro,0,0,2,2,0.0,0.0
Marcel Boloș,stirileprotv.ro,0,0,2,2,0.0,0.0
Mircea Fechet,stirileprotv.ro,0,0,2,2,0.0,0.0
Natalia Intotero,stirileprotv.ro,0,0,2,2,0.0,0.0
Radu Marinescu,stirileprotv.ro,0,0,3,3,0.0,0.0
Simona Bucura-Oprescu,stirileprotv.ro,0,0,2,2,0.0,0.0
interlop,stirileprotv.ro,0,1,0,1,-1.0,1.0
Eduard,observatornews.ro,1,0,0,1,1.0,1.0
Răzvan Ionescu,observatornews.ro,0,0,1,1,0.0,0.0
Claudiu Crăciun,www.digi24.ro,0,0,1,1,0.0,0.0
Oana Băluță,www.digi24.ro,0,0,1,1,0.0,0.0
Dan Puric,pressone.ro,0,0,1,1,0.0,0.0
Mircea Vulcănescu,pressone.ro,0,2,0,2,-1.0,1.0
Silviu Man,pressone.ro,0,0,1,1,0.0,0.0
Erez,www.euronews.ro,0,1,0,1,-1.0,1.0
Hugh Hewitt,www.euronews.ro,0,0,1,1,0.0,0.0
New Hampshire,www.euronews.ro,0,1,0,1,-1.0,1.0
Rostov,www.euronews.ro,0,1,0,1,-1.0,1.0
Maine,www.euronews.ro,0,0,1,1,0.0,0.0
Bogdan Gheorghiu,pressone.ro,0,1,0,1,-1.0,1.0
Daniel Popescu,primanews.ro,0,0,1,1,0.0,0.0
Alexandru Nazare,www.b1tv.ro,0,0,1,1,0.0,0.0
Daniel Tudorache,www.b1tv.ro,0,0,1,1,0.0,0.0
Satu Mare,www.b1tv.ro,0,0,1,1,0.0,0.0
Nepal,www.euronews.ro,0,0,1,1,0.0,0.0
șomer,www.euronews.ro,0,1,0,1,-1.0,1.0
adult,www.aktual24.ro,0,0,3,3,0.0,0.0
angajator,www.g4media.ro,0,0,1,1,0.0,0.0
Abraham,www.gandul.ro,0,0,1,1,0.0,0.0
Kamala Harris,www.gandul.ro,1,0,2,3,0.3333333333333333,0.3333333333333333
civil,www.gandul.ro,1,0,0,1,1.0,1.0
paletinian,www.gandul.ro,0,1,0,1,-1.0,1.0
terț,www.gandul.ro,0,1,0,1,-1.0,1.0
Max Weber,adevarul.ro,0,1,1,2,-0.5,0.5
filosof,adevarul.ro,0,0,1,1,0.0,0.0
investitor,www.b1tv.ro,0,1,0,1,-1.0,1.0
Constantiana,www.activenews.ro,0,1,0,1,-1.0,1.0
Constantin Barbu,www.activenews.ro,0,0,1,1,0.0,0.0
Constantin,www.activenews.ro,0,0,1,1,0.0,0.0
neștiutor,www.activenews.ro,0,1,0,1,-1.0,1.0
Romei,www.activenews.ro,0,0,1,1,0.0,0.0
Sfinții Împărați Constantin și Elena,www.activenews.ro,0,0,1,1,0.0,0.0
Tomis,www.activenews.ro,1,0,1,2,0.5,0.5
Zeita Fortuna,www.activenews.ro,0,0,1,1,0.0,0.0
negustor,www.activenews.ro,0,0,1,1,0.0,0.0
protectoare,www.activenews.ro,1,0,0,1,1.0,1.0
Fortuna,www.activenews.ro,0,0,1,1,0.0,0.0
Ponthos,www.activenews.ro,0,0,1,1,0.0,0.0
Constantin cel Mare,www.activenews.ro,0,1,1,2,-0.5,0.5
Roșia Montană,www.euronews.ro,0,1,0,1,-1.0,1.0
beneficiar,www.euronews.ro,0,0,1,1,0.0,0.0
victima,www.euronews.ro,0,0,1,1,0.0,0.0
Kovacs,www.mediafax.ro,0,0,1,1,0.0,0.0
consilier parlamentar,www.aktual24.ro,0,1,1,2,-0.5,0.5
nabab,www.aktual24.ro,0,1,0,1,-1.0,1.0
Ala Nemerenco,www.euronews.ro,0,0,1,1,0.0,0.0
Alexei Buzu,www.euronews.ro,0,0,1,1,0.0,0.0
Ana Revenco,www.euronews.ro,0,0,1,1,0.0,0.0
Anatolie Topala,www.euronews.ro,0,0,1,1,0.0,0.0
Anatolii Nosatîi,www.euronews.ro,0,0,1,1,0.0,0.0
Dumitru Alaiba,www.euronews.ro,0,0,1,1,0.0,0.0
Lilia Dabija,www.euronews.ro,0,0,1,1,0.0,0.0
Natalia Gavrilița,www.euronews.ro,0,0,1,1,0.0,0.0
Nicu Popescu,www.euronews.ro,0,0,1,1,0.0,0.0
Oleg Serebrian,www.euronews.ro,0,0,1,1,0.0,0.0
Rodica Iordanov,www.euronews.ro,0,0,1,1,0.0,0.0
Sergiu Prodan,www.euronews.ro,0,0,1,1,0.0,0.0
Victor Parlicov,www.euronews.ro,0,0,1,1,0.0,0.0
Vladimir Bolea,www.euronews.ro,0,0,1,1,0.0,0.0
absolvent,www.euronews.ro,0,0,2,2,0.0,0.0
Balș,www.euronews.ro,0,0,1,1,0.0,0.0
Ciorbea,www.euronews.ro,0,0,1,1,0.0,0.0
Funeriu,www.euronews.ro,0,0,2,2,0.0,0.0
Isărescu,www.euronews.ro,0,0,1,1,0.0,0.0
Terheș,www.euronews.ro,0,0,1,1,0.0,0.0
adjunct,www.euronews.ro,0,0,1,1,0.0,0.0
fondator,www.euronews.ro,0,0,1,1,0.0,0.0
geolog,www.euronews.ro,0,0,1,1,0.0,0.0
inițiator,www.euronews.ro,0,0,1,1,0.0,0.0
locțiitor,www.euronews.ro,0,0,1,1,0.0,0.0
Gheorghe Flutur,www.realitatea.net,0,0,1,1,0.0,0.0
pensionar,www.realitatea.net,0,3,0,3,-1.0,1.0
premiu,www.realitatea.net,1,0,0,1,1.0,1.0
exponenț,www.romaniatv.net,0,1,0,1,-1.0,1.0
lazaroiu,a1.ro,0,0,1,1,0.0,0.0
locatar,www.luju.ro,0,1,0,1,-1.0,1.0
Oana Stancu,a1.ro,0,0,2,2,0.0,0.0
moderatoare,a1.ro,0,0,1,1,0.0,0.0
Olanda,www.b1tv.ro,0,0,1,1,0.0,0.0
muzeograf,www.b1tv.ro,0,0,1,1,0.0,0.0
populație,www.b1tv.ro,0,2,0,2,-1.0,1.0
Anamaria Gavrilă,www.news.ro,0,0,3,3,0.0,0.0
Gavrilă,www.news.ro,0,0,1,1,0.0,0.0
Botoșani,www.mediafax.ro,0,0,1,1,0.0,0.0
Galați,www.mediafax.ro,0,0,3,3,0.0,0.0
Vaslui,www.mediafax.ro,0,0,2,2,0.0,0.0
Szabo Odon,www.cotidianul.ro,0,0,1,1,0.0,0.0
edil,www.cotidianul.ro,0,2,0,2,-1.0,1.0
Adjud,www.g4media.ro,0,0,1,1,0.0,0.0
Adrian Crețu,www.g4media.ro,0,0,1,1,0.0,0.0
Claudiu Matei,www.g4media.ro,0,0,1,1,0.0,0.0
Dragoș Ciobotaru,www.g4media.ro,0,0,1,1,0.0,0.0
"Dragoș Ciobotaru, președintele",www.g4media.ro,0,0,1,1,0.0,0.0
Florin Nechifor,www.g4media.ro,0,0,1,1,0.0,0.0
Ion Epure,www.g4media.ro,0,0,1,1,0.0,0.0
Liviu Bostan,www.g4media.ro,0,0,1,1,0.0,0.0
Nereju,www.g4media.ro,0,0,1,1,0.0,0.0
Nicolai Mărăscu,www.g4media.ro,0,0,1,1,0.0,0.0
Panciu,www.g4media.ro,0,0,1,1,0.0,0.0
Toader Gemănaș,www.g4media.ro,0,0,1,1,0.0,0.0
inspector,www.g4media.ro,0,0,2,2,0.0,0.0
Raluca Ioan,www.g4media.ro,1,0,1,2,0.5,0.5
Lasconi,www.luju.ro,0,0,1,1,0.0,0.0
politic,adevarul.ro,0,1,0,1,-1.0,1.0
Zăbavă,adevarul.ro,0,1,1,2,-0.5,0.5
Croitoru,stirileprotv.ro,0,0,1,1,0.0,0.0
bătrân,www.realitatea.net,0,1,1,2,-0.5,0.5
vârstnic,www.realitatea.net,0,1,0,1,-1.0,1.0
Dan Voiculescu,www.digi24.ro,0,0,1,1,0.0,0.0
Alex Nedea,www.comisarul.ro,0,0,1,1,0.0,0.0
Micutzu,www.comisarul.ro,0,0,1,1,0.0,0.0
meseriași,www.comisarul.ro,1,0,0,1,1.0,1.0
Alexandra Chirilă,pressone.ro,0,0,1,1,0.0,0.0
Silviu Feroiu,pressone.ro,0,0,1,1,0.0,0.0
Valeriu Gheorghiță,pressone.ro,0,0,1,1,0.0,0.0
Adrian Câciu,www.news.ro,0,0,1,1,0.0,0.0
Alina Gorghiu,www.news.ro,0,0,1,1,0.0,0.0
Dan Motreanu,www.news.ro,0,0,1,1,0.0,0.0
Florin Roman,www.news.ro,0,0,1,1,0.0,0.0
Gigi Becali,www.news.ro,0,1,0,1,-1.0,1.0
Mircea Fechet,www.news.ro,0,0,1,1,0.0,0.0
Mitică Dragomir,www.news.ro,0,1,0,1,-1.0,1.0
ai,www.news.ro,0,0,1,1,0.0,0.0
consultant,www.news.ro,0,1,0,1,-1.0,1.0
înlocuitor,www.news.ro,0,1,1,2,-0.5,0.5
Aurel Bogdan,adevarul.ro,0,0,1,1,0.0,0.0
Boc,adevarul.ro,0,0,2,2,0.0,0.0
Bogdan Pitigoi,adevarul.ro,0,3,0,3,-1.0,1.0
Codrut Seres,adevarul.ro,0,0,2,2,0.0,0.0
Cristian Boureanu,adevarul.ro,0,0,1,1,0.0,0.0
Dan Olteanu,adevarul.ro,0,0,1,1,0.0,0.0
Vasilescu,adevarul.ro,0,1,0,1,-1.0,1.0
Emil Boc,adevarul.ro,1,1,4,6,0.0,0.0
Gelu Visan,adevarul.ro,0,0,1,1,0.0,0.0
Gheorghe Falca,adevarul.ro,0,0,1,1,0.0,0.0
Gusa,adevarul.ro,0,0,1,1,0.0,0.0
Lia Olguta,adevarul.ro,0,0,1,1,0.0,0.0
Liviu Nistoran,adevarul.ro,0,0,2,2,0.0,0.0
Mihai Voicu,adevarul.ro,0,0,1,1,0.0,0.0
Mitica Dragomir,adevarul.ro,0,1,0,1,-1.0,1.0
Nastase,adevarul.ro,0,0,1,1,0.0,0.0
istorian,adevarul.ro,0,0,1,1,0.0,0.0
Patriciu,adevarul.ro,0,1,0,1,-1.0,1.0
Tariceanu,adevarul.ro,0,1,0,1,-1.0,1.0
tineret,adevarul.ro,0,1,2,3,-0.3333333333333333,0.3333333333333333
Vasilești,adevarul.ro,0,0,1,1,0.0,0.0
bătrân,adevarul.ro,1,0,2,3,0.3333333333333333,0.3333333333333333
Nicu Vasilescu,adevarul.ro,0,0,1,1,0.0,0.0
exponent,adevarul.ro,0,1,0,1,-1.0,1.0
pedist,adevarul.ro,0,0,1,1,0.0,0.0
pesedist,adevarul.ro,0,2,0,2,-1.0,1.0
seful,adevarul.ro,0,1,0,1,-1.0,1.0
spion,adevarul.ro,0,2,0,2,-1.0,1.0
Amalia Bellantoni,www.luju.ro,0,1,0,1,-1.0,1.0
,primanews.ro,0,0,2,2,0.0,0.0
Silviu Predoiu,primanews.ro,0,0,1,1,0.0,0.0
Angelica Fădor,recorder.ro,0,0,1,1,0.0,0.0
Anthony Quinn,recorder.ro,0,0,1,1,0.0,0.0
Bogdan Gheorghiu,recorder.ro,0,0,1,1,0.0,0.0
Bucovina,recorder.ro,1,0,0,1,1.0,1.0
bunica,recorder.ro,0,0,1,1,0.0,0.0
Constantin Daniel Cadariu,recorder.ro,0,0,1,1,0.0,0.0
Câmpulung Moldovenesc,recorder.ro,0,1,0,1,-1.0,1.0
Cătălin Avramescu,recorder.ro,0,0,1,1,0.0,0.0
Cătălin Nechifor,recorder.ro,0,0,1,1,0.0,0.0
Dolhasca,recorder.ro,0,0,1,1,0.0,0.0
Doru Lefter,recorder.ro,0,0,1,1,0.0,0.0
Dumitru Mihalescul,recorder.ro,0,0,1,1,0.0,0.0
Eugen Bejinariu,recorder.ro,0,0,2,2,0.0,0.0
Fălticeni,recorder.ro,0,0,1,1,0.0,0.0
Fărcașa,recorder.ro,0,0,1,1,0.0,0.0
Gabriel Liiceanu,recorder.ro,0,0,1,1,0.0,0.0
Hudești,recorder.ro,0,0,1,1,0.0,0.0
Ioan Balan,recorder.ro,0,0,1,1,0.0,0.0
Ioan Stan,recorder.ro,0,0,1,1,0.0,0.0
Ion Lungu,recorder.ro,1,0,0,1,1.0,1.0
Ion Mihai Pacepa,recorder.ro,0,1,0,1,-1.0,1.0
Laura Cătălina Culipei,recorder.ro,0,0,1,1,0.0,0.0
Lev Tolstoi,recorder.ro,0,0,2,2,0.0,0.0
Lorenzo Marone,recorder.ro,0,0,1,1,0.0,0.0
Marginea,recorder.ro,0,0,1,1,0.0,0.0
Marian Andronache,recorder.ro,0,0,1,1,0.0,0.0
Mirela Adomnicăi,recorder.ro,0,0,1,1,0.0,0.0
Pojorâta,recorder.ro,0,1,0,1,-1.0,1.0
Radu Ciornei,recorder.ro,0,0,1,1,0.0,0.0
Reza Aslan,recorder.ro,0,0,2,2,0.0,0.0
Seneca,recorder.ro,0,0,1,1,0.0,0.0
Stejaru,recorder.ro,0,0,1,1,0.0,0.0
Ségolène Royal,recorder.ro,0,0,1,1,0.0,0.0
Tony Blair,recorder.ro,0,0,1,1,0.0,0.0
amant,recorder.ro,0,2,0,2,-1.0,1.0
artist,recorder.ro,0,0,1,1,0.0,0.0
Rafila,recorder.ro,0,1,0,1,-1.0,1.0
Vela,recorder.ro,0,0,1,1,0.0,0.0
mandatar,recorder.ro,0,0,1,1,0.0,0.0
solicitant,recorder.ro,1,0,1,2,0.5,0.5
veterinar,recorder.ro,0,0,1,1,0.0,0.0
Președintele României,www.romaniatv.net,0,0,1,1,0.0,0.0
inițiator,www.mediafax.ro,0,0,1,1,0.0,0.0
prizonier,www.mediafax.ro,0,0,1,1,0.0,0.0
Ana Ciceala,www.aktual24.ro,0,0,1,1,0.0,0.0
Dragos Pislaru,www.aktual24.ro,0,0,1,1,0.0,0.0
Florina Presada,www.aktual24.ro,0,0,1,1,0.0,0.0
Ramona Strugariu,www.aktual24.ro,0,0,1,1,0.0,0.0
copreședinte,www.aktual24.ro,0,0,1,1,0.0,0.0
directoare,www.aktual24.ro,0,0,1,1,0.0,0.0
Nicu Ștefănuță,www.aktual24.ro,0,0,1,1,0.0,0.0
Cei,observatornews.ro,0,1,0,1,-1.0,1.0
Ion Dumitrache,observatornews.ro,0,0,1,1,0.0,0.0
Marius Voineag,observatornews.ro,0,0,1,1,0.0,0.0
Procuror,observatornews.ro,0,0,1,1,0.0,0.0
director general,observatornews.ro,0,0,1,1,0.0,0.0
dl Simonis,www.realitatea.net,0,1,0,1,-1.0,1.0
domnie,www.realitatea.net,0,2,1,3,-0.6666666666666666,0.6666666666666666
Afganistan,www.mediafax.ro,0,1,0,1,-1.0,1.0
Siria,www.mediafax.ro,0,0,1,1,0.0,0.0
Viorica Costiniu,www.luju.ro,0,3,0,3,-1.0,1.0
Pralea,www.luju.ro,0,1,0,1,-1.0,1.0
absolvent,www.luju.ro,0,0,1,1,0.0,0.0
Mugur Băsescu,www.luju.ro,0,0,1,1,0.0,0.0
initiator,www.luju.ro,0,1,0,1,-1.0,1.0
Costiniu,www.luju.ro,0,0,1,1,0.0,0.0
Ovidiu Pralea,www.luju.ro,0,1,0,1,-1.0,1.0
jude,www.luju.ro,0,0,1,1,0.0,0.0
muncitor,www.luju.ro,0,1,0,1,-1.0,1.0
politai,www.luju.ro,0,1,0,1,-1.0,1.0
Adrian Gluga,www.luju.ro,0,0,4,4,0.0,0.0
Gluga,www.luju.ro,0,0,1,1,0.0,0.0
celălalt,www.luju.ro,0,1,0,1,-1.0,1.0
dvs,www.luju.ro,0,0,1,1,0.0,0.0
Cristian Popescu Piedone,www.realitatea.net,0,0,1,1,0.0,0.0
Gabriela Firea,www.realitatea.net,0,0,1,1,0.0,0.0
Giurgiu,www.realitatea.net,0,0,1,1,0.0,0.0
Gelu Puiu,recorder.ro,0,0,1,1,0.0,0.0
demnitar,a1.ro,0,0,2,2,0.0,0.0
titular,a1.ro,0,0,2,2,0.0,0.0
Vasile Costiuc,primanews.ro,0,0,1,1,0.0,0.0
Dan Motreanu,observatornews.ro,0,0,1,1,0.0,0.0
Motreanu,observatornews.ro,0,0,1,1,0.0,0.0
Alin Nica,stirileprotv.ro,0,0,1,1,0.0,0.0
Dănuț Groza,stirileprotv.ro,0,0,1,1,0.0,0.0
EL,stirileprotv.ro,0,0,1,1,0.0,0.0
Groza,stirileprotv.ro,0,1,0,1,-1.0,1.0
Sânnicolau Mare,stirileprotv.ro,0,0,1,1,0.0,0.0
Camelia Luchian,www.comisarul.ro,0,0,1,1,0.0,0.0
Dăncilă,www.comisarul.ro,0,0,1,1,0.0,0.0
Petre Daea,www.comisarul.ro,0,0,1,1,0.0,0.0
Belgia,www.luju.ro,0,0,1,1,0.0,0.0
Irlanda,www.luju.ro,0,0,1,1,0.0,0.0
Italia,www.luju.ro,0,0,1,1,0.0,0.0
Malta,www.luju.ro,0,0,1,1,0.0,0.0
Moagher,www.luju.ro,0,0,1,1,0.0,0.0
Ungaria,www.luju.ro,0,0,1,1,0.0,0.0
Mircea Toma,www.cotidianul.ro,0,0,1,1,0.0,0.0
Toma,www.cotidianul.ro,0,0,1,1,0.0,0.0
subsecretar,www.euronews.ro,0,0,1,1,0.0,0.0
Davao,www.aktual24.ro,0,0,1,1,0.0,0.0
Davao City,www.aktual24.ro,0,0,1,1,0.0,0.0
Duterte,www.aktual24.ro,0,0,2,2,0.0,0.0
Ederson Tapia,www.aktual24.ro,0,0,1,1,0.0,0.0
Filipine,www.aktual24.ro,0,1,1,2,-0.5,0.5
Haga,www.aktual24.ro,0,0,2,2,0.0,0.0
Jean Franco,www.aktual24.ro,0,0,1,1,0.0,0.0
Karlo Nograles,www.aktual24.ro,0,0,1,1,0.0,0.0
Marcos,www.aktual24.ro,0,1,0,1,-1.0,1.0
Rodrigo Duterte,www.aktual24.ro,0,0,1,1,0.0,0.0
Sara Duterte,www.aktual24.ro,1,0,1,2,0.5,0.5
Sebastian,www.aktual24.ro,0,0,1,1,0.0,0.0
congresman,www.aktual24.ro,0,0,1,1,0.0,0.0
o,www.aktual24.ro,0,0,1,1,0.0,0.0
Ferdinand Marcos Jr,www.aktual24.ro,0,0,1,1,0.0,0.0
secretar de cabinet,www.aktual24.ro,0,0,1,1,0.0,0.0
Luduș,www.antena3.ro,1,0,0,1,1.0,1.0
Mureș,www.antena3.ro,0,0,1,1,0.0,0.0
fermier,www.antena3.ro,0,0,1,1,0.0,0.0
investitor,www.antena3.ro,1,0,0,1,1.0,1.0
producător,www.antena3.ro,1,0,0,1,1.0,1.0
Bacău,agerpres.ro,0,0,2,2,0.0,0.0
Buhuși,agerpres.ro,0,0,1,1,0.0,0.0
Comănești,agerpres.ro,0,0,1,1,0.0,0.0
Dărmănești,agerpres.ro,0,0,1,1,0.0,0.0
Lucian Daniel Stanciu Viziteu,agerpres.ro,0,0,1,1,0.0,0.0
Moinești,agerpres.ro,0,0,1,1,0.0,0.0
Onești,agerpres.ro,0,0,1,1,0.0,0.0
Slănic Moldova,agerpres.ro,0,0,1,1,0.0,0.0
Târgu Ocna,agerpres.ro,0,0,1,1,0.0,0.0
Ristea Priboi,adevarul.ro,0,2,0,2,-1.0,1.0
Marius Oprea,adevarul.ro,0,1,1,2,-0.5,0.5
Radu F. Alexandru,adevarul.ro,0,2,0,2,-1.0,1.0
Werner Sommerauer,adevarul.ro,0,0,1,1,0.0,0.0
domnul Sommerauer,adevarul.ro,0,0,1,1,0.0,0.0
Sommerauer,adevarul.ro,0,0,1,1,0.0,0.0
Tanase Joita,adevarul.ro,0,1,0,1,-1.0,1.0
Lungu,www.romaniatv.net,0,0,1,1,0.0,0.0
guvern,www.romaniatv.net,0,1,0,1,-1.0,1.0
Francis Doboș,www.digi24.ro,0,0,1,1,0.0,0.0
Francisc Doboș,www.digi24.ro,0,0,1,1,0.0,0.0
moderator,www.digi24.ro,0,1,0,1,-1.0,1.0
Vasile Bănescu,www.digi24.ro,0,0,2,2,0.0,0.0
Ardealul,pressone.ro,1,0,0,1,1.0,1.0
Constantinopol,pressone.ro,0,0,1,1,0.0,0.0
Ecaterina Teodoroiu,pressone.ro,0,0,1,1,0.0,0.0
Elisabeta Rizea,pressone.ro,0,0,1,1,0.0,0.0
Geneva,pressone.ro,0,0,2,2,0.0,0.0
Hillary Clinton,pressone.ro,0,1,0,1,-1.0,1.0
Joe Biden,pressone.ro,0,1,0,1,-1.0,1.0
Smaranda Brăescu,pressone.ro,0,0,1,1,0.0,0.0
designer,pressone.ro,0,1,0,1,-1.0,1.0
infanterist,pressone.ro,0,1,0,1,-1.0,1.0
mai,pressone.ro,0,1,0,1,-1.0,1.0
nevastă,pressone.ro,0,1,0,1,-1.0,1.0
Marius Pieleanu,pressone.ro,0,0,1,1,0.0,0.0
Andrzej Duda,primanews.ro,0,1,1,2,-0.5,0.5
Anna Urbanska,primanews.ro,0,0,1,1,0.0,0.0
Hubert Michalowski,primanews.ro,0,0,1,1,0.0,0.0
Małgorzata Mikoszewska,primanews.ro,1,0,0,1,1.0,1.0
Mentzen,primanews.ro,0,1,0,1,-1.0,1.0
Nawrocki,primanews.ro,0,1,1,2,-0.5,0.5
Radoslaw Wiecek,primanews.ro,0,1,0,1,-1.0,1.0
Trzaskowski,primanews.ro,1,0,1,2,0.5,0.5
apărător,primanews.ro,0,1,0,1,-1.0,1.0
om de afaceri,primanews.ro,0,1,0,1,-1.0,1.0
pensionară,primanews.ro,0,1,0,1,-1.0,1.0
Metsola,agerpres.ro,1,0,0,1,1.0,1.0
Budapesta,stirileprotv.ro,0,0,1,1,0.0,0.0
Cristian Pârvulescu,stirileprotv.ro,0,0,1,1,0.0,0.0
Pârvulescu,stirileprotv.ro,0,0,1,1,0.0,0.0
Viktor Orban,stirileprotv.ro,0,1,0,1,-1.0,1.0
consultant,stirileprotv.ro,0,1,0,1,-1.0,1.0
politolog,stirileprotv.ro,0,0,1,1,0.0,0.0
Cei,primanews.ro,0,0,1,1,0.0,0.0
Elon Musk,primanews.ro,0,1,1,2,-0.5,0.5
Emiratele Arabe Unite,primanews.ro,0,0,2,2,0.0,0.0
patron,primanews.ro,0,1,0,1,-1.0,1.0
Buldog,www.cotidianul.ro,0,0,1,1,0.0,0.0
Căuaș,www.cotidianul.ro,0,0,1,1,0.0,0.0
Familia Cozma,www.cotidianul.ro,0,1,0,1,-1.0,1.0
Florin Roman,www.cotidianul.ro,0,0,1,1,0.0,0.0
Marcel Vela,www.cotidianul.ro,0,0,1,1,0.0,0.0
Nicoleta Dobrescu,www.cotidianul.ro,0,1,0,1,-1.0,1.0
Pataki Csaba,www.cotidianul.ro,0,0,1,1,0.0,0.0
Portugalia,www.cotidianul.ro,0,0,1,1,0.0,0.0
Romeo Pop,www.cotidianul.ro,0,1,0,1,-1.0,1.0
Satu,www.cotidianul.ro,0,1,0,1,-1.0,1.0
Socond,www.cotidianul.ro,0,0,1,1,0.0,0.0
Târna Mare,www.cotidianul.ro,0,0,1,1,0.0,0.0
Tășnad,www.cotidianul.ro,0,0,1,1,0.0,0.0
Valer Beșeni,www.cotidianul.ro,0,1,0,1,-1.0,1.0
Vetiș,www.cotidianul.ro,0,0,1,1,0.0,0.0
contestatar,www.cotidianul.ro,0,1,0,1,-1.0,1.0
contrabandist,www.cotidianul.ro,0,1,0,1,-1.0,1.0
copreședinte,www.cotidianul.ro,0,1,0,1,-1.0,1.0
cățeluș,www.cotidianul.ro,0,1,0,1,-1.0,1.0
decan,www.cotidianul.ro,0,0,1,1,0.0,0.0
fan,www.cotidianul.ro,0,1,0,1,-1.0,1.0
fin,www.cotidianul.ro,0,1,0,1,-1.0,1.0
idiot,www.cotidianul.ro,0,1,0,1,-1.0,1.0
june Cozma,www.cotidianul.ro,0,1,0,1,-1.0,1.0
mamă,www.cotidianul.ro,0,0,2,2,0.0,0.0
necunoscut,www.cotidianul.ro,0,1,0,1,-1.0,1.0
patrihot,www.cotidianul.ro,0,1,0,1,-1.0,1.0
prodecan,www.cotidianul.ro,0,0,1,1,0.0,0.0
protector,www.cotidianul.ro,0,1,0,1,-1.0,1.0
protejat,www.cotidianul.ro,0,1,0,1,-1.0,1.0
rudă,www.cotidianul.ro,0,2,0,2,-1.0,1.0
slugă,www.cotidianul.ro,0,1,0,1,-1.0,1.0
veteran,www.cotidianul.ro,0,1,0,1,-1.0,1.0
Galați,www.cotidianul.ro,0,0,2,2,0.0,0.0
Giurgiulești,www.cotidianul.ro,0,0,1,1,0.0,0.0
Londra,www.cotidianul.ro,0,0,1,1,0.0,0.0
Principatul Andorra,www.cotidianul.ro,0,0,1,1,0.0,0.0
Regatul Unit al Marii Britanii,www.cotidianul.ro,0,0,1,1,0.0,0.0
Adrian Tănase,agerpres.ro,0,0,1,1,0.0,0.0
Adriana Strinu,agerpres.ro,0,0,1,1,0.0,0.0
Alina Matei,agerpres.ro,0,0,1,1,0.0,0.0
Andreea Armeanu,agerpres.ro,0,0,1,1,0.0,0.0
Andrei Codreanu,agerpres.ro,0,0,1,1,0.0,0.0
Andrei Daniel Gheorghe,agerpres.ro,0,0,1,1,0.0,0.0
Andrei Mozara,agerpres.ro,0,0,1,1,0.0,0.0
Antoaneta Iulia Preda,agerpres.ro,0,0,1,1,0.0,0.0
Argentina Traicu,agerpres.ro,0,0,1,1,0.0,0.0
Aurelian Cătălin Răducanu,agerpres.ro,0,0,1,1,0.0,0.0
Bogdan Enescu,agerpres.ro,0,0,1,1,0.0,0.0
Bogdan Rolea,agerpres.ro,0,0,1,1,0.0,0.0
Bogdan Toader,agerpres.ro,0,0,1,1,0.0,0.0
Carmen Gabriela Ciorbaru,agerpres.ro,0,0,1,1,0.0,0.0
Ciprian Relu Necula,agerpres.ro,0,0,1,1,0.0,0.0
Costel Cristian Tătuță,agerpres.ro,0,0,1,1,0.0,0.0
Costel Călin,agerpres.ro,0,0,1,1,0.0,0.0
Cristian Sorin Dumitrescu,agerpres.ro,0,0,1,1,0.0,0.0
Cristian Stamate,agerpres.ro,0,0,1,1,0.0,0.0
Cristian Tosun,agerpres.ro,0,0,1,1,0.0,0.0
Cristian Voinescu,agerpres.ro,0,0,1,1,0.0,0.0
Cristina Manuela Ungureanu,agerpres.ro,0,0,1,1,0.0,0.0
Daniel Florin,agerpres.ro,0,0,1,1,0.0,0.0
Daniel Ghiță,agerpres.ro,0,0,1,1,0.0,0.0
Daniel Robert Ghiță,agerpres.ro,0,0,1,1,0.0,0.0
Daniela Moraru,agerpres.ro,0,0,1,1,0.0,0.0
Denisa Mirela Tudose,agerpres.ro,0,0,1,1,0.0,0.0
Diana Beatrice Voicu,agerpres.ro,0,0,1,1,0.0,0.0
Diana Florentina Caburgan,agerpres.ro,0,0,1,1,0.0,0.0
Dinu Stratulat,agerpres.ro,0,0,1,1,0.0,0.0
Dorin Răzvan Dochiță,agerpres.ro,0,0,1,1,0.0,0.0
Dorina Maria Cojocaru,agerpres.ro,0,0,1,1,0.0,0.0
Doru Vasile,agerpres.ro,0,0,1,1,0.0,0.0
Dragoș Orheanu,agerpres.ro,0,0,1,1,0.0,0.0
Dumitru Văduva,agerpres.ro,0,0,1,1,0.0,0.0
Dănuț Angelo Trifu,agerpres.ro,0,0,1,1,0.0,0.0
Eduard Hellvig,agerpres.ro,0,0,1,1,0.0,0.0
Elena Enache,agerpres.ro,0,0,1,1,0.0,0.0
Elena Gherghescu,agerpres.ro,0,0,1,1,0.0,0.0
Elena Loredana Florescu,agerpres.ro,0,0,1,1,0.0,0.0
Emanuel Claudiu Păun,agerpres.ro,0,0,1,1,0.0,0.0
Fazakas Ernest,agerpres.ro,0,0,1,1,0.0,0.0
Felicia Tănase,agerpres.ro,0,0,1,1,0.0,0.0
Florentina Dumitrașcu,agerpres.ro,0,0,1,1,0.0,0.0
Florentina Maghiari,agerpres.ro,0,0,1,1,0.0,0.0
Florin Deaconeasa,agerpres.ro,0,0,1,1,0.0,0.0
Florin Mușat,agerpres.ro,0,0,1,1,0.0,0.0
Gabriel Sterea,agerpres.ro,0,0,1,1,0.0,0.0
Gabriel Strinu,agerpres.ro,0,0,1,1,0.0,0.0
Gabriela Dăscălița,agerpres.ro,0,0,1,1,0.0,0.0
George Adrian Brătulescu,agerpres.ro,0,0,1,1,0.0,0.0
George Liviu Coman,agerpres.ro,0,0,1,1,0.0,0.0
Georgeta Țărigradeanu,agerpres.ro,0,0,1,1,0.0,0.0
Georgiana Bogasievici,agerpres.ro,0,0,1,1,0.0,0.0
Georgiana Stoichiciu,agerpres.ro,0,0,1,1,0.0,0.0
Gheorghe Bolintineanu,agerpres.ro,0,0,1,1,0.0,0.0
Gheorghe Fițion,agerpres.ro,0,0,1,1,0.0,0.0
Gheorghe Valentino,agerpres.ro,0,0,1,1,0.0,0.0
Gianina Șerban,agerpres.ro,0,0,1,1,0.0,0.0
Gilda Maria Dincă,agerpres.ro,0,0,1,1,0.0,0.0
Ileana Ruxandra Badea,agerpres.ro,0,0,1,1,0.0,0.0
Ilfov,agerpres.ro,0,0,1,1,0.0,0.0
Ilfovul,agerpres.ro,0,0,1,1,0.0,0.0
Ioan Moț,agerpres.ro,0,0,1,1,0.0,0.0
Ioan Gabor,agerpres.ro,0,0,1,1,0.0,0.0
Ioan Vulpescu,agerpres.ro,0,0,1,1,0.0,0.0
Ioana Popescu,agerpres.ro,0,0,1,1,0.0,0.0
Ion Cătălin Bărăgan,agerpres.ro,0,0,1,1,0.0,0.0
Ionel Iliescu,agerpres.ro,0,0,1,1,0.0,0.0
Ionuț Nidelcu,agerpres.ro,0,0,1,1,0.0,0.0
Iuliana Dinu,agerpres.ro,0,0,1,1,0.0,0.0
Jenica Constantin,agerpres.ro,0,0,1,1,0.0,0.0
Kanaan Ahmad,agerpres.ro,0,0,1,1,0.0,0.0
Kis Timea,agerpres.ro,0,0,1,1,0.0,0.0
Kozma Andrei,agerpres.ro,0,0,1,1,0.0,0.0
Lavinia-Germina Radu,agerpres.ro,0,0,1,1,0.0,0.0
Lucia Maria Udrescu,agerpres.ro,0,0,1,1,0.0,0.0
Magdalena Calminschi,agerpres.ro,0,0,1,1,0.0,0.0
Maria Emilia Lungu,agerpres.ro,0,0,1,1,0.0,0.0
Marian Văduva,agerpres.ro,0,0,1,1,0.0,0.0
Marilena Barabaș,agerpres.ro,0,0,1,1,0.0,0.0
Marinela Culea,agerpres.ro,0,0,1,1,0.0,0.0
Marinella Turdean,agerpres.ro,0,0,1,1,0.0,0.0
Marius Mușeanu,agerpres.ro,0,0,1,1,0.0,0.0
Mihaela Adela Chiper,agerpres.ro,0,0,1,1,0.0,0.0
Mihaela Hurmuzachi Vasiliev,agerpres.ro,0,0,1,1,0.0,0.0
Mihai Alexandru Peșa,agerpres.ro,0,0,1,1,0.0,0.0
Nicoleta Ofelia Baciu,agerpres.ro,0,0,1,1,0.0,0.0
Petre Spîrleanu,agerpres.ro,0,0,1,1,0.0,0.0
Petrică Polifron,agerpres.ro,0,0,1,1,0.0,0.0
Ramon Alin Luca,agerpres.ro,0,0,1,1,0.0,0.0
Remus Mîndru,agerpres.ro,0,0,1,1,0.0,0.0
Rica Marin,agerpres.ro,0,0,1,1,0.0,0.0
Sergiu Lucian Matei,agerpres.ro,0,0,1,1,0.0,0.0
Silvia Elena Stoica,agerpres.ro,0,0,1,1,0.0,0.0
Smărăndița Zamfir,agerpres.ro,0,0,1,1,0.0,0.0
Zoltan Somodi,agerpres.ro,0,0,1,1,0.0,0.0
Sorinel Voinea,agerpres.ro,0,0,1,1,0.0,0.0
Szele Emese,agerpres.ro,0,0,1,1,0.0,0.0
Szolomajer Bence,agerpres.ro,0,0,1,1,0.0,0.0
Teodor Iulian Pavel,agerpres.ro,0,0,1,1,0.0,0.0
Tudor Florian Ivan,agerpres.ro,0,0,1,1,0.0,0.0
Tăriceanu,agerpres.ro,0,0,1,1,0.0,0.0
Valentin Dunei,agerpres.ro,0,0,1,1,0.0,0.0
Valentin Puiu Grecu,agerpres.ro,0,0,1,1,0.0,0.0
Valentin Scîntee,agerpres.ro,0,0,1,1,0.0,0.0
Varujan Vosganian,agerpres.ro,0,0,2,2,0.0,0.0
Vasile Valentin Vornicu,agerpres.ro,0,0,1,1,0.0,0.0
Victor Racolța,agerpres.ro,0,0,1,1,0.0,0.0
Victoria Buruncenco,agerpres.ro,0,0,1,1,0.0,0.0
Violeta Tudorie,agerpres.ro,0,0,1,1,0.0,0.0
Virginia Sorescu,agerpres.ro,0,0,1,1,0.0,0.0
agent,agerpres.ro,0,0,1,1,0.0,0.0
antreprenor,agerpres.ro,0,0,1,1,0.0,0.0
arhitect,agerpres.ro,0,0,1,1,0.0,0.0
asistent medical,agerpres.ro,0,0,1,1,0.0,0.0
avocat,agerpres.ro,0,0,1,1,0.0,0.0
biolog,agerpres.ro,0,0,1,1,0.0,0.0
consultant,agerpres.ro,0,0,1,1,0.0,0.0
contabil,agerpres.ro,0,0,1,1,0.0,0.0
dispecer,agerpres.ro,0,0,1,1,0.0,0.0
electronist,agerpres.ro,0,0,1,1,0.0,0.0
evaluator,agerpres.ro,0,0,1,1,0.0,0.0
expert contabil,agerpres.ro,0,0,1,1,0.0,0.0
farmacist,agerpres.ro,0,0,1,1,0.0,0.0
filolog,agerpres.ro,0,0,1,1,0.0,0.0
fizician,agerpres.ro,0,0,1,1,0.0,0.0
informatician,agerpres.ro,0,0,1,1,0.0,0.0
inginer,agerpres.ro,0,0,1,1,0.0,0.0
inginer TCM,agerpres.ro,0,0,1,1,0.0,0.0
inginer electronist,agerpres.ro,0,0,1,1,0.0,0.0
inginer mecanic,agerpres.ro,0,0,1,1,0.0,0.0
inspector,agerpres.ro,0,0,1,1,0.0,0.0
jurist,agerpres.ro,0,0,1,1,0.0,0.0
lucrător,agerpres.ro,0,0,1,1,0.0,0.0
manager,agerpres.ro,0,0,1,1,0.0,0.0
medic stomatolog,agerpres.ro,0,0,1,1,0.0,0.0
ospătar,agerpres.ro,0,0,1,1,0.0,0.0
pensionară,agerpres.ro,0,0,1,1,0.0,0.0
referent,agerpres.ro,0,0,1,1,0.0,0.0
registrator,agerpres.ro,0,0,1,1,0.0,0.0
regizor,agerpres.ro,0,0,1,1,0.0,0.0
sociolog,agerpres.ro,0,0,1,1,0.0,0.0
specialist,agerpres.ro,0,0,1,1,0.0,0.0
tehnician,agerpres.ro,0,0,1,1,0.0,0.0
trainer,agerpres.ro,0,0,1,1,0.0,0.0
îngrijitoare,agerpres.ro,0,0,1,1,0.0,0.0
Ștefan Alexandru Velicu,agerpres.ro,0,0,1,1,0.0,0.0
Ștefan Hortea,agerpres.ro,0,0,1,1,0.0,0.0
Ștefana Voicu,agerpres.ro,0,0,1,1,0.0,0.0
Marcel Boloș,www.b1tv.ro,0,0,3,3,0.0,0.0
Boloș,www.b1tv.ro,0,1,0,1,-1.0,1.0
oficial,www.b1tv.ro,0,0,1,1,0.0,0.0
Alexey Navalny,snoop.ro,0,0,1,1,0.0,0.0
Andrey Pokrovsky,snoop.ro,0,0,1,1,0.0,0.0
Anton Shekhovtsov,snoop.ro,0,0,1,1,0.0,0.0
Atașat,snoop.ro,0,0,1,1,0.0,0.0
Așhabad,snoop.ro,0,0,1,1,0.0,0.0
Chile,snoop.ro,0,0,1,1,0.0,0.0
Dancho Danchev,snoop.ro,0,0,1,1,0.0,0.0
Dragoș Stanca,snoop.ro,1,0,0,1,1.0,1.0
Dresda,snoop.ro,0,0,1,1,0.0,0.0
Eduard Chernovoltsev,snoop.ro,0,1,0,1,-1.0,1.0
Evaline Sophie Joubert,snoop.ro,0,0,1,1,0.0,0.0
Fesenko,snoop.ro,0,0,2,2,0.0,0.0
George Blake,snoop.ro,0,1,0,1,-1.0,1.0
georgian,snoop.ro,0,0,1,1,0.0,0.0
Georgianul Abuladze,snoop.ro,0,0,1,1,0.0,0.0
Ghana,snoop.ro,0,0,1,1,0.0,0.0
Ionel Bour,snoop.ro,0,0,1,1,0.0,0.0
Ivanov,snoop.ro,0,1,0,1,-1.0,1.0
Kiev,snoop.ro,0,0,1,1,0.0,0.0
Kolesov,snoop.ro,0,0,1,1,0.0,0.0
Lennoi,snoop.ro,0,0,1,1,0.0,0.0
Liberia,snoop.ro,0,0,1,1,0.0,0.0
Liliya,snoop.ro,0,0,1,1,0.0,0.0
Liliya Kamileyvna,snoop.ro,0,0,1,1,0.0,0.0
Maksim Pokrovskay,snoop.ro,0,0,1,1,0.0,0.0
Maksim Pokrovsky,snoop.ro,0,0,1,1,0.0,0.0
Marele,snoop.ro,0,1,0,1,-1.0,1.0
Metodi Ivanov,snoop.ro,0,1,0,1,-1.0,1.0
Metodi Radkov Ivanov,snoop.ro,0,0,1,1,0.0,0.0
Mikhail Kolesov,snoop.ro,0,0,1,1,0.0,0.0
Mikhail Kulemin,snoop.ro,0,0,1,1,0.0,0.0
Mikhail Lennoi,snoop.ro,0,0,1,1,0.0,0.0
Novosibirsk,snoop.ro,0,0,1,1,0.0,0.0
Peru,snoop.ro,0,0,1,1,0.0,0.0
Petko Petkov,snoop.ro,0,0,1,1,0.0,0.0
Petkov,snoop.ro,0,0,1,1,0.0,0.0
Plovdiv,snoop.ro,0,0,1,1,0.0,0.0
Pokrovsky,snoop.ro,0,0,1,1,0.0,0.0
Rus,snoop.ro,0,0,1,1,0.0,0.0
Sandra Gina Esparon,snoop.ro,0,0,1,1,0.0,0.0
Sergei Skripal,snoop.ro,0,0,1,1,0.0,0.0
Stanca,snoop.ro,0,0,1,1,0.0,0.0
Steven Seagal,snoop.ro,0,1,0,1,-1.0,1.0
Tudorel,snoop.ro,0,0,1,1,0.0,0.0
Turkmenistan,snoop.ro,0,1,1,2,-0.5,0.5
Uniunea Sovietică,snoop.ro,0,1,0,1,-1.0,1.0
Valeriu Pasat,snoop.ro,0,1,0,1,-1.0,1.0
Victima Tudorel,snoop.ro,0,0,1,1,0.0,0.0
Vitalii Sizov,snoop.ro,0,0,1,1,0.0,0.0
Vladimir Fesenko,snoop.ro,0,0,1,1,0.0,0.0
Yulia Serebrianskaya,snoop.ro,0,0,1,1,0.0,0.0
advertiser,snoop.ro,0,0,1,1,0.0,0.0
asasin,snoop.ro,0,1,0,1,-1.0,1.0
celebritate,snoop.ro,0,1,0,1,-1.0,1.0
conte,snoop.ro,0,0,1,1,0.0,0.0
gospodar,snoop.ro,2,0,0,2,1.0,1.0
Anatoly Karpov,snoop.ro,0,0,1,1,0.0,0.0
mana,snoop.ro,0,1,0,1,-1.0,1.0
miliardar,snoop.ro,0,1,0,1,-1.0,1.0
patriot,snoop.ro,1,0,0,1,1.0,1.0
spion,snoop.ro,0,1,0,1,-1.0,1.0
Vlad Petreanu,adevarul.ro,0,0,2,2,0.0,0.0
Adrian Severin,www.realitatea.net,0,0,1,1,0.0,0.0
Elon Musk,www.romaniatv.net,1,0,1,2,0.5,0.5
Musk,www.romaniatv.net,1,0,0,1,1.0,1.0
influencerului Mario Nawfal,www.romaniatv.net,0,0,1,1,0.0,0.0
Argentinei,adevarul.ro,0,0,1,1,0.0,0.0
Caraș Severin,adevarul.ro,0,0,1,1,0.0,0.0
Ion Ioniță,adevarul.ro,0,0,1,1,0.0,0.0
Javier Milei,adevarul.ro,0,0,1,1,0.0,0.0
Lajos Kossuth,adevarul.ro,0,0,1,1,0.0,0.0
Mateusz Morawiecki,adevarul.ro,0,0,1,1,0.0,0.0
Ion Solcanu,adevarul.ro,0,0,1,1,0.0,0.0
Solcanu,adevarul.ro,0,0,1,1,0.0,0.0
Adrian Păunescu,www.mediafax.ro,0,0,1,1,0.0,0.0
David,www.mediafax.ro,0,0,1,1,0.0,0.0
Frunda Gyorgy,www.mediafax.ro,0,1,0,1,-1.0,1.0
Marko Bela,www.mediafax.ro,0,1,2,3,-0.3333333333333333,0.3333333333333333
Sogor Csaba,www.mediafax.ro,0,0,1,1,0.0,0.0
Codrin Ștefănescu,a1.ro,0,0,2,2,0.0,0.0
Cîțu,a1.ro,0,2,0,2,-1.0,1.0
Dan Barna,a1.ro,0,0,1,1,0.0,0.0
Dumitru Stepănescu,a1.ro,0,0,1,1,0.0,0.0
Dumitru Ursu,a1.ro,0,0,1,1,0.0,0.0
Fârliug,a1.ro,0,0,1,1,0.0,0.0
Ioan Borduz,a1.ro,0,0,1,1,0.0,0.0
Luminița Jivan,a1.ro,0,0,1,1,0.0,0.0
Marius Cornici,a1.ro,0,0,1,1,0.0,0.0
Oravița,a1.ro,0,0,1,1,0.0,0.0
Petru Fara,a1.ro,0,0,1,1,0.0,0.0
Târnova,a1.ro,0,0,1,1,0.0,0.0
Zaharia Șandru,a1.ro,0,0,1,1,0.0,0.0
inspector școlar,a1.ro,0,0,1,1,0.0,0.0
Laura Sgaverdea,a1.ro,0,0,1,1,0.0,0.0
Ioan Chisăliță,a1.ro,0,1,0,1,-1.0,1.0
Dragoș Pâslaru,www.mediafax.ro,0,0,1,1,0.0,0.0
Mirabela Amarandei,www.mediafax.ro,0,0,1,1,0.0,0.0
Alexandru Ioan Cuza,www.luju.ro,1,0,0,1,1.0,1.0
Malin Bot,www.luju.ro,0,1,0,1,-1.0,1.0
Marian Ceaușescu,www.luju.ro,0,1,0,1,-1.0,1.0
Vrancea,www.luju.ro,1,0,0,1,1.0,1.0
afacere,www.luju.ro,1,0,0,1,1.0,1.0
agricultor,www.luju.ro,0,0,1,1,0.0,0.0
arhitect,www.luju.ro,0,1,0,1,-1.0,1.0
bunică,www.luju.ro,1,0,0,1,1.0,1.0
chelner,www.luju.ro,0,1,0,1,-1.0,1.0
constructor,www.luju.ro,0,1,0,1,-1.0,1.0
contabil,www.luju.ro,0,1,0,1,-1.0,1.0
Dănuț Daraban,www.luju.ro,0,0,1,1,0.0,0.0
energetician,www.luju.ro,0,1,0,1,-1.0,1.0
investitor,www.luju.ro,0,1,0,1,-1.0,1.0
medic,www.luju.ro,0,0,1,1,0.0,0.0
pompier,www.luju.ro,0,0,1,1,0.0,0.0
reformator,www.luju.ro,1,0,0,1,1.0,1.0
Bogdan Peșchir,www.gandul.ro,0,1,0,1,-1.0,1.0
Peșchir,www.gandul.ro,0,1,0,1,-1.0,1.0
Constantin Toma,primanews.ro,0,0,1,1,0.0,0.0
Adrian Zuckerman,www.antena3.ro,0,0,2,2,0.0,0.0
Mike Pence,www.antena3.ro,0,0,1,1,0.0,0.0
mogul,www.antena3.ro,0,1,0,1,-1.0,1.0
muritor,www.antena3.ro,0,1,0,1,-1.0,1.0
Florin Zamfirescu,www.antena3.ro,0,0,4,4,0.0,0.0
Zamfirescu,www.antena3.ro,0,0,1,1,0.0,0.0
cunoscător,primanews.ro,0,0,1,1,0.0,0.0
Vlad Zaha,adevarul.ro,0,0,1,1,0.0,0.0
Daniel Tudorache,www.gandul.ro,0,2,2,4,-0.5,0.5
Becali,primanews.ro,0,0,2,2,0.0,0.0
Cătălin Teniță,www.g4media.ro,0,0,2,2,0.0,0.0
George Tuță,www.g4media.ro,0,0,1,1,0.0,0.0
Rareș Hopincă,www.g4media.ro,0,0,1,1,0.0,0.0
Bucureștean,www.g4media.ro,0,0,1,1,0.0,0.0
consilier general,www.g4media.ro,0,0,4,4,0.0,0.0
nominalizare,www.g4media.ro,0,0,1,1,0.0,0.0
înlocuitor,www.g4media.ro,0,2,0,2,-1.0,1.0
Diaconescu,stirileprotv.ro,0,0,1,1,0.0,0.0
Johannes Hahn,stirileprotv.ro,0,0,1,1,0.0,0.0
Alexandru Cristian Popa,www.romaniatv.net,0,0,1,1,0.0,0.0
Bia,www.romaniatv.net,1,0,0,1,1.0,1.0
Bianca Eugenia Gavrilă,www.romaniatv.net,0,0,1,1,0.0,0.0
Cristi,www.romaniatv.net,1,0,0,1,1.0,1.0
Donca,www.romaniatv.net,0,1,0,1,-1.0,1.0
soră,www.romaniatv.net,1,0,1,2,0.5,0.5
ce,www.romaniatv.net,0,0,1,1,0.0,0.0
manager,www.romaniatv.net,0,0,3,3,0.0,0.0
rude,www.romaniatv.net,0,0,1,1,0.0,0.0
suroră,www.romaniatv.net,1,0,0,1,1.0,1.0
Bogdan Buta,recorder.ro,0,1,1,2,-0.5,0.5
Ungarie,recorder.ro,0,1,0,1,-1.0,1.0
comandant militar,recorder.ro,0,1,0,1,-1.0,1.0
cumnat,recorder.ro,0,0,1,1,0.0,0.0
soră,recorder.ro,0,0,1,1,0.0,0.0
Ionuț Luțu,www.comisarul.ro,0,0,1,1,0.0,0.0
Luțu,www.comisarul.ro,0,0,1,1,0.0,0.0
fete,www.comisarul.ro,0,0,1,1,0.0,0.0
păgub,www.comisarul.ro,0,1,0,1,-1.0,1.0
Eugen Bejinariu,www.mediafax.ro,0,0,1,1,0.0,0.0
Gavril Mîrza,www.mediafax.ro,0,2,0,2,-1.0,1.0
Gheorghe Flutur,www.mediafax.ro,0,2,0,2,-1.0,1.0
Mârza,www.mediafax.ro,0,1,0,1,-1.0,1.0
Mîrza,www.mediafax.ro,0,1,0,1,-1.0,1.0
Onofrei,www.mediafax.ro,0,0,1,1,0.0,0.0
Albin Kurti,stirileprotv.ro,0,0,1,1,0.0,0.0
Banjska,stirileprotv.ro,0,1,0,1,-1.0,1.0
Camp,stirileprotv.ro,0,0,1,1,0.0,0.0
City,stirileprotv.ro,0,0,1,1,0.0,0.0
Clinton,stirileprotv.ro,0,0,1,1,0.0,0.0
David Lammy,stirileprotv.ro,0,0,1,1,0.0,0.0
Iran,stirileprotv.ro,0,0,1,1,0.0,0.0
Iugoslavia,stirileprotv.ro,0,1,0,1,-1.0,1.0
Jared Kushner,stirileprotv.ro,0,0,1,1,0.0,0.0
Kosovo,stirileprotv.ro,0,0,1,1,0.0,0.0
Lammy,stirileprotv.ro,0,0,1,1,0.0,0.0
Madeleine,stirileprotv.ro,0,0,1,1,0.0,0.0
Milorad Dodik,stirileprotv.ro,0,1,0,1,-1.0,1.0
Novi Sad,stirileprotv.ro,0,0,1,1,0.0,0.0
Osmani,stirileprotv.ro,0,0,1,1,0.0,0.0
Pristina,stirileprotv.ro,0,0,1,1,0.0,0.0
Vladimir Putin,stirileprotv.ro,0,2,0,2,-1.0,1.0
Serbia,stirileprotv.ro,0,1,0,1,-1.0,1.0
soldat,stirileprotv.ro,0,0,1,1,0.0,0.0
Srebrenica,stirileprotv.ro,0,1,0,1,-1.0,1.0
student,stirileprotv.ro,0,0,3,3,0.0,0.0
Tonibler,stirileprotv.ro,0,0,1,1,0.0,0.0
Tony Blair,stirileprotv.ro,0,1,0,1,-1.0,1.0
Vjosa Osmani,stirileprotv.ro,0,1,0,1,-1.0,1.0
Vučić,stirileprotv.ro,0,1,0,1,-1.0,1.0
atacator,stirileprotv.ro,0,1,0,1,-1.0,1.0
demonstrant,stirileprotv.ro,0,1,0,1,-1.0,1.0
familia Trump,stirileprotv.ro,0,1,0,1,-1.0,1.0
ginere,stirileprotv.ro,0,1,0,1,-1.0,1.0
personalitate,stirileprotv.ro,0,0,1,1,0.0,0.0
polițist,stirileprotv.ro,0,1,0,1,-1.0,1.0
Aleksandar Vučić,stirileprotv.ro,0,1,0,1,-1.0,1.0
Augustin Zegrean,www.antena3.ro,0,0,2,2,0.0,0.0
Zegrean,www.antena3.ro,0,0,1,1,0.0,0.0
afacerist,primanews.ro,0,1,0,1,-1.0,1.0
semnatar,primanews.ro,0,0,1,1,0.0,0.0
Assad,primanews.ro,0,1,0,1,-1.0,1.0
Gaza,primanews.ro,0,0,1,1,0.0,0.0
Irak,primanews.ro,0,1,0,1,-1.0,1.0
MbS,primanews.ro,0,0,1,1,0.0,0.0
Riyadh,primanews.ro,0,0,1,1,0.0,0.0
Siria,primanews.ro,0,1,0,1,-1.0,1.0
a,primanews.ro,0,0,1,1,0.0,0.0
loialist,primanews.ro,0,1,0,1,-1.0,1.0
prinț moștenitor,primanews.ro,0,0,1,1,0.0,0.0
Andorra,recorder.ro,0,0,1,1,0.0,0.0
Antonio Costa,recorder.ro,0,0,1,1,0.0,0.0
Belgrad,recorder.ro,0,0,2,2,0.0,0.0
Canada,recorder.ro,0,0,2,2,0.0,0.0
Portugalia,recorder.ro,0,0,1,1,0.0,0.0
Regat,recorder.ro,0,0,1,1,0.0,0.0
Serbia,recorder.ro,0,0,2,2,0.0,0.0
Simona Bucura-Oprescu,recorder.ro,0,1,0,1,-1.0,1.0
Dolj,a1.ro,0,0,1,1,0.0,0.0
Segarcea,a1.ro,0,0,1,1,0.0,0.0
Andrei Salomia,adevarul.ro,0,0,1,1,0.0,0.0
Arhiepiscop,adevarul.ro,0,0,1,1,0.0,0.0
Bogdan Zsolt,adevarul.ro,0,0,2,2,0.0,0.0
Ciprian,adevarul.ro,0,0,1,1,0.0,0.0
Claudiu Nechita,adevarul.ro,0,0,1,1,0.0,0.0
Corina Macavei,adevarul.ro,0,0,1,1,0.0,0.0
Crasna,adevarul.ro,0,0,1,1,0.0,0.0
Criste,adevarul.ro,0,0,1,1,0.0,0.0
Cristina Stancu,adevarul.ro,0,0,1,1,0.0,0.0
Daniel Dancea,adevarul.ro,0,0,1,1,0.0,0.0
Dealul Floreni,adevarul.ro,1,0,0,1,1.0,1.0
Dinu Criste,adevarul.ro,0,0,2,2,0.0,0.0
Doba,adevarul.ro,0,0,1,1,0.0,0.0
Dobrin,adevarul.ro,0,0,1,1,0.0,0.0
Dorna Candrenilor,adevarul.ro,0,0,1,1,0.0,0.0
Dragoș Olteanu,adevarul.ro,0,0,2,2,0.0,0.0
Dugulescu,adevarul.ro,0,0,1,1,0.0,0.0
Dănuț Zuzeac,adevarul.ro,0,0,1,1,0.0,0.0
fetele,adevarul.ro,0,0,1,1,0.0,0.0
Florești,adevarul.ro,0,0,2,2,0.0,0.0
Florina Pop,adevarul.ro,0,0,1,1,0.0,0.0
Fălticene,adevarul.ro,0,0,1,1,0.0,0.0
Fălticeni,adevarul.ro,0,0,1,1,0.0,0.0
Gheorghe Aldea,adevarul.ro,0,0,1,1,0.0,0.0
Gheorghe Stoica,adevarul.ro,0,1,0,1,-1.0,1.0
Iulian Bunilă,adevarul.ro,0,1,0,1,-1.0,1.0
Laurențiu Streza,adevarul.ro,0,0,1,1,0.0,0.0
Liviu Mihăilă,adevarul.ro,0,0,5,5,0.0,0.0
Marius Dugulescu,adevarul.ro,0,0,1,1,0.0,0.0
Meseșenii de Jos,adevarul.ro,0,0,1,1,0.0,0.0
mitropolit,adevarul.ro,0,0,1,1,0.0,0.0
Negoiță,adevarul.ro,0,0,1,1,0.0,0.0
Năvodari,adevarul.ro,0,0,1,1,0.0,0.0
Orșova,adevarul.ro,0,0,1,1,0.0,0.0
Orșovei,adevarul.ro,0,0,1,1,0.0,0.0
Paul Negoiță,adevarul.ro,0,0,4,4,0.0,0.0
Preotul Negoiță,adevarul.ro,0,0,1,1,0.0,0.0
Sorin Doroftiese,adevarul.ro,0,0,4,4,0.0,0.0
Pârvu Roșu,adevarul.ro,0,1,0,1,-1.0,1.0
Părintele Nicolae Jinga,adevarul.ro,1,0,0,1,1.0,1.0
Simion Săsăujan,adevarul.ro,0,0,3,3,0.0,0.0
Ramona Găină,adevarul.ro,0,0,1,1,0.0,0.0
Seres Denes,adevarul.ro,0,0,1,1,0.0,0.0
Sorin Doroftie,adevarul.ro,0,0,1,1,0.0,0.0
Sînziana Ionescu,adevarul.ro,0,0,1,1,0.0,0.0
Tokes,adevarul.ro,0,1,0,1,-1.0,1.0
Verveghiu,adevarul.ro,0,0,1,1,0.0,0.0
Vârșolț,adevarul.ro,0,0,1,1,0.0,0.0
adult,adevarul.ro,0,0,1,1,0.0,0.0
blogger,adevarul.ro,0,0,1,1,0.0,0.0
cleric,adevarul.ro,0,1,1,2,-0.5,0.5
cler,adevarul.ro,0,0,1,1,0.0,0.0
cititor,adevarul.ro,0,0,2,2,0.0,0.0
cunoștință,adevarul.ro,0,0,1,1,0.0,0.0
Serban Deneș,adevarul.ro,0,0,1,1,0.0,0.0
Candrea Mafteiu,adevarul.ro,0,0,1,1,0.0,0.0
episcop,adevarul.ro,0,1,0,1,-1.0,1.0
fețe bisericească,adevarul.ro,0,1,0,1,-1.0,1.0
hoț,adevarul.ro,0,2,0,2,-1.0,1.0
ierarh,adevarul.ro,0,1,0,1,-1.0,1.0
mincinos,adevarul.ro,0,1,0,1,-1.0,1.0
minor,adevarul.ro,0,1,0,1,-1.0,1.0
Isidor Dâscă,adevarul.ro,1,0,0,1,1.0,1.0
pastor,adevarul.ro,0,0,1,1,0.0,0.0
Preot Emil Constantinescu,adevarul.ro,0,1,0,1,-1.0,1.0
Cornel Oprișan,adevarul.ro,0,0,1,1,0.0,0.0
Coșa,adevarul.ro,0,0,1,1,0.0,0.0
preotul Negoiță,adevarul.ro,0,0,1,1,0.0,0.0
Viorel Vlăducu,adevarul.ro,0,0,1,1,0.0,0.0
preotul Constantin Constantinescu,adevarul.ro,0,1,0,1,-1.0,1.0
Florea,adevarul.ro,0,1,0,1,-1.0,1.0
Constantin Tomozei,adevarul.ro,1,0,0,1,1.0,1.0
protopop Fazakas Csaba,adevarul.ro,0,0,1,1,0.0,0.0
Vasile Boșca,adevarul.ro,0,1,0,1,-1.0,1.0
pungaș,adevarul.ro,0,1,0,1,-1.0,1.0
Nicolae Jinga,adevarul.ro,1,0,0,1,1.0,1.0
Săsăujan,adevarul.ro,0,0,1,1,0.0,0.0
Ioan Coșa,adevarul.ro,0,0,1,1,0.0,0.0
superior,adevarul.ro,0,1,0,1,-1.0,1.0
Șincan,adevarul.ro,0,1,0,1,-1.0,1.0
Ștefan Borcea,adevarul.ro,0,0,1,1,0.0,0.0
Dănuț Iacob,www.digi24.ro,0,0,1,1,0.0,0.0
Gheorghe Nicolae,www.digi24.ro,0,0,1,1,0.0,0.0
Nelu Zarnica,www.digi24.ro,0,1,0,1,-1.0,1.0
Nicolae Pavel,www.digi24.ro,0,0,1,1,0.0,0.0
Nuțu Fonta,www.digi24.ro,0,0,1,1,0.0,0.0
Oprea,www.digi24.ro,0,1,0,1,-1.0,1.0
judecătoare,www.digi24.ro,0,0,1,1,0.0,0.0
Bogdan Gigină,www.digi24.ro,0,0,1,1,0.0,0.0
reservist,www.digi24.ro,0,0,1,1,0.0,0.0
Bolojani,www.activenews.ro,0,1,0,1,-1.0,1.0
Băsiști,www.activenews.ro,0,1,0,1,-1.0,1.0
Ciolaci,www.activenews.ro,0,1,0,1,-1.0,1.0
Grindeni,www.activenews.ro,0,1,0,1,-1.0,1.0
Johanniști,www.activenews.ro,0,1,0,1,-1.0,1.0
complic,www.activenews.ro,0,1,0,1,-1.0,1.0
cântăreț,www.activenews.ro,0,2,0,2,-1.0,1.0
proști,www.activenews.ro,0,1,0,1,-1.0,1.0
simpatizant,www.activenews.ro,0,1,1,2,-0.5,0.5
sportiv,www.activenews.ro,0,0,1,1,0.0,0.0
ea,www.mediafax.ro,0,2,0,2,-1.0,1.0
măicuță,www.mediafax.ro,0,1,0,1,-1.0,1.0
Buzău,www.cotidianul.ro,0,1,0,1,-1.0,1.0
Premierul,www.cotidianul.ro,0,1,0,1,-1.0,1.0
Mihai Tudose,a1.ro,0,0,1,1,0.0,0.0
Tudose,a1.ro,0,0,1,1,0.0,0.0
dușman,www.euronews.ro,0,1,0,1,-1.0,1.0
egal,www.euronews.ro,0,1,0,1,-1.0,1.0
Diaconescu,www.antena3.ro,0,0,1,1,0.0,0.0
Ialta,www.antena3.ro,0,1,0,1,-1.0,1.0
Deveselu,adevarul.ro,0,0,1,1,0.0,0.0
Andreea Câmpeanu,pressone.ro,0,0,1,1,0.0,0.0
Augsburg,pressone.ro,0,0,1,1,0.0,0.0
Brandenburg,pressone.ro,0,0,1,1,0.0,0.0
conservator,pressone.ro,0,1,0,1,-1.0,1.0
Greta Thunberg,pressone.ro,0,0,2,2,0.0,0.0
Hakan Bergqvist,pressone.ro,0,0,1,1,0.0,0.0
Harald Welzer,pressone.ro,0,1,0,1,-1.0,1.0
Michael Kuelbel,pressone.ro,0,1,0,1,-1.0,1.0
Pawel Zerka,pressone.ro,0,0,1,1,0.0,0.0
Philipp,pressone.ro,0,0,1,1,0.0,0.0
Philipp Fritz,pressone.ro,0,0,1,1,0.0,0.0
solicitant,pressone.ro,0,1,2,3,-0.3333333333333333,0.3333333333333333
Al Treilea Reich,pressone.ro,0,0,1,1,0.0,0.0
Trier,pressone.ro,0,0,1,1,0.0,0.0
Turingia,pressone.ro,0,0,1,1,0.0,0.0
Zerka,pressone.ro,0,0,1,1,0.0,0.0
Florin Romna,www.romaniatv.net,0,0,1,1,0.0,0.0
Vicepreședintele,www.romaniatv.net,0,0,2,2,0.0,0.0
N. Dan,www.comisarul.ro,0,1,0,1,-1.0,1.0
transgender,www.comisarul.ro,0,1,0,1,-1.0,1.0
păgubitor,www.news.ro,0,1,0,1,-1.0,1.0
Ștefan Pălărie,www.news.ro,0,0,2,2,0.0,0.0
Ion Oprișor,www.news.ro,0,0,1,1,0.0,0.0
Președintele,www.news.ro,0,0,2,2,0.0,0.0
Simona Livia Mafte,www.news.ro,0,0,1,1,0.0,0.0
Bogdan Mazuru,www.news.ro,0,0,2,2,0.0,0.0
consiler,www.news.ro,0,0,1,1,0.0,0.0
Ecaterina Andronescu,recorder.ro,0,0,2,2,0.0,0.0
Grenoble,recorder.ro,0,0,1,1,0.0,0.0
Ion Negrescu,recorder.ro,0,0,1,1,0.0,0.0
raportor,recorder.ro,0,0,2,2,0.0,0.0
chestor,recorder.ro,0,1,1,2,-0.5,0.5
consul,recorder.ro,0,0,1,1,0.0,0.0
negociator,recorder.ro,0,0,1,1,0.0,0.0
Cristinel Grosu,www.realitatea.net,0,0,1,1,0.0,0.0
hoț,www.realitatea.net,0,2,0,2,-1.0,1.0
patriot,www.realitatea.net,2,0,0,2,1.0,1.0
securist,www.realitatea.net,0,3,0,3,-1.0,1.0
Anghel Saligny,primanews.ro,1,0,0,1,1.0,1.0
Gheorghe Falcă,primanews.ro,1,0,0,1,1.0,1.0
Mickey Mouse,primanews.ro,0,0,1,1,0.0,0.0
Nicolae Ciolacu,primanews.ro,0,1,0,1,-1.0,1.0
Stănescu,primanews.ro,0,1,0,1,-1.0,1.0
comunitate,primanews.ro,1,0,0,1,1.0,1.0
familist,primanews.ro,1,0,0,1,1.0,1.0
nepot,primanews.ro,0,1,2,3,-0.3333333333333333,0.3333333333333333
patriot,primanews.ro,1,0,0,1,1.0,1.0
Cristian Țopescu,www.gandul.ro,0,0,1,1,0.0,0.0
Cristina Țopescu,www.gandul.ro,0,0,2,2,0.0,0.0
Marcel Vela,www.gandul.ro,0,0,1,1,0.0,0.0
Otopeni,www.gandul.ro,0,0,1,1,0.0,0.0
comentator sportiv,www.gandul.ro,0,0,1,1,0.0,0.0
prezentatoare,www.gandul.ro,0,1,0,1,-1.0,1.0
realizatoare,www.gandul.ro,0,1,0,1,-1.0,1.0
Borisov,www.mediafax.ro,0,1,0,1,-1.0,1.0
Borissov,www.mediafax.ro,0,0,1,1,0.0,0.0
Petkov,www.mediafax.ro,0,0,1,1,0.0,0.0
Aoun,www.aktual24.ro,0,0,1,1,0.0,0.0
Arabia Saudită,www.aktual24.ro,0,0,2,2,0.0,0.0
Beirut,www.aktual24.ro,0,0,1,1,0.0,0.0
Jospeh Aoun,www.aktual24.ro,0,0,1,1,0.0,0.0
Liban,www.aktual24.ro,0,0,3,3,0.0,0.0
Mahmoud Maakiyeh,www.aktual24.ro,0,0,1,1,0.0,0.0
mijlociu,www.aktual24.ro,0,0,1,1,0.0,0.0
Morgan Ortagus,www.aktual24.ro,0,0,1,1,0.0,0.0
Nawaf Salam,www.aktual24.ro,0,0,1,1,0.0,0.0
Salam,www.aktual24.ro,0,0,1,1,0.0,0.0
trimis,www.aktual24.ro,0,0,1,1,0.0,0.0
vecin,www.aktual24.ro,0,0,1,1,0.0,0.0
bătrân,www.g4media.ro,1,0,0,1,1.0,1.0
persoană vârstnică,www.g4media.ro,0,0,1,1,0.0,0.0
cunoscător,www.luju.ro,1,0,0,1,1.0,1.0
operator,www.luju.ro,0,0,1,1,0.0,0.0
Răzvan,www.aktual24.ro,0,1,0,1,-1.0,1.0
fată,www.aktual24.ro,0,0,2,2,0.0,0.0
înși,www.aktual24.ro,0,1,0,1,-1.0,1.0
pompier,www.aktual24.ro,0,0,1,1,0.0,0.0
soră,www.aktual24.ro,0,0,1,1,0.0,0.0
Ana Maria Roman,www.antena3.ro,0,0,1,1,0.0,0.0
Berta Popescu,www.antena3.ro,0,0,2,2,0.0,0.0
Câmpulung,www.antena3.ro,1,0,0,1,1.0,1.0
Dumitru Borțun,www.antena3.ro,0,0,1,1,0.0,0.0
Mihai Tudose,www.antena3.ro,0,0,2,2,0.0,0.0
Robert Kiss,www.antena3.ro,0,0,1,1,0.0,0.0
Robert Sighiartău,www.antena3.ro,0,0,1,1,0.0,0.0
Sabrina Preda,www.antena3.ro,0,0,1,1,0.0,0.0
Sanda Nicola,www.antena3.ro,0,0,1,1,0.0,0.0
Sergiu Cora,www.antena3.ro,0,0,2,2,0.0,0.0
națiune,www.antena3.ro,0,0,1,1,0.0,0.0
penal,www.antena3.ro,0,1,0,1,-1.0,1.0
Uniunea Europeană,www.antena3.ro,0,1,0,1,-1.0,1.0
vânzător,www.antena3.ro,0,1,0,1,-1.0,1.0
Ionuț Marcel Păcuraru,www.comisarul.ro,0,0,1,1,0.0,0.0
Maricel Păcurar,www.comisarul.ro,0,1,0,1,-1.0,1.0
Maricel Păcuraru,www.comisarul.ro,0,1,0,1,-1.0,1.0
mandatar,www.comisarul.ro,0,0,1,1,0.0,0.0
Constantin Toma,www.gandul.ro,0,0,2,2,0.0,0.0
Maxenu,www.gandul.ro,0,0,1,1,0.0,0.0
Toma,www.gandul.ro,0,0,1,1,0.0,0.0
țintește,www.gandul.ro,0,0,1,1,0.0,0.0
Vasili Osmakov,www.comisarul.ro,0,0,1,1,0.0,0.0
adjunct,www.comisarul.ro,0,1,0,1,-1.0,1.0
rezident,www.comisarul.ro,0,0,1,1,0.0,0.0
Andrei Țărnea,www.comisarul.ro,0,1,0,1,-1.0,1.0
Bizanț,pressone.ro,0,0,1,1,0.0,0.0
L,pressone.ro,0,1,0,1,-1.0,1.0
R,pressone.ro,0,0,2,2,0.0,0.0
Clotilde,pressone.ro,0,1,0,1,-1.0,1.0
Domnul Cîrstoiu,pressone.ro,0,0,1,1,0.0,0.0
domnul doctor Cîrstoiu,pressone.ro,0,1,0,1,-1.0,1.0
Cârstoiu,pressone.ro,0,1,0,1,-1.0,1.0
ofertant,pressone.ro,0,0,1,1,0.0,0.0
Irina Tănase,a1.ro,1,0,0,1,1.0,1.0
Liviu Dragnea,a1.ro,0,1,1,2,-0.5,0.5
Maia Sandu,www.g4media.ro,0,0,2,2,0.0,0.0
Roberto Stan,agerpres.ro,0,0,1,1,0.0,0.0
Adrian Vigheciu,www.b1tv.ro,0,0,1,1,0.0,0.0
Marian Vanghelie,www.b1tv.ro,0,2,0,2,-1.0,1.0
Piedone Jr,www.b1tv.ro,0,0,1,1,0.0,0.0
Piedone senior,www.b1tv.ro,0,1,0,1,-1.0,1.0
Vanghelie,www.b1tv.ro,0,1,0,1,-1.0,1.0
Vlad,www.b1tv.ro,0,1,0,1,-1.0,1.0
Vlad Piedone,www.b1tv.ro,0,2,0,2,-1.0,1.0
lăutar,www.b1tv.ro,0,1,0,1,-1.0,1.0
senior,www.b1tv.ro,0,1,0,1,-1.0,1.0
Bogdan Negoescu,www.romaniatv.net,0,0,1,1,0.0,0.0
Cătălin Ciornei,www.romaniatv.net,0,0,1,1,0.0,0.0
Răzvan Biro,www.romaniatv.net,0,0,1,1,0.0,0.0
Tiberiu Claudiu Barstan,www.romaniatv.net,0,0,1,1,0.0,0.0
Igas,a1.ro,0,0,1,1,0.0,0.0
Vasile Bănescu,www.romaniatv.net,0,0,1,1,0.0,0.0
Carman Avram,adevarul.ro,0,0,1,1,0.0,0.0
Aurelian Penescu,stirileprotv.ro,0,0,1,1,0.0,0.0
Mariana Campeanu,stirileprotv.ro,0,0,1,1,0.0,0.0
Paul Dobre,stirileprotv.ro,0,0,1,1,0.0,0.0
Radu Catana,stirileprotv.ro,0,0,1,1,0.0,0.0
Theodor Meleșcan,stirileprotv.ro,0,0,1,1,0.0,0.0
Victor Voicu,stirileprotv.ro,0,0,1,1,0.0,0.0
clujean,stirileprotv.ro,0,0,1,1,0.0,0.0
Cătălin Gheorghe,recorder.ro,0,0,1,1,0.0,0.0
Gérard Depardieu,recorder.ro,0,1,0,1,-1.0,1.0
Mohammed bin Salman,recorder.ro,0,0,1,1,0.0,0.0
Nicolae Țîbrigan,recorder.ro,0,0,1,1,0.0,0.0
Riadul,recorder.ro,1,0,0,1,1.0,1.0
prinț,recorder.ro,0,0,1,1,0.0,0.0
Țîbrigan,recorder.ro,0,0,1,1,0.0,0.0
Andra Borș,recorder.ro,0,0,1,1,0.0,0.0
Antal Istvan Lorent,recorder.ro,0,0,1,1,0.0,0.0
Bende Sandor,recorder.ro,0,0,1,1,0.0,0.0
Bălan,recorder.ro,0,0,1,1,0.0,0.0
Ciuc,recorder.ro,0,0,1,1,0.0,0.0
Elif Shafak,recorder.ro,0,0,1,1,0.0,0.0
Gheorgheni,recorder.ro,0,0,1,1,0.0,0.0
Hajdu Gabor,recorder.ro,0,1,0,1,-1.0,1.0
Harghita,recorder.ro,0,0,1,1,0.0,0.0
Kelemen Hunor,recorder.ro,0,0,1,1,0.0,0.0
Ladanyi Laszlo Zsolt,recorder.ro,0,0,1,1,0.0,0.0
Laurențiu Șoitu,recorder.ro,0,0,1,1,0.0,0.0
Ludovic von Mises,recorder.ro,0,0,1,1,0.0,0.0
Ludwig von Mises,recorder.ro,0,0,1,1,0.0,0.0
Miercurea Ciuc,recorder.ro,1,0,0,1,1.0,1.0
Odorheiul Secuiesc,recorder.ro,1,0,0,1,1.0,1.0
Toplița,recorder.ro,0,0,1,1,0.0,0.0
Victor Buzilă,recorder.ro,0,0,1,1,0.0,0.0
Yuval Harari,recorder.ro,0,0,1,1,0.0,0.0
Zakarias Zoltan,recorder.ro,0,0,1,1,0.0,0.0
Zavada Pal,recorder.ro,0,0,1,1,0.0,0.0
consultant parlamentar,recorder.ro,0,0,1,1,0.0,0.0
poet,recorder.ro,0,0,1,1,0.0,0.0
Ținutul Secuiesc,recorder.ro,0,0,1,1,0.0,0.0
Ciprian Ciucu,www.antena3.ro,0,0,1,1,0.0,0.0
Alba,www.comisarul.ro,0,0,1,1,0.0,0.0
Boc,www.comisarul.ro,0,0,1,1,0.0,0.0
Sălciua,www.comisarul.ro,0,0,1,1,0.0,0.0
Valeriu Tabără,www.comisarul.ro,0,0,1,1,0.0,0.0
doctor,www.comisarul.ro,0,0,2,2,0.0,0.0
Dorin Laurențiu Ionescu,www.antena3.ro,0,0,1,1,0.0,0.0
latifundiar,www.antena3.ro,0,1,0,1,-1.0,1.0
Pipera,www.antena3.ro,0,1,0,1,-1.0,1.0
Ionuț Luțu,www.antena3.ro,0,0,1,1,0.0,0.0
Adrian Miuțescu,recorder.ro,0,0,1,1,0.0,0.0
Angus Deaton,recorder.ro,0,0,1,1,0.0,0.0
Aurel Rogojan,recorder.ro,0,0,1,1,0.0,0.0
Bogdan Angelin David,recorder.ro,0,0,1,1,0.0,0.0
Costești,recorder.ro,0,0,1,1,0.0,0.0
Curtea de,recorder.ro,0,0,1,1,0.0,0.0
Curtea de Argeș,recorder.ro,0,0,1,1,0.0,0.0
Cătălin Cornel Bulf,recorder.ro,0,1,0,1,-1.0,1.0
Daniel Constantin,recorder.ro,0,0,1,1,0.0,0.0
Daniel Kahneman,recorder.ro,0,0,1,1,0.0,0.0
David Bogdan Angelin,recorder.ro,0,0,1,1,0.0,0.0
Dănuț Bica,recorder.ro,0,0,1,1,0.0,0.0
Ellis Avery,recorder.ro,0,0,1,1,0.0,0.0
Făgăraș,recorder.ro,0,1,0,1,-1.0,1.0
John Maxwell Simona Bucura Oprescu,recorder.ro,0,0,1,1,0.0,0.0
Liviu Ionuț Moșteanu,recorder.ro,0,0,1,1,0.0,0.0
Martin Page,recorder.ro,0,0,1,1,0.0,0.0
Molivișu,recorder.ro,0,1,0,1,-1.0,1.0
Nicolae Pavelescu,recorder.ro,0,0,1,1,0.0,0.0
Ovidiu Puiu,recorder.ro,0,0,1,1,0.0,0.0
Remus Gabriel Mihalcea,recorder.ro,0,0,1,1,0.0,0.0
Siddhartha Mukherjee,recorder.ro,0,0,1,1,0.0,0.0
ar,recorder.ro,0,1,0,1,-1.0,1.0
asistent cercetător,recorder.ro,0,0,1,1,0.0,0.0
transportator,recorder.ro,0,0,1,1,0.0,0.0
vătaf,recorder.ro,0,1,0,1,-1.0,1.0
bătrână,agerpres.ro,0,1,0,1,-1.0,1.0
Winkler,agerpres.ro,0,0,1,1,0.0,0.0
ideolog,www.antena3.ro,0,1,0,1,-1.0,1.0
Anca Alexandrescu,snoop.ro,0,0,1,1,0.0,0.0
Andreea Crețulescu,snoop.ro,0,0,1,1,0.0,0.0
Ciprian Gabriel Scrieciu,snoop.ro,0,0,1,1,0.0,0.0
Cristian Terheș,snoop.ro,0,0,1,1,0.0,0.0
Cristina Prună,snoop.ro,0,0,2,2,0.0,0.0
Georgiana Teodorescu,snoop.ro,0,0,1,1,0.0,0.0
Gheorghe Piperea,snoop.ro,0,0,1,1,0.0,0.0
Ionuț Cristache,snoop.ro,0,0,1,1,0.0,0.0
moderatoare,snoop.ro,0,0,2,2,0.0,0.0
Victor Negrescu,snoop.ro,0,0,2,2,0.0,0.0
decident,snoop.ro,0,1,0,1,-1.0,1.0
Falcă,www.news.ro,0,0,2,2,0.0,0.0
Gheorghe Falcă,www.news.ro,0,0,2,2,0.0,0.0
Gheorghe Iancu,a1.ro,0,0,1,1,0.0,0.0
György Frunda,a1.ro,0,0,1,1,0.0,0.0
adjunct,a1.ro,0,0,2,2,0.0,0.0
Ana Maria Gavrilă,www.realitatea.net,0,0,2,2,0.0,0.0
Donald Tusk,www.aktual24.ro,0,1,1,2,-0.5,0.5
Karol Nawrocki,www.aktual24.ro,0,0,2,2,0.0,0.0
Nawrocki,www.aktual24.ro,0,2,0,2,-1.0,1.0
Rafal Trzaskowski,www.aktual24.ro,0,0,2,2,0.0,0.0
Tusk,www.aktual24.ro,0,1,1,2,-0.5,0.5
Alin Teodorescu,adevarul.ro,0,0,1,1,0.0,0.0
Teodorescu,adevarul.ro,0,0,1,1,0.0,0.0
Dragnea,a1.ro,0,1,0,1,-1.0,1.0
Norvegia,a1.ro,0,0,2,2,0.0,0.0
mogul,a1.ro,0,1,0,1,-1.0,1.0
Eugen Tomac,www.news.ro,0,0,1,1,0.0,0.0
Laura Codruța Kovesi,www.news.ro,0,0,1,1,0.0,0.0
Laura Codruța Koveși,www.news.ro,0,0,1,1,0.0,0.0
Tomac,www.news.ro,0,0,1,1,0.0,0.0
Viktor Orbán,www.antena3.ro,0,0,1,1,0.0,0.0
Adrian Papahagi,adevarul.ro,0,0,1,1,0.0,0.0
Lăzăroiu,adevarul.ro,0,2,0,2,-1.0,1.0
Papahagi,adevarul.ro,0,1,1,2,-0.5,0.5
Ungureanu,adevarul.ro,0,0,1,1,0.0,0.0
Sebastian Lăzăroiu,adevarul.ro,0,0,1,1,0.0,0.0
Claudiu Năsui,www.romaniatv.net,0,0,1,1,0.0,0.0
Ialomița,www.romaniatv.net,0,0,2,2,0.0,0.0
mandatar,www.romaniatv.net,0,1,0,1,-1.0,1.0
Anda Z,pressone.ro,0,0,1,1,0.0,0.0
Andreea Zavelița,pressone.ro,0,0,1,1,0.0,0.0
Barbu Mateescu,pressone.ro,0,0,2,2,0.0,0.0
advertiser,pressone.ro,0,1,1,2,-0.5,0.5
Ailin,pressone.ro,0,0,1,1,0.0,0.0
Elena Ilie,snoop.ro,0,0,1,1,0.0,0.0
Eugeniu Carada,snoop.ro,0,0,1,1,0.0,0.0
Marius Grăjdan,snoop.ro,0,0,1,1,0.0,0.0
Mircea Preoțescu,snoop.ro,0,1,2,3,-0.3333333333333333,0.3333333333333333
Otopeni,snoop.ro,0,0,1,1,0.0,0.0
Preoțescu,snoop.ro,0,0,1,1,0.0,0.0
Greblă,snoop.ro,0,0,1,1,0.0,0.0
Șerban Mihăilescu,snoop.ro,0,0,4,4,0.0,0.0
Bence Tuzson,adevarul.ro,0,1,0,1,-1.0,1.0
Băile Tușnad,adevarul.ro,0,0,2,2,0.0,0.0
Tușnad,adevarul.ro,0,0,1,1,0.0,0.0
Ungaria Mare,adevarul.ro,0,1,0,1,-1.0,1.0
Vienei,adevarul.ro,0,0,1,1,0.0,0.0
Nicolae Ceaușescu,www.g4media.ro,0,2,0,2,-1.0,1.0
Slănic Moldova,www.g4media.ro,0,0,1,1,0.0,0.0
călăuz,www.g4media.ro,0,1,0,1,-1.0,1.0
dlui Georgescu,www.g4media.ro,0,0,1,1,0.0,0.0
figuranț,www.g4media.ro,0,1,0,1,-1.0,1.0
voievoz,www.g4media.ro,0,1,0,1,-1.0,1.0
Bergradul,www.realitatea.net,0,1,0,1,-1.0,1.0
Bădiță,pressone.ro,0,2,0,2,-1.0,1.0
Florin Bădiță,pressone.ro,0,0,1,1,0.0,0.0
George Harabagiu,pressone.ro,0,2,0,2,-1.0,1.0
Mararu,pressone.ro,0,1,0,1,-1.0,1.0
Simona Halep,pressone.ro,0,1,1,2,-0.5,0.5
X,pressone.ro,0,1,0,1,-1.0,1.0
Y,pressone.ro,0,1,0,1,-1.0,1.0
gazetar,pressone.ro,0,1,0,1,-1.0,1.0
primar general,pressone.ro,0,1,0,1,-1.0,1.0
Geanina Puscasu,a1.ro,0,0,3,3,0.0,0.0
asistent,a1.ro,0,0,2,2,0.0,0.0
sponsor,a1.ro,0,0,1,1,0.0,0.0
Gorghiu,www.g4media.ro,0,1,0,1,-1.0,1.0
trecător,recorder.ro,0,0,1,1,0.0,0.0
competitor,www.news.ro,0,1,0,1,-1.0,1.0
student,www.news.ro,0,1,2,3,-0.3333333333333333,0.3333333333333333
premiu,observatornews.ro,0,0,1,1,0.0,0.0
Alar Karis,www.comisarul.ro,0,0,1,1,0.0,0.0
Alexander Stubb,www.comisarul.ro,0,0,1,1,0.0,0.0
Estonia,www.comisarul.ro,0,0,2,2,0.0,0.0
Finlanda,www.comisarul.ro,0,0,1,1,0.0,0.0
Graham,www.comisarul.ro,0,0,1,1,0.0,0.0
Isoroku Yamamoto,www.comisarul.ro,0,0,1,1,0.0,0.0
Lennart Meri,www.comisarul.ro,0,0,1,1,0.0,0.0
Lindsey Graham,www.comisarul.ro,0,0,1,1,0.0,0.0
Matthew Whitaker,www.comisarul.ro,0,0,1,1,0.0,0.0
Papei,www.comisarul.ro,0,0,1,1,0.0,0.0
Radosław Sikorski,www.comisarul.ro,0,0,1,1,0.0,0.0
Richard Blumenthal,www.comisarul.ro,0,0,1,1,0.0,0.0
Stubb,www.comisarul.ro,0,0,1,1,0.0,0.0
Tallinn,www.comisarul.ro,0,0,1,1,0.0,0.0
amiral,www.comisarul.ro,0,0,1,1,0.0,0.0
Igas Constantin Traian,a1.ro,0,0,1,1,0.0,0.0
divinitate,primanews.ro,0,0,1,1,0.0,0.0
Mario Oprea,www.g4media.ro,0,0,1,1,0.0,0.0
demnitar,www.g4media.ro,0,1,1,2,-0.5,0.5
șofer,www.g4media.ro,0,0,4,4,0.0,0.0
Gabriel Zetea,primanews.ro,1,1,0,2,0.0,0.0
amiral,www.romaniatv.net,0,0,1,1,0.0,0.0
comandant,www.romaniatv.net,0,0,1,1,0.0,0.0
secretar de stat,agerpres.ro,0,0,1,1,0.0,0.0
stat,agerpres.ro,0,0,1,1,0.0,0.0
subsecretar de stat,agerpres.ro,0,0,1,1,0.0,0.0
Maricel Păcurar,recorder.ro,0,1,0,1,-1.0,1.0
Maricel Păcuraru,recorder.ro,0,1,0,1,-1.0,1.0
Piperea,recorder.ro,0,0,1,1,0.0,0.0
Singureni,recorder.ro,0,0,1,1,0.0,0.0
Daniel Buda,recorder.ro,0,0,2,2,0.0,0.0
Michigan,recorder.ro,0,0,1,1,0.0,0.0
crescător,recorder.ro,0,1,0,1,-1.0,1.0
Duta,a1.ro,0,1,0,1,-1.0,1.0
Maria Diana Diaconu,a1.ro,0,0,1,1,0.0,0.0
Vasile Cepoi,a1.ro,0,1,0,1,-1.0,1.0
regizor,a1.ro,0,1,0,1,-1.0,1.0
Dan Diaconescu,www.aktual24.ro,0,0,1,1,0.0,0.0
Corneliu Tudor,www.b1tv.ro,0,1,0,1,-1.0,1.0
Eșena Lasconi,www.b1tv.ro,0,0,1,1,0.0,0.0
Ion Rațiu,www.b1tv.ro,0,0,1,1,0.0,0.0
Nicolae Rațiu,www.b1tv.ro,0,0,1,1,0.0,0.0
doamnă,www.b1tv.ro,0,1,0,1,-1.0,1.0
Gheorghe Cârciu,www.digi24.ro,0,0,1,1,0.0,0.0
Paul Stănescu,www.digi24.ro,0,1,2,3,-0.3333333333333333,0.3333333333333333
Adrian Veștea,agerpres.ro,0,0,1,1,0.0,0.0
Bianca Firezar,agerpres.ro,0,0,1,1,0.0,0.0
Bogdan Mazuru,agerpres.ro,0,0,1,1,0.0,0.0
Ciprian Ciucu,agerpres.ro,0,0,1,1,0.0,0.0
Cristian Diaconescu,agerpres.ro,0,0,1,1,0.0,0.0
Dan Motreanu,agerpres.ro,0,0,1,1,0.0,0.0
Luminița Odobescu,agerpres.ro,0,0,1,1,0.0,0.0
capitală,www.digi24.ro,0,1,1,2,-0.5,0.5
Cehoslovacia,www.digi24.ro,0,0,1,1,0.0,0.0
Dumitru Mazilu,www.digi24.ro,0,0,1,1,0.0,0.0
fost,www.digi24.ro,0,1,0,1,-1.0,1.0
Gelu Voican Voiculescu,www.digi24.ro,0,0,1,1,0.0,0.0
Mazilu,www.digi24.ro,0,0,1,1,0.0,0.0
figură,www.digi24.ro,0,1,1,2,-0.5,0.5
manifestant,www.digi24.ro,0,2,0,2,-1.0,1.0
miner,www.digi24.ro,0,1,0,1,-1.0,1.0
mort,www.digi24.ro,0,1,0,1,-1.0,1.0
muncitor,www.digi24.ro,0,0,1,1,0.0,0.0
regim,www.digi24.ro,0,1,0,1,-1.0,1.0
rănit,www.digi24.ro,0,1,0,1,-1.0,1.0
Agrigoroae,recorder.ro,0,1,0,1,-1.0,1.0
Ionel,recorder.ro,0,1,0,1,-1.0,1.0
Ionel Agrigoroaei,recorder.ro,0,1,0,1,-1.0,1.0
Laos,recorder.ro,0,0,1,1,0.0,0.0
Vandam Constantin,recorder.ro,0,1,0,1,-1.0,1.0
Brooklyn,a1.ro,0,0,1,1,0.0,0.0
Fred Trump,a1.ro,0,0,1,1,0.0,0.0
Manhattan,a1.ro,0,0,3,3,0.0,0.0
Mezina,a1.ro,0,0,1,1,0.0,0.0
Michael Boulos,a1.ro,0,0,1,1,0.0,0.0
Oprah Winfrey,a1.ro,0,0,1,1,0.0,0.0
Queens,a1.ro,0,0,1,1,0.0,0.0
celebritate,a1.ro,0,0,1,1,0.0,0.0
Lee Greenwood,a1.ro,0,0,1,1,0.0,0.0
E. Jean Carroll,a1.ro,0,1,0,1,-1.0,1.0
Cosmi,www.realitatea.net,0,0,1,1,0.0,0.0
Dragoș Cristian Vlad,www.realitatea.net,0,0,1,1,0.0,0.0
Dragoș Niculescu,www.realitatea.net,0,0,1,1,0.0,0.0
Ghiță,www.realitatea.net,0,2,0,2,-1.0,1.0
Malta,www.realitatea.net,0,0,1,1,0.0,0.0
Marcel Opriș,www.realitatea.net,0,0,1,1,0.0,0.0
Mihaela Cosmi,www.realitatea.net,0,0,1,1,0.0,0.0
Mihaela Elena Culcescu,www.realitatea.net,0,0,1,1,0.0,0.0
Mihaela Culcescu,www.realitatea.net,0,1,0,1,-1.0,1.0
Minel Popescu,www.realitatea.net,0,1,0,1,-1.0,1.0
Răzvan Băicoianu,www.realitatea.net,0,1,0,1,-1.0,1.0
Tiberiu Croitoru,www.realitatea.net,0,0,1,1,0.0,0.0
inculpat,www.realitatea.net,0,2,0,2,-1.0,1.0
ofertant,www.realitatea.net,0,1,0,1,-1.0,1.0
Adrian Papahagi,www.mediafax.ro,0,0,1,1,0.0,0.0
Aurelian Pavelescu,www.mediafax.ro,0,0,1,1,0.0,0.0
Mihai Neamțu,www.mediafax.ro,0,0,1,1,0.0,0.0
Mihai Răzvan Ungureanu,www.mediafax.ro,0,0,1,1,0.0,0.0
Neamțu,www.mediafax.ro,0,0,1,1,0.0,0.0
Alina Vandenbergh,a1.ro,0,0,1,1,0.0,0.0
Dragoș Sprânceană,a1.ro,0,0,1,1,0.0,0.0
Iasmina Hill,a1.ro,0,0,1,1,0.0,0.0
Maia Sandu,a1.ro,1,0,0,1,1.0,1.0
Timișoara,a1.ro,0,0,3,3,0.0,0.0
"Washington, D.C.",a1.ro,0,0,1,1,0.0,0.0
analișt,a1.ro,0,0,1,1,0.0,0.0
rivală,a1.ro,0,1,0,1,-1.0,1.0
voluntar,a1.ro,2,0,0,2,1.0,1.0
"Washington, D.C.",www.gandul.ro,0,0,1,1,0.0,0.0
Gauthier le Bret,www.comisarul.ro,0,0,1,1,0.0,0.0
Marine Le Pen,www.comisarul.ro,0,0,1,1,0.0,0.0
Éric Zemmour,www.comisarul.ro,0,0,1,1,0.0,0.0
Ana Maria Cătăuță,recorder.ro,0,0,1,1,0.0,0.0
Anne Girard,recorder.ro,0,0,1,1,0.0,0.0
Asimov,recorder.ro,1,0,0,1,1.0,1.0
Bianca Purcărin,recorder.ro,0,0,1,1,0.0,0.0
Claudiu Ilișanu,recorder.ro,0,0,1,1,0.0,0.0
Comănești,recorder.ro,0,0,1,1,0.0,0.0
Cosmin Necula,recorder.ro,0,1,0,1,-1.0,1.0
Costel Dunava,recorder.ro,0,0,1,1,0.0,0.0
Cristina Breahnă,recorder.ro,0,0,1,1,0.0,0.0
Cătălina Ciofu,recorder.ro,0,0,1,1,0.0,0.0
Daniel David Constantin Avram,recorder.ro,0,0,1,1,0.0,0.0
Dinu C. Giurescu,recorder.ro,0,0,1,1,0.0,0.0
Dragoș Benea,recorder.ro,0,0,1,1,0.0,0.0
Fenechiu,recorder.ro,0,0,1,1,0.0,0.0
Finlanda,recorder.ro,0,0,1,1,0.0,0.0
Ion Melinte,recorder.ro,0,0,1,1,0.0,0.0
Ionel Floroiu,recorder.ro,0,1,0,1,-1.0,1.0
James Clavell,recorder.ro,0,0,1,1,0.0,0.0
Lucian Dan Viziteu,recorder.ro,0,0,1,1,0.0,0.0
Mircea Fechet,recorder.ro,0,0,1,1,0.0,0.0
Moinești,recorder.ro,0,0,1,1,0.0,0.0
Nancy Pelosi,recorder.ro,0,0,1,1,0.0,0.0
Onești,recorder.ro,0,1,0,1,-1.0,1.0
Podu Turcului,recorder.ro,0,0,1,1,0.0,0.0
Savu,recorder.ro,0,0,1,1,0.0,0.0
Sebastian Cernic,recorder.ro,0,0,1,1,0.0,0.0
Sergiu Sechelariu,recorder.ro,0,0,1,1,0.0,0.0
Stanislaw Lem,recorder.ro,1,0,0,1,1.0,1.0
Stendhal,recorder.ro,0,0,1,1,0.0,0.0
Stieg Larsson,recorder.ro,0,0,1,1,0.0,0.0
Taleb Nassim,recorder.ro,0,0,1,1,0.0,0.0
Teodor Lazăr,recorder.ro,0,0,1,1,0.0,0.0
Thomas Mann,recorder.ro,0,0,1,1,0.0,0.0
Vasile Budacă,recorder.ro,0,0,1,1,0.0,0.0
asociat,recorder.ro,0,0,1,1,0.0,0.0
Piatra Neamț,adevarul.ro,0,0,1,1,0.0,0.0
Hristos,www.aktual24.ro,0,0,1,1,0.0,0.0
dragi,www.aktual24.ro,1,0,0,1,1.0,1.0
neam,www.aktual24.ro,1,0,0,1,1.0,1.0
Albania,observatornews.ro,1,0,0,1,1.0,1.0
Berlin,observatornews.ro,0,0,1,1,0.0,0.0
Emmanuel,observatornews.ro,1,0,0,1,1.0,1.0
Georgia,observatornews.ro,1,0,0,1,1.0,1.0
Macron,observatornews.ro,1,0,0,1,1.0,1.0
Republica Macedonia de Nord,observatornews.ro,0,0,1,1,0.0,0.0
Republica Franceză,observatornews.ro,1,0,0,1,1.0,1.0
Suedia,observatornews.ro,0,0,1,1,0.0,0.0
aspirant,observatornews.ro,1,0,0,1,1.0,1.0
Președinte,observatornews.ro,1,0,0,1,1.0,1.0
liberal,www.antena3.ro,0,1,0,1,-1.0,1.0
Tudor Chirilă,stirileprotv.ro,0,0,1,1,0.0,0.0
Marian Saniuta,a1.ro,0,0,1,1,0.0,0.0
Saniuta,a1.ro,0,0,1,1,0.0,0.0
Dan Ilie Morega,a1.ro,0,0,1,1,0.0,0.0
Ilie Morega,a1.ro,0,2,0,2,-1.0,1.0
Morega,a1.ro,0,1,0,1,-1.0,1.0
Mos Crăciun,a1.ro,0,0,1,1,0.0,0.0
Pacuraru,a1.ro,0,1,1,2,-0.5,0.5
Paul Pacuraru,a1.ro,0,2,1,3,-0.6666666666666666,0.6666666666666666
judecat,a1.ro,0,1,0,1,-1.0,1.0
Emilia Raluca Trandafir,www.luju.ro,0,1,0,1,-1.0,1.0
utilizator,observatornews.ro,0,0,2,2,0.0,0.0
Arabia Saudită,adevarul.ro,0,0,1,1,0.0,0.0
Azerbaidjan,adevarul.ro,0,0,1,1,0.0,0.0
Singapore,adevarul.ro,0,0,1,1,0.0,0.0
Abrudean,www.cotidianul.ro,0,0,1,1,0.0,0.0
Cărbunaru,www.euronews.ro,0,0,1,1,0.0,0.0
Dan Cărbunaru,www.euronews.ro,0,0,1,1,0.0,0.0
Alexandru Petru Fratean,a1.ro,0,0,3,3,0.0,0.0
Cornel Briscaru,a1.ro,0,0,1,1,0.0,0.0
Vlas,a1.ro,0,0,1,1,0.0,0.0
secretar executiv,a1.ro,0,0,1,1,0.0,0.0
Munchen,a1.ro,1,0,0,1,1.0,1.0
Cserey Ilona,a1.ro,0,0,1,1,0.0,0.0
Elena Ceaușescu,a1.ro,0,0,1,1,0.0,0.0
fetele,a1.ro,0,0,1,1,0.0,0.0
Ilus,a1.ro,0,0,1,1,0.0,0.0
Ilus Néni,a1.ro,0,0,1,1,0.0,0.0
adolescent,a1.ro,1,0,0,1,1.0,1.0
bucătar,a1.ro,0,1,0,1,-1.0,1.0
cunoscut,a1.ro,0,0,1,1,0.0,0.0
cunoștință,a1.ro,0,0,1,1,0.0,0.0
pereche,a1.ro,0,0,1,1,0.0,0.0
secuime,a1.ro,0,0,1,1,0.0,0.0
slujnic,a1.ro,0,1,0,1,-1.0,1.0
vecină,a1.ro,0,1,0,1,-1.0,1.0
Augustin Zegrean,www.digi24.ro,0,0,1,1,0.0,0.0
Zegrean,www.digi24.ro,0,0,1,1,0.0,0.0
Dan Andronic,www.antena3.ro,1,0,1,2,0.5,0.5
Argeș,agerpres.ro,0,0,1,1,0.0,0.0
Constanța,agerpres.ro,0,0,1,1,0.0,0.0
Suceava,agerpres.ro,0,0,1,1,0.0,0.0
Vaslui,agerpres.ro,0,0,1,1,0.0,0.0
Marina Alexandru,www.realitatea.net,0,0,1,1,0.0,0.0
Mogoșoaia,www.realitatea.net,0,0,1,1,0.0,0.0
jandarm,www.realitatea.net,0,0,1,1,0.0,0.0
Bucureștean,observatornews.ro,1,0,1,2,0.5,0.5
Alexandra Lulache,snoop.ro,0,0,2,2,0.0,0.0
Arina Iacob,snoop.ro,0,0,1,1,0.0,0.0
Batog,snoop.ro,0,0,1,1,0.0,0.0
Claudiu Cornea,snoop.ro,0,0,1,1,0.0,0.0
Cornea,snoop.ro,1,0,2,3,0.3333333333333333,0.3333333333333333
Câlnic,snoop.ro,0,0,1,1,0.0,0.0
Călimănești,snoop.ro,0,0,1,1,0.0,0.0
Ioana Florea,snoop.ro,0,0,2,2,0.0,0.0
Lulache,snoop.ro,1,0,0,1,1.0,1.0
Marina Neagu,snoop.ro,0,0,1,1,0.0,0.0
Marius,snoop.ro,0,0,1,1,0.0,0.0
Mimiu,snoop.ro,0,0,1,1,0.0,0.0
Ploieștiu,snoop.ro,0,0,1,1,0.0,0.0
Străulești,snoop.ro,0,0,1,1,0.0,0.0
Târgu Jiu,snoop.ro,0,0,2,2,0.0,0.0
Valea,snoop.ro,0,0,1,1,0.0,0.0
antropolog,snoop.ro,0,0,1,1,0.0,0.0
arhitectă,snoop.ro,0,0,1,1,0.0,0.0
comunitate,snoop.ro,1,0,0,1,1.0,1.0
coordonator de housing,snoop.ro,0,0,1,1,0.0,0.0
Andrada Fiscutean,snoop.ro,0,0,1,1,0.0,0.0
noră,snoop.ro,0,0,1,1,0.0,0.0
specialistă,snoop.ro,0,0,1,1,0.0,0.0
Oliver Peiuși,snoop.ro,0,1,0,1,-1.0,1.0
Andrew Wakefield,pressone.ro,0,1,0,1,-1.0,1.0
Budeanu,pressone.ro,0,0,1,1,0.0,0.0
Christian Eriksen,pressone.ro,0,0,1,1,0.0,0.0
Codreanu,pressone.ro,0,0,2,2,0.0,0.0
Cristina Pocora,pressone.ro,0,0,1,1,0.0,0.0
Danemarcei,pressone.ro,0,0,1,1,0.0,0.0
Eriksen,pressone.ro,0,0,1,1,0.0,0.0
Ionuț Codreanu,pressone.ro,0,0,2,2,0.0,0.0
Mădălin Ionescu,pressone.ro,0,1,0,1,-1.0,1.0
Pandele,pressone.ro,0,1,0,1,-1.0,1.0
Pocora,pressone.ro,0,0,1,1,0.0,0.0
QAnon,pressone.ro,0,1,0,1,-1.0,1.0
Radu Budeanu,pressone.ro,0,0,1,1,0.0,0.0
Seychelles,pressone.ro,0,0,1,1,0.0,0.0
căpitan,pressone.ro,0,0,1,1,0.0,0.0
medic șef,pressone.ro,0,0,1,1,0.0,0.0
pacientă,pressone.ro,1,0,0,1,1.0,1.0
înlocuitor,pressone.ro,0,2,0,2,-1.0,1.0
Alexandru Mazare,a1.ro,0,0,1,1,0.0,0.0
Maria Schultz,a1.ro,0,0,1,1,0.0,0.0
Marian Oprisan,a1.ro,0,0,1,1,0.0,0.0
anchetator,a1.ro,0,1,0,1,-1.0,1.0
Manuela Mitrea,a1.ro,0,0,1,1,0.0,0.0
Voicu,a1.ro,0,1,0,1,-1.0,1.0
Vaslui,observatornews.ro,0,0,2,2,0.0,0.0
delegat,observatornews.ro,0,0,6,6,0.0,0.0
Amagasaki,www.news.ro,0,0,1,1,0.0,0.0
La,www.news.ro,0,0,1,1,0.0,0.0
Lucian Croitoru,stirileprotv.ro,0,0,2,2,0.0,0.0
Lago,www.news.ro,0,0,1,1,0.0,0.0
Statele Unite ale Americii,www.news.ro,0,0,1,1,0.0,0.0
cosmonaut,www.news.ro,1,0,0,1,1.0,1.0
Andrzej Duda,www.antena3.ro,0,0,1,1,0.0,0.0
Boleslav I,www.antena3.ro,0,0,1,1,0.0,0.0
Donald Tusk,www.antena3.ro,0,0,1,1,0.0,0.0
Karol Nawrocki,www.antena3.ro,0,0,1,1,0.0,0.0
organizator,www.antena3.ro,0,0,1,1,0.0,0.0
Rafal Trzaskowski,www.antena3.ro,0,0,2,2,0.0,0.0
Varșovia,www.antena3.ro,0,0,1,1,0.0,0.0
participanț,www.antena3.ro,0,0,1,1,0.0,0.0
rege,www.antena3.ro,0,0,1,1,0.0,0.0
Elene,www.b1tv.ro,0,1,0,1,-1.0,1.0
dâns,www.b1tv.ro,0,1,0,1,-1.0,1.0
Amagasaki,adevarul.ro,0,0,1,1,0.0,0.0
chimist,adevarul.ro,0,1,1,2,-0.5,0.5
Diana Iovanovici Șoșoacă,www.gandul.ro,0,1,0,1,-1.0,1.0
Diana Ivanovici Șoșoacă,www.gandul.ro,0,1,0,1,-1.0,1.0
Nicolae Ceaușescu,www.gandul.ro,0,0,1,1,0.0,0.0
Gavrilă Anamaria,adevarul.ro,0,0,1,1,0.0,0.0
Filip Constantin Titian,adevarul.ro,0,0,1,1,0.0,0.0
Funeriu Petru - Daniel,adevarul.ro,0,0,1,1,0.0,0.0
domnul,adevarul.ro,0,0,1,1,0.0,0.0
Pricopie Remus,adevarul.ro,0,0,1,1,0.0,0.0
Terheș Cristian – Vasile,adevarul.ro,0,0,1,1,0.0,0.0
Dâmbovița,www.realitatea.net,0,1,0,1,-1.0,1.0
Barna Tanczos,www.news.ro,1,0,0,1,1.0,1.0
Niculor Dan,www.romaniatv.net,0,0,1,1,0.0,0.0
Alexandru Ioan Cuza,www.antena3.ro,1,0,0,1,1.0,1.0
Bogdan Duca,www.antena3.ro,1,0,1,2,0.5,0.5
Brătian,www.antena3.ro,0,0,1,1,0.0,0.0
Christian Tell,www.antena3.ro,0,0,1,1,0.0,0.0
conservator,www.antena3.ro,0,0,1,1,0.0,0.0
Dan Barna,www.antena3.ro,0,0,1,1,0.0,0.0
Dimitrie Sturza,www.antena3.ro,0,0,1,1,0.0,0.0
Gheorghe Asachi,www.antena3.ro,0,0,1,1,0.0,0.0
Mihail Kogălniceanu,www.antena3.ro,1,0,0,1,1.0,1.0
Moise Guran,www.antena3.ro,1,0,0,1,1.0,1.0
Nicolae Bălcescu,www.antena3.ro,0,0,1,1,0.0,0.0
Norberto Bobbio,www.antena3.ro,0,0,1,1,0.0,0.0
Politologul Bogdan Duca,www.antena3.ro,0,0,1,1,0.0,0.0
Spiru Haret,www.antena3.ro,0,0,1,1,0.0,0.0
Titu Maiorescu,www.antena3.ro,0,0,1,1,0.0,0.0
Vasile Alecsandri,www.antena3.ro,0,0,1,1,0.0,0.0
bogat,www.antena3.ro,0,2,0,2,-1.0,1.0
boier,www.antena3.ro,0,0,1,1,0.0,0.0
cel,www.antena3.ro,0,1,0,1,-1.0,1.0
Cuza,www.antena3.ro,0,0,1,1,0.0,0.0
individ,www.antena3.ro,1,0,0,1,1.0,1.0
moșier,www.antena3.ro,0,1,0,1,-1.0,1.0
regele Ferdinand,www.antena3.ro,0,0,1,1,0.0,0.0
sărac,www.antena3.ro,0,1,0,1,-1.0,1.0
țăran,www.antena3.ro,0,0,3,3,0.0,0.0
Murariu,www.luju.ro,0,1,0,1,-1.0,1.0
Oana Murariu,www.luju.ro,0,0,1,1,0.0,0.0
Omului,www.luju.ro,0,0,1,1,0.0,0.0
acuzat,www.luju.ro,0,1,0,1,-1.0,1.0
deputata Oana Murariu,www.luju.ro,0,1,0,1,-1.0,1.0
organ,www.luju.ro,0,1,0,1,-1.0,1.0
oric,www.luju.ro,0,1,0,1,-1.0,1.0
partid,www.luju.ro,0,0,1,1,0.0,0.0
parte civilă,www.luju.ro,0,0,1,1,0.0,0.0
partidă,www.luju.ro,0,0,1,1,0.0,0.0
Alexandru,www.comisarul.ro,1,1,0,2,0.0,0.0
Dana,www.comisarul.ro,0,0,1,1,0.0,0.0
George Ganea,www.comisarul.ro,1,0,0,1,1.0,1.0
Ionel Ganea,www.comisarul.ro,0,1,0,1,-1.0,1.0
Monica,www.comisarul.ro,0,0,1,1,0.0,0.0
Târgu Mureș,www.comisarul.ro,0,0,1,1,0.0,0.0
familia Ganea,www.comisarul.ro,0,0,1,1,0.0,0.0
internațional,www.comisarul.ro,0,0,1,1,0.0,0.0
mic,www.comisarul.ro,0,0,1,1,0.0,0.0
Bogdan,www.antena3.ro,0,0,1,1,0.0,0.0
Cristina Maria Ciucă,www.antena3.ro,0,0,1,1,0.0,0.0
Grigore Leșe,www.antena3.ro,0,0,1,1,0.0,0.0
doamna Ciucă,www.antena3.ro,0,0,1,1,0.0,0.0
nepoțică,www.antena3.ro,0,0,1,1,0.0,0.0
noră,www.antena3.ro,0,0,1,1,0.0,0.0
Alexandra Hutu,www.aktual24.ro,0,0,1,1,0.0,0.0
Andrei Arosculesei,www.aktual24.ro,0,0,1,1,0.0,0.0
Ciprian Manolache,www.aktual24.ro,0,0,1,1,0.0,0.0
Constantin Cristian Nistor,www.aktual24.ro,0,0,1,1,0.0,0.0
Dana Betenchi,www.aktual24.ro,0,0,1,1,0.0,0.0
Doina Elena Federovici,www.aktual24.ro,0,0,1,1,0.0,0.0
Doina Federovici,www.aktual24.ro,0,0,1,1,0.0,0.0
Elisabeta Lipa,www.aktual24.ro,0,1,0,1,-1.0,1.0
Florin Alexandru Gavril,www.aktual24.ro,0,0,1,1,0.0,0.0
Maria Cristina Bălăuca,www.aktual24.ro,0,0,1,1,0.0,0.0
Marius Budai,www.aktual24.ro,0,0,2,2,0.0,0.0
Mircea Magdalena,www.aktual24.ro,0,0,1,1,0.0,0.0
Remus Dan Dugheru,www.aktual24.ro,0,0,1,1,0.0,0.0
Vasile Lucian Florea,www.aktual24.ro,0,0,1,1,0.0,0.0
campioană,www.aktual24.ro,0,0,1,1,0.0,0.0
Ion Stan,www.gandul.ro,0,1,0,1,-1.0,1.0
Liverpool,www.gandul.ro,0,0,1,1,0.0,0.0
Nea Stane,www.gandul.ro,0,1,0,1,-1.0,1.0
Sorin,www.gandul.ro,0,0,1,1,0.0,0.0
cormoran,www.gandul.ro,0,0,1,1,0.0,0.0
Viorel Hrebenciuc,observatornews.ro,0,0,1,1,0.0,0.0
Adriana Săftoiu,www.gandul.ro,0,0,1,1,0.0,0.0
Andrei Chiliman,www.gandul.ro,0,1,0,1,-1.0,1.0
Baia Mare,www.gandul.ro,0,1,0,1,-1.0,1.0
baron,www.gandul.ro,0,2,0,2,-1.0,1.0
Chiliman,www.gandul.ro,0,1,0,1,-1.0,1.0
Cătălin Cherecheș,www.gandul.ro,0,1,0,1,-1.0,1.0
Marian Vanghelie,www.gandul.ro,0,1,0,1,-1.0,1.0
Moisescu,www.gandul.ro,0,1,0,1,-1.0,1.0
Vlad Moisescu,www.gandul.ro,0,1,0,1,-1.0,1.0
popular,www.gandul.ro,0,0,1,1,0.0,0.0
Sorin Frunzăverde,www.gandul.ro,0,0,1,1,0.0,0.0
acesta,agerpres.ro,0,1,0,1,-1.0,1.0
Florin Birta,agerpres.ro,0,0,1,1,0.0,0.0
Mircea Mălan,agerpres.ro,0,0,1,1,0.0,0.0
Oradea,agerpres.ro,0,0,1,1,0.0,0.0
bihorean,agerpres.ro,0,1,0,1,-1.0,1.0
orădenie,agerpres.ro,0,1,0,1,-1.0,1.0
Corneliu Andrioaei,www.luju.ro,0,2,0,2,-1.0,1.0
petentă,www.luju.ro,0,1,0,1,-1.0,1.0
Ilina,www.aktual24.ro,0,0,1,1,0.0,0.0
prezentatoare,www.aktual24.ro,0,0,1,1,0.0,0.0
hoț,www.romaniatv.net,0,2,0,2,-1.0,1.0
curator,www.romaniatv.net,0,0,1,1,0.0,0.0
Exum,www.aktual24.ro,0,0,1,1,0.0,0.0
Liam Peach,www.aktual24.ro,0,0,1,1,0.0,0.0
Syzdykov,www.aktual24.ro,0,0,1,1,0.0,0.0
Yerlan Syzdykov,www.aktual24.ro,0,0,1,1,0.0,0.0
Danemarca,www.comisarul.ro,0,0,1,1,0.0,0.0
Donald Trump Jr,www.comisarul.ro,0,0,1,1,0.0,0.0
Ladbrokes,www.comisarul.ro,0,0,1,1,0.0,0.0
magnat,www.comisarul.ro,0,1,0,1,-1.0,1.0
Mexic,www.comisarul.ro,0,0,1,1,0.0,0.0
Panama,www.comisarul.ro,0,0,1,1,0.0,0.0
Statele Unite ale Americii,www.comisarul.ro,0,0,2,2,0.0,0.0
parior,www.comisarul.ro,0,1,0,1,-1.0,1.0
Balan,www.aktual24.ro,0,0,1,1,0.0,0.0
Gheorghe Flutur,www.aktual24.ro,0,0,1,1,0.0,0.0
subsemnat,www.aktual24.ro,0,0,1,1,0.0,0.0
Eugen Teodorovici,observatornews.ro,0,1,0,1,-1.0,1.0
Marcel Vela,observatornews.ro,0,0,2,2,0.0,0.0
Teodorovici,observatornews.ro,0,1,0,1,-1.0,1.0
Victor Costache,observatornews.ro,0,0,2,2,0.0,0.0
Miron Costin,observatornews.ro,0,0,1,1,0.0,0.0
pacientă,observatornews.ro,0,1,0,1,-1.0,1.0
Patrick André de Hillerin,www.cotidianul.ro,0,0,1,1,0.0,0.0
exportator,www.gandul.ro,0,1,0,1,-1.0,1.0
Irlanda,www.gandul.ro,0,0,1,1,0.0,0.0
Maroš Šefčovič,www.gandul.ro,0,0,1,1,0.0,0.0
favorit,www.antena3.ro,0,1,0,1,-1.0,1.0
Nicușor Constantin,www.mediafax.ro,0,0,1,1,0.0,0.0
Bucureștean,www.mediafax.ro,0,0,1,1,0.0,0.0
Bogdan Maran,www.gandul.ro,0,0,1,1,0.0,0.0
Băluță,www.gandul.ro,0,0,1,1,0.0,0.0
Cătălina Filip,www.gandul.ro,0,0,1,1,0.0,0.0
Dragoș Cristescu,www.gandul.ro,0,0,1,1,0.0,0.0
Daciana Sârbu,www.gandul.ro,0,1,0,1,-1.0,1.0
Dan Diaconescu,www.gandul.ro,0,0,1,1,0.0,0.0
Daniele Popa,www.gandul.ro,0,0,1,1,0.0,0.0
Dorin Cocoș,www.gandul.ro,0,1,0,1,-1.0,1.0
EBA,www.gandul.ro,0,0,1,1,0.0,0.0
Elena Băsescu,www.gandul.ro,0,1,1,2,-0.5,0.5
Femeia Cameleon,www.gandul.ro,0,0,1,1,0.0,0.0
Femeia Paravan,www.gandul.ro,0,1,0,1,-1.0,1.0
Mona Muscă,www.gandul.ro,0,0,1,1,0.0,0.0
Monica Macovei,www.gandul.ro,0,0,1,1,0.0,0.0
Oana Băluță,www.gandul.ro,1,0,1,2,0.5,0.5
Petrache,www.gandul.ro,0,1,0,1,-1.0,1.0
Sebastian Ghiță,www.gandul.ro,0,1,0,1,-1.0,1.0
Simonei Man,www.gandul.ro,0,0,1,1,0.0,0.0
Udrea,www.gandul.ro,0,1,0,1,-1.0,1.0
activistă,www.gandul.ro,0,1,0,1,-1.0,1.0
conferențiar universitar,www.gandul.ro,0,0,1,1,0.0,0.0
deținător,www.gandul.ro,0,1,0,1,-1.0,1.0
Renate Weber,www.gandul.ro,0,0,1,1,0.0,0.0
Minodora Cliveti,www.gandul.ro,0,0,1,1,0.0,0.0
Gabriela Crețu,www.gandul.ro,0,0,1,1,0.0,0.0
Che Guevara,adevarul.ro,0,0,1,1,0.0,0.0
Dansul,adevarul.ro,0,0,1,1,0.0,0.0
cameleon,adevarul.ro,0,1,0,1,-1.0,1.0
domnul Simeon,adevarul.ro,0,0,1,1,0.0,0.0
Crina Dobre,www.news.ro,0,0,1,1,0.0,0.0
Dana Budeanu,www.news.ro,0,1,0,1,-1.0,1.0
Rareș,www.news.ro,0,1,0,1,-1.0,1.0
Vasile Blaga,www.news.ro,0,1,0,1,-1.0,1.0
peneliști,www.news.ro,0,1,0,1,-1.0,1.0
Marian Ceaușescu,www.news.ro,0,0,1,1,0.0,0.0
reporter,www.news.ro,0,0,1,1,0.0,0.0
greblă,www.digi24.ro,0,1,1,2,-0.5,0.5
Barna,adevarul.ro,0,1,0,1,-1.0,1.0
Cristian Ghinea,adevarul.ro,0,1,1,2,-0.5,0.5
Mihai Caraman,www.cotidianul.ro,0,1,0,1,-1.0,1.0
Mircea Malița,www.cotidianul.ro,0,1,0,1,-1.0,1.0
mentor,www.cotidianul.ro,0,1,0,1,-1.0,1.0
Pitești,www.mediafax.ro,0,0,1,1,0.0,0.0
Liviu Pleșoianu,www.gandul.ro,0,0,1,1,0.0,0.0
Neptun,www.gandul.ro,0,0,1,1,0.0,0.0
Șerban Nicolae,www.gandul.ro,0,0,1,1,0.0,0.0
Guillermo Vilas,www.antena3.ro,0,0,1,1,0.0,0.0
Ilie Năstase,www.antena3.ro,0,0,1,1,0.0,0.0
Melbourne,www.antena3.ro,0,0,1,1,0.0,0.0
Nadia Comăneci,www.antena3.ro,0,0,1,1,0.0,0.0
glorie,www.antena3.ro,0,0,1,1,0.0,0.0
număr,www.antena3.ro,0,0,1,1,0.0,0.0
tenismen,www.antena3.ro,0,0,1,1,0.0,0.0
Irinel Darău,adevarul.ro,0,0,2,2,0.0,0.0
Alfred Simonis,www.euronews.ro,0,0,1,1,0.0,0.0
participant,www.euronews.ro,0,0,1,1,0.0,0.0
Borlești,recorder.ro,0,1,0,1,-1.0,1.0
Cel,recorder.ro,0,0,1,1,0.0,0.0
Drăgușeni,recorder.ro,0,1,0,1,-1.0,1.0
Floricica Dansatoarea,recorder.ro,0,0,1,1,0.0,0.0
părăsit,recorder.ro,0,1,0,1,-1.0,1.0
babelor,recorder.ro,0,1,0,1,-1.0,1.0
hipster,recorder.ro,0,1,0,1,-1.0,1.0
inamic,recorder.ro,0,1,0,1,-1.0,1.0
Tony Blair,www.mediafax.ro,0,0,1,1,0.0,0.0
Andy Ogles,www.news.ro,0,0,1,1,0.0,0.0
Anna Paulina Luna,www.news.ro,0,0,1,1,0.0,0.0
Dina Titus,www.news.ro,0,0,1,1,0.0,0.0
Ilhan Omar,www.news.ro,0,0,1,1,0.0,0.0
Lloyd Doggett,www.news.ro,0,0,1,1,0.0,0.0
Neal Dunn,www.news.ro,0,0,1,1,0.0,0.0
Ted Lieu,www.news.ro,0,0,1,1,0.0,0.0
Vern Buchanan,www.news.ro,0,0,1,1,0.0,0.0
Alin Bena,adevarul.ro,0,0,1,1,0.0,0.0
George Calin Brian Brown,www.comisarul.ro,0,0,1,1,0.0,0.0
Masha Gessen,www.comisarul.ro,0,1,0,1,-1.0,1.0
Tbilisi,www.comisarul.ro,0,0,1,1,0.0,0.0
exponent,www.comisarul.ro,0,0,1,1,0.0,0.0
homosexual,www.comisarul.ro,0,1,0,1,-1.0,1.0
lesbiană,www.comisarul.ro,0,1,0,1,-1.0,1.0
mame,www.comisarul.ro,0,0,2,2,0.0,0.0
Maria Zaharova,www.euronews.ro,0,0,1,1,0.0,0.0
Mariei Zaharova,www.euronews.ro,0,0,1,1,0.0,0.0
Zaharova,www.euronews.ro,0,1,0,1,-1.0,1.0
Avramescu,a1.ro,0,1,0,1,-1.0,1.0
Baconschi,a1.ro,0,1,0,1,-1.0,1.0
Barcelona,a1.ro,0,0,1,1,0.0,0.0
Cătălin Avrămescu,a1.ro,0,0,1,1,0.0,0.0
Corlatean,a1.ro,0,0,1,1,0.0,0.0
Cynthia Curt,a1.ro,0,1,1,2,-0.5,0.5
Estonia,a1.ro,0,0,1,1,0.0,0.0
Finlanda,a1.ro,0,0,1,1,0.0,0.0
Titus Corlătean,a1.ro,0,0,1,1,0.0,0.0
diplomat,a1.ro,0,1,1,2,-0.5,0.5
AELS,adevarul.ro,0,0,1,1,0.0,0.0
Mureș,adevarul.ro,0,0,1,1,0.0,0.0
Odobescu,adevarul.ro,0,0,1,1,0.0,0.0
Prim-ministru,adevarul.ro,0,0,1,1,0.0,0.0
cavaler,adevarul.ro,0,0,1,1,0.0,0.0
Călin Gorgescu,adevarul.ro,0,0,1,1,0.0,0.0
Ovidiu Ganț,www.gandul.ro,0,0,1,1,0.0,0.0
Anca Orheian,adevarul.ro,0,0,1,1,0.0,0.0
Anca Suciu,adevarul.ro,0,0,1,1,0.0,0.0
Andreea Dumitrescu,adevarul.ro,0,0,1,1,0.0,0.0
Claudiu Pândaru,adevarul.ro,0,0,1,1,0.0,0.0
Cristi Citre,adevarul.ro,0,0,1,1,0.0,0.0
Lili Ruse,adevarul.ro,0,0,1,1,0.0,0.0
Managing Director,adevarul.ro,0,0,1,1,0.0,0.0
Roxana Lăzărescu,adevarul.ro,0,0,1,1,0.0,0.0
Sabin Orcan,adevarul.ro,0,0,1,1,0.0,0.0
Makaveli,www.comisarul.ro,0,1,0,1,-1.0,1.0
Spătaru,www.b1tv.ro,0,1,0,1,-1.0,1.0
Chiruță,pressone.ro,0,0,1,1,0.0,0.0
Dragoș Stancă,pressone.ro,0,0,1,1,0.0,0.0
Hrițuc,pressone.ro,0,0,1,1,0.0,0.0
Mark Zuckerberg,pressone.ro,0,1,0,1,-1.0,1.0
Phillip N. Howard,pressone.ro,0,1,0,1,-1.0,1.0
Răzvan Chiruță,pressone.ro,0,0,1,1,0.0,0.0
Samantha Bradshaw,pressone.ro,0,1,0,1,-1.0,1.0
Tăpălagă,pressone.ro,0,1,0,1,-1.0,1.0
Oana Mihăilă,observatornews.ro,0,0,1,1,0.0,0.0
Valeriu Gheorghiță,observatornews.ro,0,0,1,1,0.0,0.0
Nadiei Comăneci,primanews.ro,0,0,1,1,0.0,0.0
inițiator,primanews.ro,0,0,1,1,0.0,0.0
sportiv,primanews.ro,1,0,0,1,1.0,1.0
Călin Tăriceanu,www.mediafax.ro,0,0,1,1,0.0,0.0
Dacian,www.mediafax.ro,0,0,1,1,0.0,0.0
Pașcani,www.mediafax.ro,0,1,0,1,-1.0,1.0
Siret,www.mediafax.ro,0,0,1,1,0.0,0.0
comunicator,www.mediafax.ro,0,1,0,1,-1.0,1.0
liberal,www.mediafax.ro,0,1,0,1,-1.0,1.0
proști,www.mediafax.ro,0,1,0,1,-1.0,1.0
subordonat,www.mediafax.ro,0,1,0,1,-1.0,1.0
George Jiglău,www.comisarul.ro,0,0,5,5,0.0,0.0
Andrei Gușa,agerpres.ro,0,2,0,2,-1.0,1.0
Andrei Gușă,agerpres.ro,0,2,0,2,-1.0,1.0
Andrew Jackson,agerpres.ro,0,0,1,1,0.0,0.0
Diana Iovanovici,agerpres.ro,0,0,1,1,0.0,0.0
trădător,agerpres.ro,0,1,0,1,-1.0,1.0
Huși,www.euronews.ro,0,0,1,1,0.0,0.0
administrator,www.euronews.ro,0,0,1,1,0.0,0.0
aparținător,www.euronews.ro,0,1,0,1,-1.0,1.0
bolnav,www.euronews.ro,0,1,0,1,-1.0,1.0
colegiu,www.euronews.ro,0,0,1,1,0.0,0.0
soț,www.euronews.ro,0,0,1,1,0.0,0.0
Bob Wickers,snoop.ro,0,0,2,2,0.0,0.0
Boris Elțin,snoop.ro,0,0,1,1,0.0,0.0
Bratislava,snoop.ro,0,0,1,1,0.0,0.0
Burgr,snoop.ro,0,0,1,1,0.0,0.0
Cristian Seidler,snoop.ro,0,0,3,3,0.0,0.0
Hanna Poliacikova,snoop.ro,0,0,1,1,0.0,0.0
Martin Burgr,snoop.ro,0,0,1,1,0.0,0.0
Martin Poliacik,snoop.ro,0,0,1,1,0.0,0.0
Michaela Sedovicova,snoop.ro,0,0,1,1,0.0,0.0
Petr Pavel,snoop.ro,1,0,1,2,0.5,0.5
Poliacik,snoop.ro,0,0,1,1,0.0,0.0
Poliacikova,snoop.ro,0,0,1,1,0.0,0.0
Seidler,snoop.ro,0,0,1,1,0.0,0.0
Zuzana Caputova,snoop.ro,0,0,1,1,0.0,0.0
consultant politic,snoop.ro,0,0,1,1,0.0,0.0
fiecare,www.comisarul.ro,1,0,0,1,1.0,1.0
toți,observatornews.ro,0,1,0,1,-1.0,1.0
Cezar Marin,a1.ro,0,0,1,1,0.0,0.0
Borbely,a1.ro,0,1,0,1,-1.0,1.0
Marin,a1.ro,0,1,0,1,-1.0,1.0
secretar de stat,a1.ro,0,0,3,3,0.0,0.0
Daniel Șandru,www.g4media.ro,0,0,2,2,0.0,0.0
ior,www.gandul.ro,0,0,1,1,0.0,0.0
aliaț,www.gandul.ro,0,0,1,1,0.0,0.0
Cucșa,www.g4media.ro,0,0,1,1,0.0,0.0
Marian Cucșa,www.g4media.ro,0,0,1,1,0.0,0.0
concurent,www.g4media.ro,0,1,0,1,-1.0,1.0
chelner,a1.ro,0,1,0,1,-1.0,1.0
Anglia,adevarul.ro,0,0,1,1,0.0,0.0
Dan Negru,adevarul.ro,0,0,1,1,0.0,0.0
Mircea Radu,adevarul.ro,0,0,1,1,0.0,0.0
homosexual,adevarul.ro,0,2,1,3,-0.6666666666666666,0.6666666666666666
mamică,adevarul.ro,0,1,0,1,-1.0,1.0
Nicolae Vacaroiu,adevarul.ro,0,1,0,1,-1.0,1.0
ostaș,adevarul.ro,0,1,0,1,-1.0,1.0
Biertan,pressone.ro,0,0,1,1,0.0,0.0
Ciumârna,pressone.ro,0,1,0,1,-1.0,1.0
Colțești,pressone.ro,1,0,0,1,1.0,1.0
Câmpulung Moldovenesc,pressone.ro,1,0,1,2,0.5,0.5
Doru Frolu,pressone.ro,0,0,2,2,0.0,0.0
Hoghilag,pressone.ro,1,0,0,1,1.0,1.0
Ionuț,pressone.ro,1,0,0,1,1.0,1.0
Ionuț Diaconeasa,pressone.ro,1,0,1,2,0.5,0.5
Ionuț Loba,pressone.ro,1,0,0,1,1.0,1.0
Rimetea,pressone.ro,1,0,0,1,1.0,1.0
Rimetei,pressone.ro,0,1,0,1,-1.0,1.0
Stelian,pressone.ro,0,0,1,1,0.0,0.0
Stelian Burduhos,pressone.ro,0,0,2,2,0.0,0.0
Szilard Levente Deak Szekely,pressone.ro,0,0,1,1,0.0,0.0
cofondator,pressone.ro,0,0,1,1,0.0,0.0
Mirela Furtună,agerpres.ro,0,0,1,1,0.0,0.0
Manda,agerpres.ro,0,0,1,1,0.0,0.0
Olguța Vasilescu,agerpres.ro,0,0,1,1,0.0,0.0
Claudiu Manda,agerpres.ro,0,0,1,1,0.0,0.0
soție,agerpres.ro,0,0,1,1,0.0,0.0
sursă,www.activenews.ro,0,0,1,1,0.0,0.0
Alexandru Păcuraru,www.euronews.ro,0,0,1,1,0.0,0.0
Anna Birchall,www.euronews.ro,0,0,1,1,0.0,0.0
Cătălin Georgescu,www.euronews.ro,0,0,1,1,0.0,0.0
Mircea,www.euronews.ro,0,0,1,1,0.0,0.0
pierzător,www.euronews.ro,0,1,0,1,-1.0,1.0
Siebenbürgen,a1.ro,0,0,1,1,0.0,0.0
Tara Romaneasca,a1.ro,0,0,1,1,0.0,0.0
Transilvania,a1.ro,0,0,1,1,0.0,0.0
Andras,www.comisarul.ro,0,1,0,1,-1.0,1.0
András Kurkó,www.comisarul.ro,0,0,1,1,0.0,0.0
Barti Tihamer,www.comisarul.ro,0,3,0,3,-1.0,1.0
Kurko András,www.comisarul.ro,0,1,0,1,-1.0,1.0
Tihamert Barti,www.comisarul.ro,0,0,1,1,0.0,0.0
Tihamér Barti,www.comisarul.ro,0,0,2,2,0.0,0.0
Kurko Andras,www.comisarul.ro,0,2,0,2,-1.0,1.0
Kurko,www.comisarul.ro,0,0,1,1,0.0,0.0
lucrător,www.comisarul.ro,0,0,1,1,0.0,0.0
Csoma Botond,www.mediafax.ro,0,0,1,1,0.0,0.0
martor,adevarul.ro,0,0,1,1,0.0,0.0
Marian Motocu,adevarul.ro,0,1,0,1,-1.0,1.0
Valeriu Iftime,adevarul.ro,0,0,1,1,0.0,0.0
lie Bolojan,adevarul.ro,0,0,1,1,0.0,0.0
Flutur,stirileprotv.ro,0,0,1,1,0.0,0.0
Gheorghe Flutur,stirileprotv.ro,0,0,1,1,0.0,0.0
Andrei Spînu,www.realitatea.net,0,2,0,2,-1.0,1.0
Chișinău,www.realitatea.net,0,0,1,1,0.0,0.0
Carmen Dan,www.aktual24.ro,0,0,1,1,0.0,0.0
Mara Mareș,adevarul.ro,0,0,1,1,0.0,0.0
Mareș,adevarul.ro,0,1,0,1,-1.0,1.0
Craiova,www.news.ro,0,0,1,1,0.0,0.0
Anca,www.romaniatv.net,0,0,1,1,0.0,0.0
Anca Alexandrescu,www.romaniatv.net,0,1,0,1,-1.0,1.0
BECALI,www.romaniatv.net,0,0,1,1,0.0,0.0
bai,www.romaniatv.net,0,1,0,1,-1.0,1.0
Dragoș Bistriceanu,www.romaniatv.net,0,0,2,2,0.0,0.0
Georgica,www.romaniatv.net,0,2,0,2,-1.0,1.0
Victor,www.romaniatv.net,0,0,2,2,0.0,0.0
ală,www.romaniatv.net,0,1,0,1,-1.0,1.0
amandă,www.romaniatv.net,0,1,0,1,-1.0,1.0
bagabont,www.romaniatv.net,0,1,0,1,-1.0,1.0
bă,www.romaniatv.net,0,1,0,1,-1.0,1.0
Potra,www.romaniatv.net,0,0,1,1,0.0,0.0
hot,www.romaniatv.net,0,1,0,1,-1.0,1.0
nea,www.romaniatv.net,0,1,0,1,-1.0,1.0
Sebastian Zachmann,adevarul.ro,0,1,0,1,-1.0,1.0
trădător,adevarul.ro,0,2,0,2,-1.0,1.0
extremist,adevarul.ro,0,2,0,2,-1.0,1.0
Adriana Neagoe,pressone.ro,0,0,1,1,0.0,0.0
Berlin,pressone.ro,0,0,1,1,0.0,0.0
George Simon,pressone.ro,0,0,1,1,0.0,0.0
Rareș,pressone.ro,0,0,1,1,0.0,0.0
Renata Mogîldea,pressone.ro,0,0,1,1,0.0,0.0
Sandu,pressone.ro,0,0,2,2,0.0,0.0
înaintaș,pressone.ro,0,1,0,1,-1.0,1.0
șef adjunct,pressone.ro,0,1,0,1,-1.0,1.0
Toader Paleologu,adevarul.ro,0,0,3,3,0.0,0.0
Tănase,adevarul.ro,0,1,0,1,-1.0,1.0
tinichigiu,adevarul.ro,0,1,0,1,-1.0,1.0
șomer,adevarul.ro,0,0,1,1,0.0,0.0
Allen Coliban,stirileprotv.ro,0,0,1,1,0.0,0.0
Vicepreședintele,stirileprotv.ro,0,0,1,1,0.0,0.0
Zuckermann,stirileprotv.ro,0,1,0,1,-1.0,1.0
baron,stirileprotv.ro,0,1,0,1,-1.0,1.0
bunică,stirileprotv.ro,1,0,0,1,1.0,1.0
fan,stirileprotv.ro,0,1,0,1,-1.0,1.0
fricos,stirileprotv.ro,0,1,0,1,-1.0,1.0
izolaționist,stirileprotv.ro,0,1,0,1,-1.0,1.0
salvator,stirileprotv.ro,0,1,0,1,-1.0,1.0
spectator,stirileprotv.ro,0,1,0,1,-1.0,1.0
Cristi Misăilă,pressone.ro,0,2,0,2,-1.0,1.0
Cârmaci,pressone.ro,0,1,0,1,-1.0,1.0
Grindă,pressone.ro,0,1,0,1,-1.0,1.0
Liviu Pogorevici,pressone.ro,0,1,0,1,-1.0,1.0
Lucreția Dumbravă,pressone.ro,0,0,1,1,0.0,0.0
Marian Oprișan,pressone.ro,0,1,0,1,-1.0,1.0
Misăilă,pressone.ro,0,1,0,1,-1.0,1.0
Oprișan,pressone.ro,0,1,0,1,-1.0,1.0
Pogorevici,pressone.ro,0,1,1,2,-0.5,0.5
Ion Ștefan,pressone.ro,0,1,0,1,-1.0,1.0
star,pressone.ro,0,0,1,1,0.0,0.0
André Ventura,primanews.ro,0,0,1,1,0.0,0.0
Chega,primanews.ro,0,1,0,1,-1.0,1.0
Luís Montenegro,primanews.ro,0,1,0,1,-1.0,1.0
Montenegro,primanews.ro,0,1,1,2,-0.5,0.5
Rafał Trzaskowski,primanews.ro,1,0,0,1,1.0,1.0
Slovacia,primanews.ro,0,1,0,1,-1.0,1.0
Tusk,primanews.ro,0,0,1,1,0.0,0.0
comentator,primanews.ro,0,0,1,1,0.0,0.0
Cătălin Cîrstoiu,www.romaniatv.net,0,0,4,4,0.0,0.0
Remus Ștefureac,www.romaniatv.net,0,1,0,1,-1.0,1.0
respondent,www.romaniatv.net,0,0,3,3,0.0,0.0
prieten,www.b1tv.ro,2,0,3,5,0.4,0.4
Slovacia,www.romaniatv.net,0,1,1,2,-0.5,0.5
Marius Pieleanu,www.romaniatv.net,0,0,1,1,0.0,0.0
șepcă,www.romaniatv.net,0,1,0,1,-1.0,1.0
purtător,www.aktual24.ro,0,0,1,1,0.0,0.0
Adrian Nastase,www.romaniatv.net,0,0,1,1,0.0,0.0
Adriane,www.romaniatv.net,0,1,0,1,-1.0,1.0
Grindeanu,www.romaniatv.net,0,1,1,2,-0.5,0.5
Marian Vanghelie,www.romaniatv.net,0,1,0,1,-1.0,1.0
Nastase,www.romaniatv.net,0,0,1,1,0.0,0.0
Rovinari,www.romaniatv.net,0,1,0,1,-1.0,1.0
succesor,www.romaniatv.net,0,0,1,1,0.0,0.0
Turceni,www.romaniatv.net,0,1,0,1,-1.0,1.0
Sorin Ovidiu Vantu,www.romaniatv.net,0,1,0,1,-1.0,1.0
multi,www.romaniatv.net,0,0,1,1,0.0,0.0
predecesor,www.romaniatv.net,0,0,1,1,0.0,0.0
purtător,www.romaniatv.net,0,1,0,1,-1.0,1.0
Daniel Blaga,observatornews.ro,0,1,0,1,-1.0,1.0
Georgeta Holban,observatornews.ro,0,0,1,1,0.0,0.0
Nicolae Roman,observatornews.ro,0,0,1,1,0.0,0.0
Victor Ilie,observatornews.ro,0,0,1,1,0.0,0.0
Alina Greavu,pressone.ro,0,0,1,1,0.0,0.0
Aluzivei,pressone.ro,0,0,1,1,0.0,0.0
Andreea Raicu,pressone.ro,0,0,2,2,0.0,0.0
Andreei,pressone.ro,0,0,1,1,0.0,0.0
Decembrie,pressone.ro,0,0,1,1,0.0,0.0
George Stănculescu,pressone.ro,0,0,2,2,0.0,0.0
Neptun,pressone.ro,0,0,1,1,0.0,0.0
Slobozia,pressone.ro,0,1,0,1,-1.0,1.0
ipochimen,www.cotidianul.ro,0,1,0,1,-1.0,1.0
ofițer,www.cotidianul.ro,0,1,0,1,-1.0,1.0
subordonat,www.cotidianul.ro,0,1,0,1,-1.0,1.0
urmaș,www.cotidianul.ro,0,1,0,1,-1.0,1.0
Alfred Moses,recorder.ro,0,0,1,1,0.0,0.0
Anne Applebaum,recorder.ro,0,0,1,1,0.0,0.0
Arsenie Papacioc,recorder.ro,0,0,1,1,0.0,0.0
Asko Sahlberg,recorder.ro,0,0,1,1,0.0,0.0
Beba Veche,recorder.ro,0,0,1,1,0.0,0.0
California,recorder.ro,0,0,1,1,0.0,0.0
Claudiu Martin Chira,recorder.ro,0,0,1,1,0.0,0.0
Cosmin Șandru,recorder.ro,0,0,1,1,0.0,0.0
creator,recorder.ro,1,0,0,1,1.0,1.0
Dan Reștinec,recorder.ro,0,0,1,1,0.0,0.0
Daniel Liviu Toda,recorder.ro,0,0,1,1,0.0,0.0
Ernst Jünger,recorder.ro,0,0,1,1,0.0,0.0
Eugen Dogariu,recorder.ro,0,0,1,1,0.0,0.0
Frankfurt,recorder.ro,0,0,1,1,0.0,0.0
George Martin,recorder.ro,0,0,1,1,0.0,0.0
Gilles Whittell,recorder.ro,0,0,1,1,0.0,0.0
Henryk Sienkiewicz,recorder.ro,0,0,1,1,0.0,0.0
Ionuț Sorinel Gaiță,recorder.ro,0,0,1,1,0.0,0.0
Machiavelli,recorder.ro,1,1,1,3,0.0,0.0
Marilen Pirtea,recorder.ro,0,0,1,1,0.0,0.0
Mihail Neamțu,recorder.ro,0,0,1,1,0.0,0.0
Mihăiță Bojin,recorder.ro,0,0,1,1,0.0,0.0
Nicolae Birău,recorder.ro,0,0,1,1,0.0,0.0
Nicolae Titulescu,recorder.ro,0,0,1,1,0.0,0.0
Nicu Fălcoi,recorder.ro,0,0,1,1,0.0,0.0
Piatra,recorder.ro,0,1,0,1,-1.0,1.0
Platon,recorder.ro,0,0,1,1,0.0,0.0
Radu Adrian Pau,recorder.ro,0,0,1,1,0.0,0.0
Raoul Adrian Trifan,recorder.ro,0,0,1,1,0.0,0.0
Rwanda,recorder.ro,0,0,1,1,0.0,0.0
Variaș,recorder.ro,0,0,1,1,0.0,0.0
"Washington, D.C.",recorder.ro,0,0,1,1,0.0,0.0
coautor,recorder.ro,0,0,1,1,0.0,0.0
Adi Pau,recorder.ro,1,0,0,1,1.0,1.0
cunoscător,recorder.ro,2,0,0,2,1.0,1.0
dezvoltator,recorder.ro,0,1,1,2,-0.5,0.5
domnișoară,recorder.ro,0,0,1,1,0.0,0.0
informatician,recorder.ro,0,0,1,1,0.0,0.0
nou,recorder.ro,1,0,0,1,1.0,1.0
pastor,recorder.ro,0,0,1,1,0.0,0.0
prietena,recorder.ro,0,0,1,1,0.0,0.0
Eugeniu de Savoia,recorder.ro,1,0,0,1,1.0,1.0
Mircea Mihăieș,recorder.ro,0,0,1,1,0.0,0.0
timișean,recorder.ro,1,0,1,2,0.5,0.5
Lucian Romașcanu,www.comisarul.ro,0,0,1,1,0.0,0.0
Nikolai Morozov,www.gandul.ro,0,0,2,2,0.0,0.0
Tucă,www.gandul.ro,0,0,1,1,0.0,0.0
Adrian Axinia,www.comisarul.ro,0,0,1,1,0.0,0.0
Baconschi,www.b1tv.ro,0,0,1,1,0.0,0.0
Mihai Răzvan Ungureanu,www.b1tv.ro,0,0,1,1,0.0,0.0
Teodor Baconschi,www.b1tv.ro,0,0,1,1,0.0,0.0
Crina Muntean,www.comisarul.ro,0,1,0,1,-1.0,1.0
Cătălin Voicu,www.comisarul.ro,0,0,2,2,0.0,0.0
Daniela Panioglu,www.comisarul.ro,0,1,0,1,-1.0,1.0
Lia Savonea,www.comisarul.ro,0,1,2,3,-0.3333333333333333,0.3333333333333333
Lelia Savonea,www.comisarul.ro,0,0,1,1,0.0,0.0
Marian Vanghelie,www.comisarul.ro,0,0,1,1,0.0,0.0
Mario Iorgulescu,www.comisarul.ro,0,0,1,1,0.0,0.0
Savonea,www.comisarul.ro,0,1,0,1,-1.0,1.0
Voicu,www.comisarul.ro,0,0,1,1,0.0,0.0
apărător,www.comisarul.ro,0,0,1,1,0.0,0.0
Cezar Bivolaru,www.comisarul.ro,0,0,1,1,0.0,0.0
Mihai Savonea,www.comisarul.ro,0,0,1,1,0.0,0.0
Corina Corbu,www.comisarul.ro,0,0,1,1,0.0,0.0
judecătoare,www.comisarul.ro,0,0,1,1,0.0,0.0
Cristian Terheș,www.digi24.ro,0,1,1,2,-0.5,0.5
Popescu,www.digi24.ro,0,1,0,1,-1.0,1.0
Sebastian Popescu,www.digi24.ro,0,0,1,1,0.0,0.0
Terheș,www.digi24.ro,0,1,0,1,-1.0,1.0
boți,www.digi24.ro,0,1,0,1,-1.0,1.0
Belgia,www.b1tv.ro,0,0,1,1,0.0,0.0
fiică,www.b1tv.ro,0,0,1,1,0.0,0.0
Adrian Veștea,www.g4media.ro,0,0,1,1,0.0,0.0
Adrian Veștea Bolojan,www.g4media.ro,0,0,1,1,0.0,0.0
Ciprian Ciuc,www.g4media.ro,0,0,1,1,0.0,0.0
Valeriu Iftime,www.g4media.ro,0,0,2,2,0.0,0.0
Dragii,www.gandul.ro,0,1,0,1,-1.0,1.0
Drag,www.gandul.ro,0,0,1,1,0.0,0.0
patriot,www.gandul.ro,1,0,0,1,1.0,1.0
Elek,pressone.ro,0,0,1,1,0.0,0.0
Elek Levente,pressone.ro,0,0,1,1,0.0,0.0
Poiana Brașov,pressone.ro,0,0,1,1,0.0,0.0
Doljul,agerpres.ro,0,1,0,1,-1.0,1.0
doljeni,agerpres.ro,0,1,0,1,-1.0,1.0
doljen,agerpres.ro,1,0,0,1,1.0,1.0
voluntar,agerpres.ro,1,0,0,1,1.0,1.0
Shiraz,www.mediafax.ro,0,1,0,1,-1.0,1.0
Teheran,www.mediafax.ro,0,0,1,1,0.0,0.0
Dublin,observatornews.ro,0,0,1,1,0.0,0.0
Serbia,observatornews.ro,0,0,1,1,0.0,0.0
Vienei,observatornews.ro,0,0,1,1,0.0,0.0
emigrant,observatornews.ro,0,2,0,2,-1.0,1.0
migrant,observatornews.ro,0,0,1,1,0.0,0.0
Cristian Năsulea,www.euronews.ro,0,0,1,1,0.0,0.0
geniu,www.euronews.ro,0,0,1,1,0.0,0.0
Georgia,www.euronews.ro,0,0,1,1,0.0,0.0
Orhei,www.euronews.ro,0,0,1,1,0.0,0.0
Podgoreni,www.euronews.ro,0,0,1,1,0.0,0.0
Gelu Duminică,www.euronews.ro,0,0,2,2,0.0,0.0
Strasbourg,www.euronews.ro,0,0,1,1,0.0,0.0
Tbilisi,www.euronews.ro,0,0,1,1,0.0,0.0
localnic,www.euronews.ro,0,0,1,1,0.0,0.0
scutier,www.euronews.ro,0,0,1,1,0.0,0.0
profesor universitar,www.aktual24.ro,0,0,1,1,0.0,0.0
Toader Paleologu,www.aktual24.ro,0,0,1,1,0.0,0.0
Alex,a1.ro,1,0,0,1,1.0,1.0
Cole,a1.ro,0,0,1,1,0.0,0.0
Doug,a1.ro,0,0,2,2,0.0,0.0
Doug Emhoff,a1.ro,0,0,1,1,0.0,0.0
Ella,a1.ro,0,0,1,1,0.0,0.0
Ella Fitzgerald,a1.ro,0,0,1,1,0.0,0.0
Harris,a1.ro,0,0,1,1,0.0,0.0
Kerstin Emhoff,a1.ro,0,0,1,1,0.0,0.0
Momala,a1.ro,1,0,0,1,1.0,1.0
Bernie Sanders,a1.ro,0,1,0,1,-1.0,1.0
Vance,a1.ro,0,1,0,1,-1.0,1.0
prietenă,a1.ro,1,0,0,1,1.0,1.0
JD Vance,a1.ro,0,0,1,1,0.0,0.0
Poiana Brașov,a1.ro,0,0,1,1,0.0,0.0
oaspete,a1.ro,0,1,0,1,-1.0,1.0
tătăl,a1.ro,0,1,0,1,-1.0,1.0
Amalia Bellantoni,www.gandul.ro,0,0,1,1,0.0,0.0
Dianei Iovanovici Șoșoacă,www.gandul.ro,0,0,1,1,0.0,0.0
Miron Cosma,www.gandul.ro,0,0,1,1,0.0,0.0
Talpoș Ioan,www.gandul.ro,0,0,1,1,0.0,0.0
Todiroaie Ioan,www.gandul.ro,0,0,1,1,0.0,0.0
Ursa Mihai Gheorghe,www.gandul.ro,0,0,1,1,0.0,0.0
Valerian Stan,www.gandul.ro,0,0,1,1,0.0,0.0
Șerban Puică,www.gandul.ro,0,0,1,1,0.0,0.0
Ioana Ramona Bruynseels,www.cotidianul.ro,0,0,1,1,0.0,0.0
reprezentantă,www.cotidianul.ro,0,0,1,1,0.0,0.0
Cristian Preda,www.gandul.ro,0,0,1,1,0.0,0.0
George Becali,www.gandul.ro,0,0,2,2,0.0,0.0
Preda,www.gandul.ro,0,0,1,1,0.0,0.0
Sever Voinescu,www.gandul.ro,0,0,2,2,0.0,0.0
Voinescu,www.gandul.ro,0,0,1,1,0.0,0.0
Costin,agerpres.ro,0,0,1,1,0.0,0.0
Cristian Anghelache,agerpres.ro,0,0,2,2,0.0,0.0
Dumitru Costin,agerpres.ro,0,0,1,1,0.0,0.0
bucurești,a1.ro,0,0,1,1,0.0,0.0
multi,a1.ro,0,1,0,1,-1.0,1.0
Karl Nehammer,adevarul.ro,0,0,1,1,0.0,0.0
cancelar,adevarul.ro,0,0,1,1,0.0,0.0
Andreea Vass,a1.ro,0,0,1,1,0.0,0.0
Andrei Pippidi,a1.ro,0,0,1,1,0.0,0.0
Aurora Tarsoaga,a1.ro,0,0,1,1,0.0,0.0
Cornelia Gafiu,a1.ro,0,0,1,1,0.0,0.0
Csilla Hegedus,a1.ro,0,0,1,1,0.0,0.0
Gheorghe Patrascu,a1.ro,0,0,1,1,0.0,0.0
Ovidiu Popescu,a1.ro,0,0,2,2,0.0,0.0
Paleologu,a1.ro,0,0,2,2,0.0,0.0
Peter Derer,a1.ro,0,0,1,1,0.0,0.0
Rasmussen,a1.ro,0,0,1,1,0.0,0.0
Stolojan,a1.ro,0,1,0,1,-1.0,1.0
Irina Iamandescu,a1.ro,0,0,1,1,0.0,0.0
Ovidiu Nahoi,a1.ro,0,0,1,1,0.0,0.0
participant,a1.ro,0,0,1,1,0.0,0.0
Bianca Teodora Firezar,adevarul.ro,0,0,1,1,0.0,0.0
Bogdan Mazuru,adevarul.ro,0,0,1,1,0.0,0.0
Dan Nica,adevarul.ro,0,0,2,2,0.0,0.0
Diaconescu,adevarul.ro,1,1,2,4,0.0,0.0
Elena Udrea,adevarul.ro,0,4,1,5,-0.8,0.8
Ion Oprișor,adevarul.ro,0,0,1,1,0.0,0.0
Mihai Răzvan Ungureanu,adevarul.ro,0,0,3,3,0.0,0.0
Simona Livia Maftei,adevarul.ro,0,0,1,1,0.0,0.0
Agnes Erich,www.g4media.ro,0,0,1,1,0.0,0.0
Corneliu Sălișteanu,www.g4media.ro,0,0,1,1,0.0,0.0
Corneliu Ștefan,www.g4media.ro,0,0,1,1,0.0,0.0
Felix Georgescu,www.g4media.ro,0,0,1,1,0.0,0.0
Ioana Radu,www.g4media.ro,0,0,1,1,0.0,0.0
Ionuț Săvoiu,www.g4media.ro,0,0,1,1,0.0,0.0
Laurențiu Neculaescu,www.g4media.ro,0,0,1,1,0.0,0.0
Mihai Istrate,www.g4media.ro,0,0,1,1,0.0,0.0
Niculești,www.g4media.ro,0,0,1,1,0.0,0.0
Titus Corlățean,www.g4media.ro,0,0,1,1,0.0,0.0
Dumitru Barbu,www.g4media.ro,0,0,1,1,0.0,0.0
consilier județean,www.g4media.ro,0,0,1,1,0.0,0.0
Carmen Holban,www.g4media.ro,0,0,1,1,0.0,0.0
Radu Popa,www.g4media.ro,0,0,1,1,0.0,0.0
medic pediatru,www.g4media.ro,0,0,1,1,0.0,0.0
Claudia Gilia,www.g4media.ro,0,0,1,1,0.0,0.0
Florin Georgescu,www.g4media.ro,0,0,1,1,0.0,0.0
Ileana Stana Ionescu,observatornews.ro,1,0,1,2,0.5,0.5
actriță,observatornews.ro,1,0,0,1,1.0,1.0
Andrei Ionescu,observatornews.ro,1,0,0,1,1.0,1.0
Ciprian Dobre,www.cotidianul.ro,0,2,0,2,-1.0,1.0
Dorin Laurențiu Ionescu,www.gandul.ro,0,0,1,1,0.0,0.0
Dănuț Lupu,www.gandul.ro,0,1,0,1,-1.0,1.0
Ionuț Luțu,www.gandul.ro,0,0,1,1,0.0,0.0
șofer,www.gandul.ro,0,4,1,5,-0.8,0.8
Cluj Napoca,primanews.ro,0,0,1,1,0.0,0.0
Cambodgia,www.romaniatv.net,0,0,1,1,0.0,0.0
Cristian Preda,www.romaniatv.net,0,0,1,1,0.0,0.0
Preda,www.romaniatv.net,0,0,1,1,0.0,0.0
Steve Bannon,www.activenews.ro,0,0,1,1,0.0,0.0
Cristian Tudor Popescu,www.romaniatv.net,0,0,4,4,0.0,0.0
gazetar,www.romaniatv.net,0,1,2,3,-0.3333333333333333,0.3333333333333333
Zoltán Soós,www.mediafax.ro,0,1,0,1,-1.0,1.0
Târgu Mureș,www.mediafax.ro,0,0,2,2,0.0,0.0
afacerist,www.mediafax.ro,0,1,0,1,-1.0,1.0
Kovács Mihály Levente,www.mediafax.ro,0,0,1,1,0.0,0.0
Anton Pisaroglu,www.aktual24.ro,0,0,1,1,0.0,0.0
Pisaroglu,www.aktual24.ro,0,0,1,1,0.0,0.0
eu,www.b1tv.ro,0,1,0,1,-1.0,1.0
Robert Fico,www.b1tv.ro,0,0,1,1,0.0,0.0
Slovacia,www.b1tv.ro,0,0,1,1,0.0,0.0
Slovac,www.b1tv.ro,0,1,0,1,-1.0,1.0
fanatic,www.b1tv.ro,0,2,0,2,-1.0,1.0
manifestanț,www.b1tv.ro,0,1,0,1,-1.0,1.0
provocator,www.b1tv.ro,0,1,0,1,-1.0,1.0
unit,www.b1tv.ro,0,1,0,1,-1.0,1.0
nemulțumit,www.antena3.ro,0,1,0,1,-1.0,1.0
Alexandra Bertalan,a1.ro,0,0,1,1,0.0,0.0
Mihaela,a1.ro,0,0,1,1,0.0,0.0
semen,primanews.ro,1,0,0,1,1.0,1.0
Ceaușescu,www.romaniatv.net,0,1,0,1,-1.0,1.0
Năstase,www.g4media.ro,0,0,1,1,0.0,0.0
Peiu,www.g4media.ro,0,0,1,1,0.0,0.0
Radu Vasile,www.g4media.ro,0,0,1,1,0.0,0.0
analist,www.g4media.ro,0,0,1,1,0.0,0.0
Austria,www.mediafax.ro,0,0,1,1,0.0,0.0
AU,www.aktual24.ro,0,1,0,1,-1.0,1.0
Covasna,www.aktual24.ro,0,1,0,1,-1.0,1.0
Damureanu,www.aktual24.ro,0,1,0,1,-1.0,1.0
domnului,www.aktual24.ro,2,0,0,2,1.0,1.0
Iosub,www.aktual24.ro,0,1,0,1,-1.0,1.0
Oltenia,www.aktual24.ro,0,2,0,2,-1.0,1.0
Ringo Damureanu,www.aktual24.ro,0,0,1,1,0.0,0.0
Tinutul Secuiesc,www.aktual24.ro,0,1,0,1,-1.0,1.0
Liliana Scripnic,www.aktual24.ro,0,0,1,1,0.0,0.0
impostor,www.aktual24.ro,0,1,0,1,-1.0,1.0
iubitor,www.aktual24.ro,0,1,0,1,-1.0,1.0
or,www.aktual24.ro,0,1,0,1,-1.0,1.0
Neagu,www.aktual24.ro,0,1,0,1,-1.0,1.0
Alina Mungiu Pippidi,www.aktual24.ro,0,1,1,2,-0.5,0.5
Angela Merkel,www.aktual24.ro,0,0,1,1,0.0,0.0
intreprinzător,www.aktual24.ro,0,0,1,1,0.0,0.0
Robert Alecu,www.cotidianul.ro,0,0,1,1,0.0,0.0
Budești,www.antena3.ro,0,0,1,1,0.0,0.0
Andrei Țăranu,www.b1tv.ro,0,0,2,2,0.0,0.0
Gabriela Firea,www.b1tv.ro,0,0,1,1,0.0,0.0
cadru didactic,www.b1tv.ro,0,0,1,1,0.0,0.0
Ștefureac,www.b1tv.ro,0,0,1,1,0.0,0.0
Satu Mare,www.aktual24.ro,0,0,1,1,0.0,0.0
Tulcea,www.aktual24.ro,0,0,1,1,0.0,0.0
Bangladesh,www.news.ro,3,0,0,3,1.0,1.0
Columbia,www.news.ro,0,0,2,2,0.0,0.0
Divia Desideria Cepeda Rojas,www.news.ro,0,0,1,1,0.0,0.0
Shahnaz Gazi,www.news.ro,2,0,1,3,0.6666666666666666,0.6666666666666666
Kuweit,www.news.ro,2,0,0,2,1.0,1.0
președinte interimar,www.news.ro,0,0,4,4,0.0,0.0
Mihai Fuiorea,www.g4media.ro,0,0,1,1,0.0,0.0
Alexandru Fifea,www.g4media.ro,0,0,1,1,0.0,0.0
Mihai Ene,www.g4media.ro,0,0,1,1,0.0,0.0
Ciprian Speranza,www.g4media.ro,0,0,1,1,0.0,0.0
Andrei Țăranu,www.g4media.ro,0,0,1,1,0.0,0.0
Radu Stochița,www.g4media.ro,0,0,1,1,0.0,0.0
cadru didactic universitar,www.g4media.ro,0,0,2,2,0.0,0.0
Andreea Petruț,www.g4media.ro,0,0,1,1,0.0,0.0
Claudiu Turcuș,www.g4media.ro,0,0,1,1,0.0,0.0
Tudor Ionuț,www.g4media.ro,0,0,1,1,0.0,0.0
Adrian Doboș,www.g4media.ro,0,0,1,1,0.0,0.0
Mihail Chiru,www.g4media.ro,0,0,1,1,0.0,0.0
Nona Șerbănescu,www.g4media.ro,0,0,1,1,0.0,0.0
Ciprian Mihali,www.g4media.ro,0,0,1,1,0.0,0.0
Ciprian Necula,www.g4media.ro,0,0,1,1,0.0,0.0
Claudiu Crăciun,www.g4media.ro,0,0,1,1,0.0,0.0
creatoare,www.g4media.ro,0,0,1,1,0.0,0.0
Cristian Cercel,www.g4media.ro,0,0,1,1,0.0,0.0
Emil Onea,www.g4media.ro,0,0,1,1,0.0,0.0
Florin Arhire,www.g4media.ro,0,0,1,1,0.0,0.0
Cosmin Cercel,www.g4media.ro,0,0,1,1,0.0,0.0
Gianina Cărbunariu,www.g4media.ro,0,0,1,1,0.0,0.0
Manuela Boatcă,www.g4media.ro,0,0,1,1,0.0,0.0
Mihai Burcea,www.g4media.ro,0,0,1,1,0.0,0.0
Oana Băluță,www.g4media.ro,0,0,1,1,0.0,0.0
Mihaela Michailov,www.g4media.ro,0,0,1,1,0.0,0.0
poet,www.g4media.ro,0,0,1,1,0.0,0.0
Alexandra Corbu,www.g4media.ro,0,0,1,1,0.0,0.0
Camil Pârvu,www.g4media.ro,0,0,1,1,0.0,0.0
Costina Adrian,www.g4media.ro,0,0,1,1,0.0,0.0
Radu Jude,www.g4media.ro,0,0,1,1,0.0,0.0
Eugen Gabor,www.g4media.ro,0,0,1,1,0.0,0.0
Andrei Panțu,www.g4media.ro,0,0,1,1,0.0,0.0
Sergiu Mișcoiu,www.g4media.ro,0,0,1,1,0.0,0.0
Vlad Morariu,www.g4media.ro,0,0,1,1,0.0,0.0
Radu Apostol,www.g4media.ro,0,0,1,1,0.0,0.0
Raluca Oancea,www.g4media.ro,0,0,1,1,0.0,0.0
Raluca Petre,www.g4media.ro,0,0,1,1,0.0,0.0
Ramon Demirel Sadîc,www.g4media.ro,0,0,1,1,0.0,0.0
Raul Cârstocea,www.g4media.ro,0,0,1,1,0.0,0.0
Alexandru Cârlan,www.g4media.ro,0,0,1,1,0.0,0.0
regizor,www.g4media.ro,0,0,1,1,0.0,0.0
Ionuț Jugureanu,www.g4media.ro,0,0,1,1,0.0,0.0
Miki Braniște,www.g4media.ro,0,0,1,1,0.0,0.0
Nicolae Mandea,www.g4media.ro,0,0,1,1,0.0,0.0
Sorin Despot,www.g4media.ro,0,0,1,1,0.0,0.0
Virginia Toma,www.g4media.ro,0,0,1,1,0.0,0.0
complic,www.g4media.ro,0,1,0,1,-1.0,1.0
dvs,www.g4media.ro,0,2,0,2,-1.0,1.0
manager cultural,www.g4media.ro,0,0,1,1,0.0,0.0
Corina Doboș,www.g4media.ro,0,0,1,1,0.0,0.0
Arhiepiscopul Calinic,recorder.ro,0,0,1,1,0.0,0.0
Gorghiu,recorder.ro,0,1,0,1,-1.0,1.0
Marcel Popa,recorder.ro,0,0,3,3,0.0,0.0
Mihăești,recorder.ro,0,0,1,1,0.0,0.0
Perianu,recorder.ro,0,0,1,1,0.0,0.0
Popa,recorder.ro,0,0,1,1,0.0,0.0
Radu Perianu,recorder.ro,0,0,1,1,0.0,0.0
Anemona,snoop.ro,0,0,1,1,0.0,0.0
Attila Cseke,snoop.ro,0,0,1,1,0.0,0.0
Rafila Cîrstoiu,snoop.ro,0,0,1,1,0.0,0.0
Cârstoiu,snoop.ro,0,0,1,1,0.0,0.0
Attila,snoop.ro,0,0,1,1,0.0,0.0
Cătălin Drulă,www.realitatea.net,0,0,1,1,0.0,0.0
Dan Barna,www.realitatea.net,0,1,1,2,-0.5,0.5
Laura Codruța Koveși,www.realitatea.net,0,0,1,1,0.0,0.0
Marcel Zegan,www.antena3.ro,0,0,1,1,0.0,0.0
Zegan,www.antena3.ro,0,1,0,1,-1.0,1.0
militant,www.antena3.ro,0,1,0,1,-1.0,1.0
Adrian Onciu,www.activenews.ro,0,0,1,1,0.0,0.0
Adrian Pătrușcă,www.activenews.ro,0,1,0,1,-1.0,1.0
Crevedia,www.activenews.ro,0,0,1,1,0.0,0.0
Cristela Georgescu,www.activenews.ro,0,0,1,1,0.0,0.0
cronicar,www.activenews.ro,0,1,0,1,-1.0,1.0
cântat,www.activenews.ro,0,0,1,1,0.0,0.0
Dan Puric,www.activenews.ro,2,0,0,2,1.0,1.0
Eduard Hellvig,www.activenews.ro,0,0,1,1,0.0,0.0
Familia Udrea,www.activenews.ro,0,0,1,1,0.0,0.0
Fântâna Albă,www.activenews.ro,0,0,1,1,0.0,0.0
Gigi Becali,www.activenews.ro,0,2,0,2,-1.0,1.0
Ilinca Simion,www.activenews.ro,0,0,1,1,0.0,0.0
Ion Pillat,www.activenews.ro,0,0,1,1,0.0,0.0
Liviu Mihaiu,www.activenews.ro,0,0,1,1,0.0,0.0
Mănăstirea,www.activenews.ro,0,0,1,1,0.0,0.0
Radu Ciuceanu,www.activenews.ro,1,0,0,1,1.0,1.0
Radu Gyr,www.activenews.ro,1,0,1,2,0.5,0.5
Sfinții,www.activenews.ro,1,0,0,1,1.0,1.0
Petru Huțan,www.activenews.ro,0,0,1,1,0.0,0.0
TRONOS,www.activenews.ro,0,0,1,1,0.0,0.0
Târgoviște,www.activenews.ro,0,0,1,1,0.0,0.0
V. Voiculescu,www.activenews.ro,0,0,1,1,0.0,0.0
Vasile Voiculescu,www.activenews.ro,1,0,0,1,1.0,1.0
Victor Roncea,www.activenews.ro,0,1,0,1,-1.0,1.0
bebeluș,www.activenews.ro,0,1,0,1,-1.0,1.0
bioetician,www.activenews.ro,0,1,0,1,-1.0,1.0
maică,www.activenews.ro,0,0,1,1,0.0,0.0
mărturisitor,www.activenews.ro,1,0,0,1,1.0,1.0
ocupant,www.activenews.ro,0,1,0,1,-1.0,1.0
prieteni,www.activenews.ro,1,0,0,1,1.0,1.0
Bogdan,primanews.ro,0,0,1,1,0.0,0.0
Radu Moldovan,www.digi24.ro,0,1,0,1,-1.0,1.0
Bogdan,www.b1tv.ro,0,0,1,1,0.0,0.0
Cătălin Manea,www.b1tv.ro,0,0,1,1,0.0,0.0
Iulian Paraschiv,www.b1tv.ro,0,0,1,1,0.0,0.0
Marian Daragiu,www.b1tv.ro,0,0,1,1,0.0,0.0
absolvent,www.b1tv.ro,0,0,1,1,0.0,0.0
funcționar,www.b1tv.ro,0,0,1,1,0.0,0.0
Nicu Sebe,www.digi24.ro,0,0,1,1,0.0,0.0
Mihai Burduja,www.digi24.ro,0,0,1,1,0.0,0.0
guvernant,www.digi24.ro,0,1,0,1,-1.0,1.0
Cîmpeanu,observatornews.ro,0,0,1,1,0.0,0.0
Deca,observatornews.ro,0,0,1,1,0.0,0.0
Ligia Deca,observatornews.ro,0,0,1,1,0.0,0.0
doctor,observatornews.ro,0,0,2,2,0.0,0.0
Camelia Donțu,www.comisarul.ro,0,0,1,1,0.0,0.0
Csaba Asztalos,www.comisarul.ro,0,0,1,1,0.0,0.0
Podoliak,primanews.ro,0,0,1,1,0.0,0.0
Adrian Cătană,www.g4media.ro,0,0,1,1,0.0,0.0
Fabian Radu,www.g4media.ro,0,0,1,1,0.0,0.0
Luminița Păucean Fernandes,www.g4media.ro,0,0,1,1,0.0,0.0
Sebastian Suciu,www.g4media.ro,0,0,1,1,0.0,0.0
psiholog,www.g4media.ro,0,0,2,2,0.0,0.0
speaker,www.g4media.ro,0,0,1,1,0.0,0.0
Amsterdam,www.g4media.ro,0,0,1,1,0.0,0.0
cancelar,www.g4media.ro,0,0,1,1,0.0,0.0
Friedrich Merz,www.g4media.ro,0,0,1,1,0.0,0.0
Gerhard Jahn,www.g4media.ro,0,0,1,1,0.0,0.0
Gil Ofarim,www.g4media.ro,0,0,1,1,0.0,0.0
Adolf Hitler,www.g4media.ro,0,0,1,1,0.0,0.0
Ierusalim,www.g4media.ro,0,0,2,2,0.0,0.0
Leipzig,www.g4media.ro,0,1,0,1,-1.0,1.0
Merz,www.g4media.ro,0,0,1,1,0.0,0.0
Ofarim,www.g4media.ro,0,1,0,1,-1.0,1.0
Prien,www.g4media.ro,0,0,1,1,0.0,0.0
Walther Rathenau,www.g4media.ro,0,0,1,1,0.0,0.0
purtătoare de cuvânt,www.g4media.ro,0,0,1,1,0.0,0.0
refugiat,www.g4media.ro,0,1,0,1,-1.0,1.0
A,pressone.ro,0,0,1,1,0.0,0.0
Adrian Chesnoiu,pressone.ro,0,1,0,1,-1.0,1.0
C,pressone.ro,0,0,1,1,0.0,0.0
Charlottesville,pressone.ro,0,0,1,1,0.0,0.0
Chesnoiu,pressone.ro,0,0,1,1,0.0,0.0
Daea,pressone.ro,0,0,1,1,0.0,0.0
E,pressone.ro,0,1,0,1,-1.0,1.0
Hodor,pressone.ro,0,0,1,1,0.0,0.0
Lucian Mate,pressone.ro,0,0,1,1,0.0,0.0
Mate,pressone.ro,0,0,1,1,0.0,0.0
Mădălin Hodor,pressone.ro,0,0,3,3,0.0,0.0
Predoiu,pressone.ro,0,0,1,1,0.0,0.0
Silvian Predoiu,pressone.ro,0,0,1,1,0.0,0.0
Tatiana Niculescu,pressone.ro,0,0,1,1,0.0,0.0
Claudiu Tufiș,pressone.ro,0,0,1,1,0.0,0.0
idol,pressone.ro,0,1,0,1,-1.0,1.0
informație,pressone.ro,0,1,0,1,-1.0,1.0
Mihai Bădescu,pressone.ro,0,0,2,2,0.0,0.0
ș,pressone.ro,0,1,0,1,-1.0,1.0
angajat,www.activenews.ro,0,5,0,5,-1.0,1.0
George Enescu,www.activenews.ro,0,0,1,1,0.0,0.0
lucrător,www.activenews.ro,0,1,0,1,-1.0,1.0
Daniel Jinga,www.activenews.ro,0,1,1,2,-0.5,0.5
Fănel Ignat,www.activenews.ro,0,0,1,1,0.0,0.0
dâns,www.activenews.ro,0,1,0,1,-1.0,1.0
întreținător,www.activenews.ro,0,1,0,1,-1.0,1.0
Cristian Popescu Piedone,observatornews.ro,0,0,1,1,0.0,0.0
Cătălin Cirstoiu,observatornews.ro,0,0,1,1,0.0,0.0
Alba Iulia,www.luju.ro,0,0,1,1,0.0,0.0
Ana Ciceală,www.g4media.ro,0,0,1,1,0.0,0.0
Andrei Macsut,www.g4media.ro,0,0,1,1,0.0,0.0
Florina Presadă,www.g4media.ro,0,0,1,1,0.0,0.0
Nicu Ștefănuță,www.g4media.ro,0,0,2,2,0.0,0.0
Ramona Strugariu,www.g4media.ro,0,0,1,1,0.0,0.0
Victor Rebengiuc,adevarul.ro,0,1,1,2,-0.5,0.5
Victor Ilie,adevarul.ro,0,0,1,1,0.0,0.0
iepuraș,adevarul.ro,0,1,0,1,-1.0,1.0
Dragoș Pătraru,adevarul.ro,0,1,0,1,-1.0,1.0
Ion Gheorghe Duca,adevarul.ro,0,1,0,1,-1.0,1.0
Radu Burnete,www.b1tv.ro,0,0,2,2,0.0,0.0
dascăl,adevarul.ro,0,0,1,1,0.0,0.0
Amina,www.comisarul.ro,0,0,1,1,0.0,0.0
Bianca Eugenia Gavrilă,www.comisarul.ro,0,0,1,1,0.0,0.0
Camerun,www.comisarul.ro,0,0,1,1,0.0,0.0
Chiajna,www.comisarul.ro,0,0,1,1,0.0,0.0
Crinela Meidinger,www.comisarul.ro,0,0,1,1,0.0,0.0
Ibrahim Njoya,www.comisarul.ro,0,0,1,1,0.0,0.0
Pavel,www.comisarul.ro,0,0,1,1,0.0,0.0
Raul Hoca,www.comisarul.ro,0,1,0,1,-1.0,1.0
Sultan,www.comisarul.ro,0,0,1,1,0.0,0.0
Teodor Iulian Pavel,www.comisarul.ro,0,1,0,1,-1.0,1.0
Tânăra,www.comisarul.ro,0,0,2,2,0.0,0.0
condamnat,www.comisarul.ro,0,1,0,1,-1.0,1.0
monarh,www.comisarul.ro,0,0,1,1,0.0,0.0
prințesă,www.comisarul.ro,0,0,1,1,0.0,0.0
rege,www.comisarul.ro,0,1,2,3,-0.3333333333333333,0.3333333333333333
soră,www.comisarul.ro,0,1,1,2,-0.5,0.5
Anca Boagiu,adevarul.ro,0,2,0,2,-1.0,1.0
Boagiu,adevarul.ro,0,1,0,1,-1.0,1.0
Macovei,adevarul.ro,0,0,2,2,0.0,0.0
Mantale,adevarul.ro,0,0,1,1,0.0,0.0
Mioara Mantale,adevarul.ro,0,0,1,1,0.0,0.0
Mona Muscă,adevarul.ro,0,1,0,1,-1.0,1.0
Monica Iacob Ridzi,adevarul.ro,0,2,0,2,-1.0,1.0
Monica Macovei,adevarul.ro,0,1,1,2,-0.5,0.5
Muscă,adevarul.ro,0,1,0,1,-1.0,1.0
Udrea,adevarul.ro,0,0,1,1,0.0,0.0
blond,adevarul.ro,0,1,0,1,-1.0,1.0
magician,adevarul.ro,0,1,0,1,-1.0,1.0
portavoce,adevarul.ro,0,1,0,1,-1.0,1.0
turnătoare,adevarul.ro,0,1,0,1,-1.0,1.0
Fallon,adevarul.ro,0,0,1,1,0.0,0.0
Pat Fallon,adevarul.ro,0,0,1,1,0.0,0.0
Gheorghe Vela,agerpres.ro,0,0,1,1,0.0,0.0
decident,www.antena3.ro,0,1,0,1,-1.0,1.0
Annalena Baerbock,www.gandul.ro,0,0,1,1,0.0,0.0
Antonio Tajani,www.gandul.ro,0,0,1,1,0.0,0.0
Johansson,www.gandul.ro,0,0,1,1,0.0,0.0
Nehammer,www.gandul.ro,0,3,1,4,-0.75,0.75
Tajani,www.gandul.ro,0,0,1,1,0.0,0.0
Viena,www.gandul.ro,0,0,1,1,0.0,0.0
Ylva Johansson,www.gandul.ro,0,0,1,1,0.0,0.0
imigrant,www.gandul.ro,0,0,1,1,0.0,0.0
victima,www.gandul.ro,0,0,1,1,0.0,0.0
Afganistan,www.digi24.ro,1,0,0,1,1.0,1.0
Aurescu,www.digi24.ro,0,0,1,1,0.0,0.0
Nicolae Popescu,www.digi24.ro,0,0,1,1,0.0,0.0
Doamna Șoșoacă,www.romaniatv.net,0,1,0,1,-1.0,1.0
dvs,www.romaniatv.net,0,0,1,1,0.0,0.0
Aura Socol,www.cotidianul.ro,0,0,1,1,0.0,0.0
Boloș,www.cotidianul.ro,0,0,1,1,0.0,0.0
Cosmin Marinescu,www.cotidianul.ro,0,0,1,1,0.0,0.0
Cristian Popa,www.cotidianul.ro,0,0,1,1,0.0,0.0
Csaba Bálint,www.cotidianul.ro,0,0,1,1,0.0,0.0
Florin Georgescu,www.cotidianul.ro,0,0,2,2,0.0,0.0
Horia Neamțu,www.cotidianul.ro,0,0,1,1,0.0,0.0
Isărescu,www.cotidianul.ro,0,0,1,1,0.0,0.0
Leonardo Badea,www.cotidianul.ro,0,0,1,1,0.0,0.0
Mugur Isărescu,www.cotidianul.ro,1,0,0,1,1.0,1.0
viceguvernator,www.cotidianul.ro,0,0,1,1,0.0,0.0
Brătieni,agerpres.ro,1,0,0,1,1.0,1.0
Pambuccian,agerpres.ro,0,0,1,1,0.0,0.0
Carol I,agerpres.ro,1,0,0,1,1.0,1.0
Varujan Pambuccian,agerpres.ro,0,0,2,2,0.0,0.0
purtător,www.euronews.ro,0,1,1,2,-0.5,0.5
Alin Tișe,www.cotidianul.ro,0,0,1,1,0.0,0.0
Tișe,www.cotidianul.ro,0,0,1,1,0.0,0.0
ai,www.cotidianul.ro,0,1,0,1,-1.0,1.0
aleș,www.cotidianul.ro,0,1,0,1,-1.0,1.0
Ovidiu Voicu,www.aktual24.ro,0,0,1,1,0.0,0.0
Slovac,www.aktual24.ro,0,0,1,1,0.0,0.0
dansator,www.aktual24.ro,0,0,1,1,0.0,0.0
extra,www.aktual24.ro,0,1,0,1,-1.0,1.0
Moș Crăciun,www.antena3.ro,0,1,0,1,-1.0,1.0
zână,www.antena3.ro,0,0,1,1,0.0,0.0
Alexandru Bârlădeanu,www.activenews.ro,0,0,1,1,0.0,0.0
Brucan,www.activenews.ro,0,1,0,1,-1.0,1.0
Dan Șucu,www.activenews.ro,0,1,0,1,-1.0,1.0
Doamna Maria,www.activenews.ro,0,1,0,1,-1.0,1.0
Hermina,www.activenews.ro,0,1,0,1,-1.0,1.0
Lavinia Betea,www.activenews.ro,0,0,1,1,0.0,0.0
Leonid,www.activenews.ro,0,1,0,1,-1.0,1.0
Liigheanu,www.activenews.ro,0,1,0,1,-1.0,1.0
Lisabona,www.activenews.ro,0,0,1,1,0.0,0.0
Lucia Hossu Longin,www.activenews.ro,0,1,0,1,-1.0,1.0
Marin Oltescu,www.activenews.ro,0,1,0,1,-1.0,1.0
Minsk,www.activenews.ro,0,1,0,1,-1.0,1.0
Papahagi,www.activenews.ro,0,1,0,1,-1.0,1.0
Pappadi,www.activenews.ro,0,1,0,1,-1.0,1.0
Patapievici,www.activenews.ro,0,1,0,1,-1.0,1.0
Petrov,www.activenews.ro,0,1,0,1,-1.0,1.0
Pipihagi,www.activenews.ro,0,1,0,1,-1.0,1.0
Sun Tzu,www.activenews.ro,1,0,0,1,1.0,1.0
Tismăneanu,www.activenews.ro,0,1,0,1,-1.0,1.0
Tismănene,www.activenews.ro,0,0,1,1,0.0,0.0
Vladimir Tismăneanu,www.activenews.ro,0,1,0,1,-1.0,1.0
Volodea,www.activenews.ro,0,2,0,2,-1.0,1.0
Volodea Tisminețki,www.activenews.ro,0,1,0,1,-1.0,1.0
Volodea Tismăneanu,www.activenews.ro,0,1,0,1,-1.0,1.0
apărător,www.activenews.ro,0,1,0,1,-1.0,1.0
Ingrid Mocanu,www.activenews.ro,0,1,0,1,-1.0,1.0
beizadea,www.activenews.ro,0,1,0,1,-1.0,1.0
bulibașă,www.activenews.ro,0,1,0,1,-1.0,1.0
Paleologu,www.activenews.ro,0,1,0,1,-1.0,1.0
exponenții,www.activenews.ro,0,1,0,1,-1.0,1.0
exponenț,www.activenews.ro,0,1,0,1,-1.0,1.0
instaurator,www.activenews.ro,0,1,0,1,-1.0,1.0
Baconski,www.activenews.ro,0,1,0,1,-1.0,1.0
marele,www.activenews.ro,0,1,0,1,-1.0,1.0
matroz,www.activenews.ro,0,1,0,1,-1.0,1.0
mogul,www.activenews.ro,0,1,0,1,-1.0,1.0
noi,www.activenews.ro,0,1,0,1,-1.0,1.0
olimpic,www.activenews.ro,0,1,0,1,-1.0,1.0
patapievic,www.activenews.ro,0,1,0,1,-1.0,1.0
politolog,www.activenews.ro,0,1,0,1,-1.0,1.0
progenitor,www.activenews.ro,0,1,0,1,-1.0,1.0
turnător,www.activenews.ro,0,1,0,1,-1.0,1.0
turnător securist,www.activenews.ro,0,1,0,1,-1.0,1.0
Iosif Stalin,www.activenews.ro,0,1,0,1,-1.0,1.0
întâi,www.activenews.ro,0,1,0,1,-1.0,1.0
înaintaș,www.activenews.ro,0,1,1,2,-0.5,0.5
Șuncoski,www.activenews.ro,0,1,0,1,-1.0,1.0
Cătălina Ponor,www.digi24.ro,0,0,3,3,0.0,0.0
Felix Stroe,www.digi24.ro,0,0,1,1,0.0,0.0
gimnast,www.digi24.ro,0,0,2,2,0.0,0.0
Rio,www.digi24.ro,0,0,1,1,0.0,0.0
Sportiva,www.digi24.ro,0,0,1,1,0.0,0.0
Mircea Dobre,www.digi24.ro,0,0,1,1,0.0,0.0
medaliat,www.digi24.ro,1,0,0,1,1.0,1.0
Antal Arpad,agerpres.ro,0,0,1,1,0.0,0.0
George Simon,agerpres.ro,0,1,0,1,-1.0,1.0
Gheorghe,agerpres.ro,0,0,1,1,0.0,0.0
Sfântu Gheorghe,agerpres.ro,0,0,1,1,0.0,0.0
stop,agerpres.ro,0,1,0,1,-1.0,1.0
Alba Iulia,www.antena3.ro,0,0,1,1,0.0,0.0
Ionuț Fulea,www.antena3.ro,0,0,2,2,0.0,0.0
Marius Filimon,www.antena3.ro,0,0,1,1,0.0,0.0
Mircea Hava,www.antena3.ro,0,0,1,1,0.0,0.0
Voicu Paul,www.antena3.ro,0,0,1,1,0.0,0.0
artist,www.antena3.ro,0,0,1,1,0.0,0.0
cântăreț,www.antena3.ro,0,0,1,1,0.0,0.0
secretar adjunct,www.antena3.ro,0,0,1,1,0.0,0.0
viceprimar,www.antena3.ro,0,0,4,4,0.0,0.0
Dragomir,www.realitatea.net,0,0,1,1,0.0,0.0
Mitică Dragomir,www.realitatea.net,0,1,1,2,-0.5,0.5
Bujor Petruț,pressone.ro,0,0,2,2,0.0,0.0
După Deal,pressone.ro,0,0,1,1,0.0,0.0
Feliciei Petruț,pressone.ro,0,0,1,1,0.0,0.0
Geogel,pressone.ro,0,0,1,1,0.0,0.0
La Tiușan,pressone.ro,0,0,1,1,0.0,0.0
La Troacă,pressone.ro,0,0,1,1,0.0,0.0
Marius Hațegan,pressone.ro,0,0,1,1,0.0,0.0
Marius Iulius Toma,pressone.ro,0,0,1,1,0.0,0.0
Măcărești,pressone.ro,0,0,1,1,0.0,0.0
Petruț Bujor,pressone.ro,0,1,1,2,-0.5,0.5
Ponor,pressone.ro,0,0,1,1,0.0,0.0
Ponor Alba,pressone.ro,0,1,0,1,-1.0,1.0
Troacă,pressone.ro,0,1,0,1,-1.0,1.0
Vale în Jos,pressone.ro,0,1,0,1,-1.0,1.0
Valea Bucurului,pressone.ro,0,0,1,1,0.0,0.0
Petruț Bujor Cherchez,pressone.ro,0,1,0,1,-1.0,1.0
străbunică,pressone.ro,1,0,0,1,1.0,1.0
George Simon,www.comisarul.ro,0,1,0,1,-1.0,1.0
Simona Bucura-Oprescu,agerpres.ro,0,0,2,2,0.0,0.0
Bogdan Licu,www.news.ro,0,1,0,1,-1.0,1.0
realizator,www.news.ro,0,1,0,1,-1.0,1.0
Alexandru Nazare,www.romaniatv.net,0,0,1,1,0.0,0.0
Alexandru Rafila,www.romaniatv.net,0,0,1,1,0.0,0.0
Angel Tilvar,www.romaniatv.net,0,0,1,1,0.0,0.0
Florin Barbu,www.romaniatv.net,0,0,1,1,0.0,0.0
Ionut Mosteanu,www.romaniatv.net,0,0,1,1,0.0,0.0
Iulian Bulai,www.romaniatv.net,0,0,1,1,0.0,0.0
Moșteanu,www.romaniatv.net,0,0,1,1,0.0,0.0
Ștefan Palarie,www.romaniatv.net,0,0,1,1,0.0,0.0
Tantos Barna,www.romaniatv.net,0,0,1,1,0.0,0.0
aleș,www.romaniatv.net,0,1,0,1,-1.0,1.0
notar,www.romaniatv.net,0,0,1,1,0.0,0.0
Blaga,adevarul.ro,0,0,2,2,0.0,0.0
Bogdan Cosmin Gigină,adevarul.ro,0,0,1,1,0.0,0.0
Mircea Dușa,adevarul.ro,0,0,1,1,0.0,0.0
Turciei,www.euronews.ro,0,0,1,1,0.0,0.0
Andrei Gușă,www.activenews.ro,0,0,1,1,0.0,0.0
Laura,www.activenews.ro,0,1,0,1,-1.0,1.0
laureat,www.activenews.ro,0,1,0,1,-1.0,1.0
Laurei Vicol,www.activenews.ro,0,1,0,1,-1.0,1.0
Vicol,www.activenews.ro,0,1,0,1,-1.0,1.0
absolvent,www.activenews.ro,0,0,1,1,0.0,0.0
Vicol Ciorbă,www.activenews.ro,0,1,0,1,-1.0,1.0
făptuitor,www.activenews.ro,0,1,0,1,-1.0,1.0
Vicol - Ciorbă,www.activenews.ro,0,0,1,1,0.0,0.0
Cornu,www.euronews.ro,0,0,1,1,0.0,0.0
Jens Stoltenberg,www.euronews.ro,0,0,1,1,0.0,0.0
Căprar,pressone.ro,0,0,1,1,0.0,0.0
Horia Grama,pressone.ro,0,0,1,1,0.0,0.0
Ioan Dârzu,pressone.ro,0,0,1,1,0.0,0.0
Orbului,pressone.ro,0,1,0,1,-1.0,1.0
Antal Arpad,www.cotidianul.ro,0,0,1,1,0.0,0.0
George Simon,www.cotidianul.ro,0,1,0,1,-1.0,1.0
Gheorghe,www.cotidianul.ro,0,0,1,1,0.0,0.0
Sfântu Gheorghe,www.cotidianul.ro,0,0,1,1,0.0,0.0
Stop Simion,www.cotidianul.ro,0,1,0,1,-1.0,1.0
subiect,www.comisarul.ro,0,0,2,2,0.0,0.0
Ciuhandu,a1.ro,0,0,1,1,0.0,0.0
Mircea Geoana,a1.ro,0,0,1,1,0.0,0.0
Primei Doamne,a1.ro,0,0,1,1,0.0,0.0
Mihai Fifor,observatornews.ro,0,0,1,1,0.0,0.0
Bianca,snoop.ro,0,0,3,3,0.0,0.0
Biancăi,snoop.ro,0,1,1,2,-0.5,0.5
Cornescu,snoop.ro,0,1,1,2,-0.5,0.5
Daniela Cornescu,snoop.ro,0,0,2,2,0.0,0.0
Diana Vasile,snoop.ro,0,0,3,3,0.0,0.0
Doru,snoop.ro,0,0,1,1,0.0,0.0
Doru Cornescu,snoop.ro,0,0,3,3,0.0,0.0
Familia Cornescu,snoop.ro,0,0,1,1,0.0,0.0
Fata,snoop.ro,0,0,2,2,0.0,0.0
Gorj,snoop.ro,0,0,4,4,0.0,0.0
Ion Iordache,snoop.ro,0,0,1,1,0.0,0.0
Ligia Deca,snoop.ro,0,0,1,1,0.0,0.0
Manolache,snoop.ro,0,1,0,1,-1.0,1.0
Marian Trușcă,snoop.ro,0,0,1,1,0.0,0.0
Mihaela Chiper,snoop.ro,0,0,1,1,0.0,0.0
Mihail Cornescu,snoop.ro,0,9,1,10,-0.9,0.9
Oana Șandru,snoop.ro,0,0,1,1,0.0,0.0
Raluca Rișcă,snoop.ro,0,0,1,1,0.0,0.0
Raluca Rișcă Bianca,snoop.ro,0,1,0,1,-1.0,1.0
Profesorul Cornescu,snoop.ro,0,1,0,1,-1.0,1.0
Rișcă,snoop.ro,0,0,1,1,0.0,0.0
Trușcă,snoop.ro,0,0,1,1,0.0,0.0
Turceni,snoop.ro,0,1,1,2,-0.5,0.5
agresor,snoop.ro,0,2,0,2,-1.0,1.0
Aurora Manolache,snoop.ro,0,0,1,1,0.0,0.0
dumnealor,snoop.ro,0,1,0,1,-1.0,1.0
educatoare,snoop.ro,0,0,1,1,0.0,0.0
Doru Ion Cornescu,snoop.ro,0,0,1,1,0.0,0.0
ministră,snoop.ro,0,0,1,1,0.0,0.0
Șandru,snoop.ro,0,0,1,1,0.0,0.0
Andrzej Duda,recorder.ro,0,0,1,1,0.0,0.0
Cosmin Nedelcu,recorder.ro,0,1,0,1,-1.0,1.0
Karol Nawrocki,recorder.ro,0,0,1,1,0.0,0.0
Nawrocki,recorder.ro,1,0,0,1,1.0,1.0
Rafał Trzaskowski,recorder.ro,0,0,1,1,0.0,0.0
beneficiar,adevarul.ro,0,0,1,1,0.0,0.0
Benedek Zacharie,recorder.ro,0,0,1,1,0.0,0.0
Dalai Lama,recorder.ro,0,0,2,2,0.0,0.0
Fejer Laszlo Odon,recorder.ro,0,0,1,1,0.0,0.0
Jănel Leaua,recorder.ro,0,0,1,1,0.0,0.0
Csaba Konczei,recorder.ro,0,0,1,1,0.0,0.0
Laurens van den Muyzenberg,recorder.ro,0,0,1,1,0.0,0.0
Lee Iacocca,recorder.ro,0,0,1,1,0.0,0.0
Miklos Zoltan,recorder.ro,0,0,1,1,0.0,0.0
Nizam Al Mulk,recorder.ro,0,0,1,1,0.0,0.0
Olimpiu Floroian,recorder.ro,0,0,1,1,0.0,0.0
Târgu Secuiesc,recorder.ro,1,0,0,1,1.0,1.0
comunicator,recorder.ro,0,0,1,1,0.0,0.0
Benko Erika,recorder.ro,0,0,1,1,0.0,0.0
Antal Árpád,recorder.ro,0,0,1,1,0.0,0.0
etnic,recorder.ro,0,1,0,1,-1.0,1.0
ofițer de informații,recorder.ro,0,0,1,1,0.0,0.0
Ardealul,primanews.ro,0,0,1,1,0.0,0.0
Claudiu Manda,primanews.ro,0,0,1,1,0.0,0.0
Corneliu Ștefan,primanews.ro,0,0,1,1,0.0,0.0
Daniel Băluță,primanews.ro,0,1,0,1,-1.0,1.0
Gabriela Firea,primanews.ro,0,1,0,1,-1.0,1.0
Lia Olguța Vasilescu,primanews.ro,0,0,1,1,0.0,0.0
Viorica Dăncilă,primanews.ro,0,1,1,2,-0.5,0.5
Claudiu-Daniel Catană,www.g4media.ro,0,0,2,2,0.0,0.0
Dan,agerpres.ro,1,0,0,1,1.0,1.0
Juan Lobato,agerpres.ro,0,0,1,1,0.0,0.0
Regatul Unit,agerpres.ro,0,0,1,1,0.0,0.0
Salvador Garcia,agerpres.ro,0,0,1,1,0.0,0.0
reformist,agerpres.ro,0,0,1,1,0.0,0.0
Adiyaman,pressone.ro,0,0,1,1,0.0,0.0
Aleksandar Vucic,pressone.ro,0,0,1,1,0.0,0.0
Ali,pressone.ro,0,1,0,1,-1.0,1.0
Ankara,pressone.ro,0,0,1,1,0.0,0.0
Atatürk,pressone.ro,0,1,0,1,-1.0,1.0
Boyko Borisov,pressone.ro,0,0,1,1,0.0,0.0
Carolina Drüten,pressone.ro,0,0,1,1,0.0,0.0
Carolina Ali,pressone.ro,0,0,1,1,0.0,0.0
Carolina Drüten Erdogan,pressone.ro,0,0,1,1,0.0,0.0
Ekrem İmamoğlu,pressone.ro,0,0,1,1,0.0,0.0
Gerhard Schröder,pressone.ro,0,0,1,1,0.0,0.0
Gezi,pressone.ro,0,1,0,1,-1.0,1.0
Ismet,pressone.ro,0,0,1,1,0.0,0.0
İsmet İnönü,pressone.ro,0,0,1,1,0.0,0.0
Istanbul,pressone.ro,0,0,2,2,0.0,0.0
Kemal Atatürk,pressone.ro,1,0,0,1,1.0,1.0
Kemal Kılıçdaroğlu,pressone.ro,0,0,1,1,0.0,0.0
Murat Bay,pressone.ro,0,1,0,1,-1.0,1.0
Occident,pressone.ro,0,1,0,1,-1.0,1.0
Recep Tayyip,pressone.ro,0,1,0,1,-1.0,1.0
regizoare,pressone.ro,0,0,2,2,0.0,0.0
Sibel Tekin,pressone.ro,0,0,2,2,0.0,0.0
Rize,pressone.ro,0,0,1,1,0.0,0.0
Sankt Petersburg,pressone.ro,0,0,1,1,0.0,0.0
Sanliurfa,pressone.ro,0,0,1,1,0.0,0.0
Sirie,pressone.ro,0,1,0,1,-1.0,1.0
Tekin,pressone.ro,0,0,1,1,0.0,0.0
Turciei,pressone.ro,0,0,1,1,0.0,0.0
autocrat,pressone.ro,0,1,0,1,-1.0,1.0
cancelar,pressone.ro,0,1,0,1,-1.0,1.0
Ahmet Erdogan,pressone.ro,0,0,1,1,0.0,0.0
ia,pressone.ro,0,1,0,1,-1.0,1.0
Carolina Drüten Acesta,pressone.ro,0,0,1,1,0.0,0.0
AUR,adevarul.ro,0,0,1,1,0.0,0.0
Adina Săniuță,adevarul.ro,0,0,1,1,0.0,0.0
Biro Rozalia,adevarul.ro,0,0,1,1,0.0,0.0
Cristina Prună,adevarul.ro,0,0,1,1,0.0,0.0
Csep-Eva Andrea,adevarul.ro,0,0,1,1,0.0,0.0
Daniela Cîmpean,adevarul.ro,0,0,1,1,0.0,0.0
Diana Enache,adevarul.ro,0,0,1,1,0.0,0.0
Doina Fedorovici,adevarul.ro,0,0,1,1,0.0,0.0
Dumitrina Mitrea,adevarul.ro,0,0,1,1,0.0,0.0
Flavia Boghiu,adevarul.ro,0,0,1,1,0.0,0.0
Gal Eva,adevarul.ro,0,0,1,1,0.0,0.0
Gianina Șerban,adevarul.ro,0,0,1,1,0.0,0.0
Gliga Dumitrița,adevarul.ro,0,0,1,1,0.0,0.0
guvern,adevarul.ro,0,0,1,1,0.0,0.0
Lia Olguța Vasilescu,adevarul.ro,0,0,1,1,0.0,0.0
Monica Anisie,adevarul.ro,0,0,1,1,0.0,0.0
Nicolae Pauliuc,adevarul.ro,0,0,1,1,0.0,0.0
Oana Țoiu,adevarul.ro,0,0,1,1,0.0,0.0
Olah Emese,adevarul.ro,0,0,1,1,0.0,0.0
Ramona Lovin,adevarul.ro,0,0,1,1,0.0,0.0
Ramona Strugariu,adevarul.ro,0,0,1,1,0.0,0.0
Silvia Dinică,adevarul.ro,0,0,1,1,0.0,0.0
Simona Spătaru,adevarul.ro,0,0,1,1,0.0,0.0
Steluța Cătăniciu,adevarul.ro,0,0,1,1,0.0,0.0
Szilagyi Dora Emese,adevarul.ro,0,0,1,1,0.0,0.0
Vetuța Stănescu,adevarul.ro,0,0,1,1,0.0,0.0
ministră,adevarul.ro,0,0,1,1,0.0,0.0
Akos Hadhazy,primanews.ro,0,1,0,1,-1.0,1.0
donator,primanews.ro,0,1,0,1,-1.0,1.0
Bogdan Toader,www.mediafax.ro,0,0,1,1,0.0,0.0
Bădălău,www.mediafax.ro,0,0,1,1,0.0,0.0
Carmen Dan,www.mediafax.ro,0,1,2,3,-0.3333333333333333,0.3333333333333333
Cătălin Ioniță,www.mediafax.ro,0,1,0,1,-1.0,1.0
Cătălin Ivan,www.mediafax.ro,0,2,1,3,-0.6666666666666666,0.6666666666666666
Gabriel Petrea,www.mediafax.ro,0,0,1,1,0.0,0.0
Gabriel Zetea,www.mediafax.ro,0,0,1,1,0.0,0.0
Ioan Dîrzu,www.mediafax.ro,0,0,2,2,0.0,0.0
Ionel Arsene,www.mediafax.ro,0,0,1,1,0.0,0.0
Ionuț Vulpescu,www.mediafax.ro,0,0,1,1,0.0,0.0
Manda,www.mediafax.ro,0,0,1,1,0.0,0.0
Marian Oprișan,www.mediafax.ro,0,0,1,1,0.0,0.0
Marius Oprișan,www.mediafax.ro,0,0,1,1,0.0,0.0
Negoiță,www.mediafax.ro,0,0,1,1,0.0,0.0
Nicolae Marin,www.mediafax.ro,0,0,1,1,0.0,0.0
Niculae Bădălău,www.mediafax.ro,0,0,2,2,0.0,0.0
Olt,www.mediafax.ro,0,0,1,1,0.0,0.0
Oprișan,www.mediafax.ro,0,1,0,1,-1.0,1.0
Petre,www.mediafax.ro,0,0,1,1,0.0,0.0
Președintele executiv,www.mediafax.ro,0,0,1,1,0.0,0.0
Robert Negoiță,www.mediafax.ro,0,0,1,1,0.0,0.0
Tuțuianu,www.mediafax.ro,0,1,0,1,-1.0,1.0
Vulpescu,www.mediafax.ro,0,0,1,1,0.0,0.0
interimar,www.mediafax.ro,0,1,1,2,-0.5,0.5
minor,www.mediafax.ro,0,1,0,1,-1.0,1.0
polițist,www.mediafax.ro,0,1,3,4,-0.25,0.25
aleș,www.mediafax.ro,0,0,1,1,0.0,0.0
Cristian Rizea,www.mediafax.ro,0,1,0,1,-1.0,1.0
inspector,www.mediafax.ro,0,2,0,2,-1.0,1.0
Rizea,www.mediafax.ro,0,1,0,1,-1.0,1.0
Călin,a1.ro,0,1,0,1,-1.0,1.0
Elena Băsescu,observatornews.ro,0,0,1,1,0.0,0.0
Marian Vanghelie,observatornews.ro,0,0,1,1,0.0,0.0
Bololan,www.luju.ro,0,1,0,1,-1.0,1.0
președintele interimar,www.luju.ro,0,2,0,2,-1.0,1.0
Bogdan Popovici,adevarul.ro,0,0,1,1,0.0,0.0
Bogdan Popvici,adevarul.ro,1,0,0,1,1.0,1.0
Claudiu Năsui,adevarul.ro,0,0,1,1,0.0,0.0
Florin Presadă,adevarul.ro,0,0,1,1,0.0,0.0
Ghinea,adevarul.ro,0,1,0,1,-1.0,1.0
Ovidiu Paraschivescu,adevarul.ro,0,0,1,1,0.0,0.0
Tudor Benga,adevarul.ro,1,0,1,2,0.5,0.5
brașovean,adevarul.ro,0,0,1,1,0.0,0.0
Soos Zoltan,recorder.ro,1,0,0,1,1.0,1.0
politic,www.digi24.ro,0,1,0,1,-1.0,1.0
inginer,www.digi24.ro,0,0,1,1,0.0,0.0
Diaconu,www.realitatea.net,0,0,1,1,0.0,0.0
Gabriel Diaconu,www.realitatea.net,0,0,1,1,0.0,0.0
predecesor,www.realitatea.net,0,0,1,1,0.0,0.0
psihiatru,www.realitatea.net,0,0,1,1,0.0,0.0
șofer,www.realitatea.net,0,0,1,1,0.0,0.0
Anca Simina,adevarul.ro,0,0,1,1,0.0,0.0
bunica,adevarul.ro,0,1,0,1,-1.0,1.0
Huendoara,adevarul.ro,1,0,0,1,1.0,1.0
prezentatoare,adevarul.ro,0,0,1,1,0.0,0.0
Adriana Săftoiu,pressone.ro,0,0,1,1,0.0,0.0
Cosette Chichirău,pressone.ro,0,1,0,1,-1.0,1.0
Danielei Crudu,pressone.ro,0,1,0,1,-1.0,1.0
Florina Presadă,pressone.ro,0,1,2,3,-0.3333333333333333,0.3333333333333333
Rodica Boboc,pressone.ro,0,0,1,1,0.0,0.0
femeie parlamentar,pressone.ro,1,0,0,1,1.0,1.0
femeie politician,pressone.ro,0,1,0,1,-1.0,1.0
Alin Stoica,adevarul.ro,0,0,1,1,0.0,0.0
Bogdan Iancu,adevarul.ro,0,0,1,1,0.0,0.0
Cristian Ene,adevarul.ro,0,0,1,1,0.0,0.0
Iancu,adevarul.ro,0,0,1,1,0.0,0.0
Marian Radu,adevarul.ro,0,0,1,1,0.0,0.0
Marius Militaru,adevarul.ro,0,0,1,1,0.0,0.0
Oana Anghel,adevarul.ro,0,0,1,1,0.0,0.0
participanți,adevarul.ro,0,0,1,1,0.0,0.0
Viorel Mocanu,adevarul.ro,0,0,1,1,0.0,0.0
conferențiar,adevarul.ro,0,0,1,1,0.0,0.0
Mária Kolumbán,adevarul.ro,0,0,1,1,0.0,0.0
Georgescu Călin,adevarul.ro,0,0,1,1,0.0,0.0
Popa Ion,adevarul.ro,0,0,1,1,0.0,0.0
incitator,adevarul.ro,0,1,0,1,-1.0,1.0
Ana Hermina Iancu,adevarul.ro,0,0,1,1,0.0,0.0
Cristinel Grosu,adevarul.ro,0,0,1,1,0.0,0.0
Maricel Nechita,adevarul.ro,0,0,1,1,0.0,0.0
Mihaela Mîneran,adevarul.ro,0,0,1,1,0.0,0.0
Mihnea Adrian Tănase,adevarul.ro,0,0,1,1,0.0,0.0
Cristina Cuculas,primanews.ro,0,0,1,1,0.0,0.0
Emanuel Ungureanu,primanews.ro,0,0,1,1,0.0,0.0
bătrân,primanews.ro,0,0,1,1,0.0,0.0
California,stirileprotv.ro,0,0,1,1,0.0,0.0
Colton,stirileprotv.ro,0,0,1,1,0.0,0.0
Dugulescu,stirileprotv.ro,0,0,1,1,0.0,0.0
Gheorghe Ciobanu,stirileprotv.ro,0,0,1,1,0.0,0.0
Marius Dugulescu,stirileprotv.ro,0,0,1,1,0.0,0.0
San,stirileprotv.ro,0,0,1,1,0.0,0.0
Timis,stirileprotv.ro,0,0,1,1,0.0,0.0
pastor,stirileprotv.ro,0,0,1,1,0.0,0.0
amant,www.romaniatv.net,0,1,0,1,-1.0,1.0
Andreea Paul Vass,a1.ro,0,0,2,2,0.0,0.0
Vas,a1.ro,0,0,1,1,0.0,0.0
Valeriu Nicolae,adevarul.ro,0,0,1,1,0.0,0.0
Zbigniew Ziobro,adevarul.ro,0,0,1,1,0.0,0.0
Constantin,primanews.ro,0,0,2,2,0.0,0.0
Daniel Constantin,primanews.ro,0,0,1,1,0.0,0.0
Deca,primanews.ro,0,0,1,1,0.0,0.0
Gorj,primanews.ro,1,0,0,1,1.0,1.0
Ion Iordache,primanews.ro,2,0,0,2,1.0,1.0
Iordache,primanews.ro,0,0,2,2,0.0,0.0
Teleorman,primanews.ro,0,0,1,1,0.0,0.0
finalist,www.cotidianul.ro,0,0,1,1,0.0,0.0
Iuliana Scantei,www.aktual24.ro,0,0,2,2,0.0,0.0
judecătoare,www.aktual24.ro,0,0,2,2,0.0,0.0
Gheorghe Rosculet,adevarul.ro,0,0,1,1,0.0,0.0
Rosculet,adevarul.ro,0,0,1,1,0.0,0.0
Vasile Suciu,adevarul.ro,0,0,1,1,0.0,0.0
Ana Roxana Rosca,www.luju.ro,0,0,1,1,0.0,0.0
Anca Emilia Cordos,www.luju.ro,0,0,2,2,0.0,0.0
Catalin Traistaru,www.luju.ro,0,0,1,1,0.0,0.0
cenzor,www.luju.ro,0,0,1,1,0.0,0.0
Cristiana Popa,www.luju.ro,0,0,1,1,0.0,0.0
Erika,www.luju.ro,0,0,1,1,0.0,0.0
George Cristian Nadaban,www.luju.ro,0,0,1,1,0.0,0.0
George Pirvu,www.luju.ro,0,0,1,1,0.0,0.0
Janina Cretan,www.luju.ro,0,0,1,1,0.0,0.0
Liviu Daraban,www.luju.ro,0,0,1,1,0.0,0.0
Mariana Budur,www.luju.ro,0,0,1,1,0.0,0.0
Marina Vasile,www.luju.ro,0,0,1,1,0.0,0.0
Silviu Răzvan Creangă,www.luju.ro,0,0,1,1,0.0,0.0
Răzvan Crețan,www.luju.ro,0,0,1,1,0.0,0.0
delegat,www.luju.ro,0,0,1,1,0.0,0.0
Roxana Ana Rosca,www.luju.ro,0,0,1,1,0.0,0.0
Mesia,primanews.ro,0,1,0,1,-1.0,1.0
Călin Popescu Tăriceanu,stirileprotv.ro,0,0,1,1,0.0,0.0
nemulțumit,stirileprotv.ro,0,1,0,1,-1.0,1.0
rival,stirileprotv.ro,0,1,0,1,-1.0,1.0
Rector,observatornews.ro,0,0,1,1,0.0,0.0
Clienți,adevarul.ro,0,0,1,1,0.0,0.0
Viorel Ștefan,adevarul.ro,0,0,2,2,0.0,0.0
Oana Țoiu,primanews.ro,0,0,1,1,0.0,0.0
Alin Stoica,primanews.ro,0,0,1,1,0.0,0.0
Madrid,primanews.ro,0,0,1,1,0.0,0.0
Sara Aagesen,primanews.ro,0,0,1,1,0.0,0.0
Caraș Severin,www.digi24.ro,0,0,1,1,0.0,0.0
Crimeea,www.aktual24.ro,0,1,0,1,-1.0,1.0
Imperiul Otoman,www.aktual24.ro,0,0,1,1,0.0,0.0
Patrusev,www.aktual24.ro,0,1,0,1,-1.0,1.0
RMD,www.aktual24.ro,1,0,0,1,1.0,1.0
Uniunea Sovietică,www.aktual24.ro,0,1,0,1,-1.0,1.0
baltic,www.aktual24.ro,0,0,1,1,0.0,0.0
oligarh,www.aktual24.ro,0,1,0,1,-1.0,1.0
Beniamin Netanyahu,www.aktual24.ro,0,1,1,2,-0.5,0.5
CTP,www.cotidianul.ro,0,1,0,1,-1.0,1.0
Munteanu,www.cotidianul.ro,0,0,1,1,0.0,0.0
Amol Rajan,primanews.ro,0,0,1,1,0.0,0.0
Gabby Logan,primanews.ro,0,0,1,1,0.0,0.0
Gary Lineker,primanews.ro,0,0,1,1,0.0,0.0
Kelly Cates,primanews.ro,0,0,1,1,0.0,0.0
Lineker,primanews.ro,0,0,1,1,0.0,0.0
Mark Chapman,primanews.ro,0,0,1,1,0.0,0.0
fotbalist,primanews.ro,0,0,2,2,0.0,0.0
Glodeanu Sărat,recorder.ro,0,0,1,1,0.0,0.0
Alexandra Presură,www.comisarul.ro,0,2,3,5,-0.4,0.4
Liei Olguța Vasilescu,www.comisarul.ro,0,0,1,1,0.0,0.0
Manda,www.comisarul.ro,0,1,0,1,-1.0,1.0
presură,www.comisarul.ro,0,1,0,1,-1.0,1.0
Protejata,www.comisarul.ro,0,0,1,1,0.0,0.0
Zoia Dinulescu,www.comisarul.ro,0,0,2,2,0.0,0.0
creditor,www.comisarul.ro,0,1,0,1,-1.0,1.0
Presură,www.comisarul.ro,0,1,0,1,-1.0,1.0
pensionară,www.comisarul.ro,0,1,0,1,-1.0,1.0
primăriță,www.comisarul.ro,0,1,0,1,-1.0,1.0
Cristian Presură,www.comisarul.ro,0,0,1,1,0.0,0.0
artizan,www.aktual24.ro,0,1,0,1,-1.0,1.0
donator,www.aktual24.ro,0,2,0,2,-1.0,1.0
ea,www.aktual24.ro,0,2,0,2,-1.0,1.0
Lidia Vadim Tudor,www.g4media.ro,0,0,1,1,0.0,0.0
Nina Stelea,www.g4media.ro,0,0,1,1,0.0,0.0
Octavian Bădescu,www.g4media.ro,0,0,1,1,0.0,0.0
Alin Coleșa,www.antena3.ro,0,0,1,1,0.0,0.0
Coleșa,www.antena3.ro,0,0,1,1,0.0,0.0
Alex Jones,pressone.ro,0,1,0,1,-1.0,1.0
Laurei Kövesi,pressone.ro,0,1,0,1,-1.0,1.0
Manicea,pressone.ro,0,1,0,1,-1.0,1.0
Narcis Manicea,pressone.ro,0,2,0,2,-1.0,1.0
Slatinei,pressone.ro,0,1,0,1,-1.0,1.0
Chestor,adevarul.ro,0,0,1,1,0.0,0.0
Otopeni,adevarul.ro,0,0,1,1,0.0,0.0
Tuță,adevarul.ro,0,0,1,1,0.0,0.0
Bodea,recorder.ro,0,0,2,2,0.0,0.0
Câmpeni,recorder.ro,0,0,1,1,0.0,0.0
Domnul Bodea,recorder.ro,0,0,1,1,0.0,0.0
Gog,recorder.ro,0,1,1,2,-0.5,0.5
Gog Valentin Tiberiu,recorder.ro,0,0,1,1,0.0,0.0
Ilie Călin Bodea,recorder.ro,0,0,2,2,0.0,0.0
Valentin Gog,recorder.ro,0,0,1,1,0.0,0.0
nenorocit,recorder.ro,0,1,0,1,-1.0,1.0
Călin Andreș,recorder.ro,0,0,1,1,0.0,0.0
Ana Maria Gavrilă,www.news.ro,0,0,1,1,0.0,0.0
Ciprian Ciucu,observatornews.ro,0,0,3,3,0.0,0.0
Dan Vâlceanu,observatornews.ro,0,0,1,1,0.0,0.0
Emil Boc,observatornews.ro,0,0,1,1,0.0,0.0
Ciucă,www.b1tv.ro,1,0,0,1,1.0,1.0
Nicolae-Ionel Ciucă,www.b1tv.ro,1,0,0,1,1.0,1.0
George,www.b1tv.ro,0,0,1,1,0.0,0.0
Moldovan,www.b1tv.ro,0,0,1,1,0.0,0.0
Thomas Moldovan,www.b1tv.ro,0,0,1,1,0.0,0.0
polițist,www.realitatea.net,0,0,1,1,0.0,0.0
Ludovic Orban,www.aktual24.ro,0,0,1,1,0.0,0.0
Oradea,www.aktual24.ro,0,0,1,1,0.0,0.0
Adrian Duicu,stirileprotv.ro,0,1,0,1,-1.0,1.0
Braila,stirileprotv.ro,0,0,1,1,0.0,0.0
Constantin Nicolescu,stirileprotv.ro,0,1,0,1,-1.0,1.0
Gheorghe Bunea Stancu,stirileprotv.ro,0,1,0,1,-1.0,1.0
Ion Prioteasa,stirileprotv.ro,0,1,0,1,-1.0,1.0
Marian Oprisan,stirileprotv.ro,0,1,0,1,-1.0,1.0
Mircea Cosma,stirileprotv.ro,0,1,0,1,-1.0,1.0
Nicușor Constatinescu,stirileprotv.ro,0,1,0,1,-1.0,1.0
Poiana Brașov,stirileprotv.ro,0,0,1,1,0.0,0.0
grec,stirileprotv.ro,0,1,0,1,-1.0,1.0
Bacău,observatornews.ro,0,0,2,2,0.0,0.0
Ploiești,www.news.ro,0,0,1,1,0.0,0.0
sindicalist,www.aktual24.ro,0,1,0,1,-1.0,1.0
retailer,www.comisarul.ro,0,1,0,1,-1.0,1.0
comerciant,www.comisarul.ro,0,1,0,1,-1.0,1.0
Adinei Vălean,recorder.ro,0,0,1,1,0.0,0.0
artizan,recorder.ro,0,1,1,2,-0.5,0.5
Avramescu,www.euronews.ro,0,1,0,1,-1.0,1.0
Dansul,www.euronews.ro,0,1,0,1,-1.0,1.0
criminal,www.euronews.ro,0,2,0,2,-1.0,1.0
oportunist,www.euronews.ro,0,1,0,1,-1.0,1.0
Bullmann,www.activenews.ro,0,1,0,1,-1.0,1.0
Bănie,www.activenews.ro,0,1,0,1,-1.0,1.0
dregător,www.activenews.ro,0,1,0,1,-1.0,1.0
ticălos,www.activenews.ro,0,3,0,3,-1.0,1.0
Monica Iacob Ridzi,recorder.ro,0,0,1,1,0.0,0.0
Nicolae Ștefănuță,recorder.ro,0,0,3,3,0.0,0.0
Rășinari,recorder.ro,0,0,1,1,0.0,0.0
Viena,recorder.ro,0,0,3,3,0.0,0.0
raportor general,recorder.ro,0,0,1,1,0.0,0.0
Antonio Costa,observatornews.ro,0,1,0,1,-1.0,1.0
Estonia,observatornews.ro,0,0,1,1,0.0,0.0
Portugalia,observatornews.ro,0,1,0,1,-1.0,1.0
Roberta Metsola,observatornews.ro,0,0,1,1,0.0,0.0
ar,observatornews.ro,0,1,0,1,-1.0,1.0
Crin,observatornews.ro,1,0,0,1,1.0,1.0
Lide,observatornews.ro,0,0,1,1,0.0,0.0
prezidențiabil,observatornews.ro,1,0,0,1,1.0,1.0
mogosoaie,www.aktual24.ro,0,0,1,1,0.0,0.0
bodyguard,www.aktual24.ro,0,1,0,1,-1.0,1.0
Rector,www.aktual24.ro,0,0,1,1,0.0,0.0
Amândoi,snoop.ro,1,0,0,1,1.0,1.0
Bogdan,snoop.ro,0,0,1,1,0.0,0.0
Cristela,snoop.ro,0,1,0,1,-1.0,1.0
Călin,snoop.ro,1,0,1,2,0.5,0.5
Horia,snoop.ro,0,0,1,1,0.0,0.0
Iuliana Neagu,snoop.ro,1,0,0,1,1.0,1.0
Orban,snoop.ro,0,1,0,1,-1.0,1.0
Robert,snoop.ro,0,0,1,1,0.0,0.0
TikTok,snoop.ro,0,0,1,1,0.0,0.0
veterinar,snoop.ro,0,0,1,1,0.0,0.0
alț,snoop.ro,0,1,0,1,-1.0,1.0
casnică,snoop.ro,0,0,1,1,0.0,0.0
dumnealui,snoop.ro,1,0,0,1,1.0,1.0
hoț,snoop.ro,0,1,0,1,-1.0,1.0
intelectual,snoop.ro,0,1,0,1,-1.0,1.0
intervievat,snoop.ro,0,0,2,2,0.0,0.0
lache,snoop.ro,0,1,0,1,-1.0,1.0
nepoată,snoop.ro,0,1,0,1,-1.0,1.0
noi,snoop.ro,0,1,0,1,-1.0,1.0
papagal,snoop.ro,0,1,0,1,-1.0,1.0
promotor,snoop.ro,0,1,0,1,-1.0,1.0
propagandist,snoop.ro,0,1,0,1,-1.0,1.0
proros,snoop.ro,0,1,0,1,-1.0,1.0
proști,snoop.ro,0,1,0,1,-1.0,1.0
păcătos,snoop.ro,0,1,0,1,-1.0,1.0
regizor,snoop.ro,0,0,1,1,0.0,0.0
tiktokar,snoop.ro,0,1,0,1,-1.0,1.0
Alexandru Burdescu,www.g4media.ro,0,0,1,1,0.0,0.0
Ciprian Blejan,www.g4media.ro,0,0,1,1,0.0,0.0
Căbești,www.g4media.ro,0,0,1,1,0.0,0.0
Florin Popa,www.g4media.ro,0,0,1,1,0.0,0.0
Florin Sere,www.g4media.ro,0,0,1,1,0.0,0.0
Ioan Gheorghe Blaj,www.g4media.ro,0,0,1,1,0.0,0.0
Ionel Adrian Sârb,www.g4media.ro,0,0,1,1,0.0,0.0
Mihai Lasca,www.g4media.ro,0,0,1,1,0.0,0.0
Rieni,www.g4media.ro,0,0,1,1,0.0,0.0
Corina Ene,www.g4media.ro,0,0,1,1,0.0,0.0
Mircea Mălan,www.g4media.ro,0,0,1,1,0.0,0.0
oponent,www.g4media.ro,0,0,1,1,0.0,0.0
predecesor,www.g4media.ro,0,0,1,1,0.0,0.0
Gheorghe Bota,www.g4media.ro,0,0,1,1,0.0,0.0
Adeluța Mădălina Andrei,pressone.ro,0,0,1,1,0.0,0.0
Alexandru Andrei,pressone.ro,0,0,1,1,0.0,0.0
Claudia Țapardel,pressone.ro,0,0,1,1,0.0,0.0
Primar General,pressone.ro,1,0,0,1,1.0,1.0
Grațiela Aurelia Drăghici,pressone.ro,0,1,0,1,-1.0,1.0
Grațiela Drăghici,pressone.ro,0,0,1,1,0.0,0.0
Grațiel Drăghici,pressone.ro,0,0,1,1,0.0,0.0
Liviu Ioan Adrian Pleșoianu,pressone.ro,0,0,1,1,0.0,0.0
Marius Alexandru Dunca,pressone.ro,0,0,1,1,0.0,0.0
Mirela Furtună,pressone.ro,0,1,0,1,-1.0,1.0
Oana Florea,pressone.ro,0,0,2,2,0.0,0.0
Radu Iordăchel,pressone.ro,0,0,1,1,0.0,0.0
Vasile Drăghici,pressone.ro,0,0,1,1,0.0,0.0
coach,pressone.ro,0,0,1,1,0.0,0.0
consilier parlamentar,pressone.ro,0,0,2,2,0.0,0.0
gospodină,pressone.ro,0,1,0,1,-1.0,1.0
inginer mecanic,pressone.ro,0,0,1,1,0.0,0.0
Ramona Bădescu,www.digi24.ro,0,0,3,3,0.0,0.0
Alba Iulia,www.digi24.ro,0,0,1,1,0.0,0.0
Bădescu,www.digi24.ro,0,0,1,1,0.0,0.0
Roma,www.digi24.ro,1,0,0,1,1.0,1.0
Tokes Laszlo,www.antena3.ro,0,0,1,1,0.0,0.0
Laszlo Tokes,www.antena3.ro,0,0,1,1,0.0,0.0
Dumbrava,www.realitatea.net,0,0,1,1,0.0,0.0
Iorga,www.realitatea.net,0,0,1,1,0.0,0.0
J,www.realitatea.net,0,0,1,1,0.0,0.0
Kennedy,www.realitatea.net,0,0,1,1,0.0,0.0
Mihai Eminescu,www.realitatea.net,0,0,1,1,0.0,0.0
Militianul Predoiu,www.realitatea.net,0,1,0,1,-1.0,1.0
Munchen,www.realitatea.net,0,0,1,1,0.0,0.0
băietel,www.realitatea.net,1,0,0,1,1.0,1.0
Cristina Preda,www.realitatea.net,0,1,0,1,-1.0,1.0
Antoinescu,www.realitatea.net,0,0,1,1,0.0,0.0
dansator,www.realitatea.net,0,2,0,2,-1.0,1.0
ofiter,www.realitatea.net,0,1,0,1,-1.0,1.0
omenire,www.realitatea.net,0,0,1,1,0.0,0.0
seful,www.realitatea.net,0,1,0,1,-1.0,1.0
Vance,www.realitatea.net,0,1,0,1,-1.0,1.0
vinovat,www.realitatea.net,0,3,0,3,-1.0,1.0
voluntar,www.realitatea.net,1,0,0,1,1.0,1.0
Andrei Daniel Gheorghe,recorder.ro,0,0,1,1,0.0,0.0
Chiajna,recorder.ro,0,1,1,2,-0.5,0.5
Cornel Zainea,recorder.ro,0,0,1,1,0.0,0.0
Florin Andrei Senat,recorder.ro,0,0,1,1,0.0,0.0
Ilfovul,recorder.ro,0,1,0,1,-1.0,1.0
Malcolm Gladwell,recorder.ro,0,0,1,1,0.0,0.0
Mark Manson,recorder.ro,0,0,1,1,0.0,0.0
Măgurele,recorder.ro,0,0,1,1,0.0,0.0
Nicoleta Pauliuc,recorder.ro,0,0,1,1,0.0,0.0
Oana Cambera,recorder.ro,0,0,1,1,0.0,0.0
România Mare,recorder.ro,0,0,1,1,0.0,0.0
Ioan Gură de Aur,recorder.ro,0,0,1,1,0.0,0.0
Vidra,recorder.ro,0,1,0,1,-1.0,1.0
aparținător,recorder.ro,0,0,1,1,0.0,0.0
pasionat,recorder.ro,1,0,0,1,1.0,1.0
Andrei Rizoiu,recorder.ro,0,1,0,1,-1.0,1.0
Dăncilă,observatornews.ro,0,0,1,1,0.0,0.0
Radu Oprea,www.mediafax.ro,0,0,1,1,0.0,0.0
Marian Lazăr,www.g4media.ro,0,0,1,1,0.0,0.0
Adi Hădean,www.digi24.ro,0,0,1,1,0.0,0.0
Ionela Năstase,www.digi24.ro,0,0,1,1,0.0,0.0
manager,www.digi24.ro,0,1,0,1,-1.0,1.0
soră,www.digi24.ro,0,0,2,2,0.0,0.0
absolvent,www.gandul.ro,1,0,0,1,1.0,1.0
Andrei Gușă,www.gandul.ro,0,0,1,1,0.0,0.0
Bogdan Comaroni,www.gandul.ro,0,0,1,1,0.0,0.0
Cozmin Gusă,www.gandul.ro,0,1,0,1,-1.0,1.0
Ninel Peia,www.gandul.ro,0,0,1,1,0.0,0.0
Răzvan Savaliuc,www.gandul.ro,0,0,1,1,0.0,0.0
Sorin Roșca Stănescu,www.gandul.ro,0,0,1,1,0.0,0.0
Sri Lanka,www.gandul.ro,0,1,0,1,-1.0,1.0
cadru,www.gandul.ro,0,1,0,1,-1.0,1.0
Luis Lazarus,www.gandul.ro,0,0,2,2,0.0,0.0
militant,www.gandul.ro,1,0,0,1,1.0,1.0
muncitor,www.gandul.ro,0,1,0,1,-1.0,1.0
Florian Colceag,www.gandul.ro,0,0,1,1,0.0,0.0
sportiv,www.gandul.ro,1,0,1,2,0.5,0.5
Andrei,www.antena3.ro,0,0,1,1,0.0,0.0
Beijing,www.euronews.ro,0,0,1,1,0.0,0.0
Keir Starmer,www.euronews.ro,0,0,1,1,0.0,0.0
Mamaia,www.euronews.ro,0,0,1,1,0.0,0.0
Xi Jinping,www.euronews.ro,0,0,1,1,0.0,0.0
Sud,www.euronews.ro,0,1,0,1,-1.0,1.0
cuvânt,www.euronews.ro,0,1,0,1,-1.0,1.0
finalist,www.euronews.ro,0,0,1,1,0.0,0.0
rezident,www.euronews.ro,0,0,1,1,0.0,0.0
Mirea,stirileprotv.ro,0,0,1,1,0.0,0.0
Șerban Nicolae,stirileprotv.ro,0,0,1,1,0.0,0.0
aceastia,a1.ro,0,0,1,1,0.0,0.0
Adrian Miclescu,a1.ro,0,0,1,1,0.0,0.0
Bradisteanu,a1.ro,0,0,2,2,0.0,0.0
Diana Gasparovici,a1.ro,0,0,1,1,0.0,0.0
Ioan Lascar,a1.ro,0,0,1,1,0.0,0.0
Ion Cazacu,a1.ro,0,0,2,2,0.0,0.0
Marian Ioana,a1.ro,0,0,1,1,0.0,0.0
Marina Popovici,a1.ro,0,0,1,1,0.0,0.0
Mihail Cristian Vasile,a1.ro,0,0,1,1,0.0,0.0
poltist,a1.ro,0,1,0,1,-1.0,1.0
Radu Tudo,a1.ro,0,0,1,1,0.0,0.0
Șerban Bradisteanu,a1.ro,0,0,1,1,0.0,0.0
Zamfir Zambaccian,a1.ro,0,0,1,1,0.0,0.0
apărător,a1.ro,0,0,1,1,0.0,0.0
Mircea Beuran,a1.ro,0,0,1,1,0.0,0.0
inspector general,a1.ro,0,0,1,1,0.0,0.0
Serban Bradisteanu,a1.ro,0,0,1,1,0.0,0.0
mentor,a1.ro,0,0,1,1,0.0,0.0
Alice Draghici,a1.ro,0,0,1,1,0.0,0.0
aviator,www.aktual24.ro,0,1,0,1,-1.0,1.0
secretar general adjunct,www.cotidianul.ro,0,0,1,1,0.0,0.0
Michael,a1.ro,0,0,1,1,0.0,0.0
Michael Stanciu,a1.ro,0,0,1,1,0.0,0.0
emigrant,a1.ro,0,0,1,1,0.0,0.0
Marko Berla,www.mediafax.ro,0,0,1,1,0.0,0.0
Eckstein Kovacs Peter,www.mediafax.ro,0,0,1,1,0.0,0.0
Valeriu,a1.ro,0,0,1,1,0.0,0.0
Dan Darabont,www.mediafax.ro,0,0,1,1,0.0,0.0
Dan Darabonț,www.mediafax.ro,0,0,1,1,0.0,0.0
Gabriel Pârvu,www.mediafax.ro,0,0,1,1,0.0,0.0
Horațiu Panaitescu,www.mediafax.ro,0,0,1,1,0.0,0.0
Horia Scarlat,www.mediafax.ro,0,0,1,1,0.0,0.0
Iulia Zorkoczy,www.mediafax.ro,0,0,1,1,0.0,0.0
Lucian Iliescu,www.mediafax.ro,0,0,2,2,0.0,0.0
Marcel Nicolaescu,www.mediafax.ro,0,0,1,1,0.0,0.0
Marius Țugure,www.mediafax.ro,0,0,1,1,0.0,0.0
Nicolae Petrovan,www.mediafax.ro,0,0,1,1,0.0,0.0
Richard Ghiță,www.mediafax.ro,0,0,2,2,0.0,0.0
Sorin Oprescu,www.mediafax.ro,0,0,2,2,0.0,0.0
Tudor Toma,www.mediafax.ro,0,0,1,1,0.0,0.0
consilier general,www.mediafax.ro,0,0,1,1,0.0,0.0
Mircea Raicu,www.mediafax.ro,0,0,1,1,0.0,0.0
Marius Oprescu,www.cotidianul.ro,0,0,1,1,0.0,0.0
Oprescu,www.cotidianul.ro,0,0,1,1,0.0,0.0
Marius Tucă,www.cotidianul.ro,0,0,1,1,0.0,0.0
Diaconu,pressone.ro,0,0,1,1,0.0,0.0
Heisenberg,pressone.ro,0,0,1,1,0.0,0.0
Iulian Capsali,www.g4media.ro,0,0,1,1,0.0,0.0
Geneva,recorder.ro,0,0,2,2,0.0,0.0
Neptun,recorder.ro,0,0,1,1,0.0,0.0
Tineret,recorder.ro,0,1,0,1,-1.0,1.0
actorul Victor Rebengiuc,recorder.ro,0,1,0,1,-1.0,1.0
Moise Guran,adevarul.ro,0,0,1,1,0.0,0.0
Budapesta,agerpres.ro,0,0,1,1,0.0,0.0
trimis,recorder.ro,0,1,0,1,-1.0,1.0
Giurgiu,www.news.ro,0,0,1,1,0.0,0.0
Horia Constantinescu,www.news.ro,0,0,1,1,0.0,0.0
Paul Anghel,www.news.ro,0,0,1,1,0.0,0.0
director general,www.news.ro,0,0,1,1,0.0,0.0
actor,www.news.ro,0,0,1,1,0.0,0.0
actorii,www.news.ro,0,0,1,1,0.0,0.0
Porțile de Fier,www.mediafax.ro,0,1,1,2,-0.5,0.5
Cadrele,www.digi24.ro,0,0,1,1,0.0,0.0
Congo,www.digi24.ro,0,0,1,1,0.0,0.0
lector universitar,pressone.ro,0,1,0,1,-1.0,1.0
Alexandru Potor,www.luju.ro,1,0,0,1,1.0,1.0
Ialomița,www.luju.ro,0,0,1,1,0.0,0.0
Ion Teodorescu,www.luju.ro,0,0,1,1,0.0,0.0
Marian Pavel,www.luju.ro,2,0,0,2,1.0,1.0
Slobozia,www.luju.ro,1,0,0,1,1.0,1.0
slobozie,www.luju.ro,1,0,0,1,1.0,1.0
cunoscut,www.luju.ro,1,0,0,1,1.0,1.0
locuitor,www.luju.ro,2,0,0,2,1.0,1.0
Georgescu Călin Georgescu,adevarul.ro,0,0,1,1,0.0,0.0
România Mare,adevarul.ro,0,0,1,1,0.0,0.0
afrasinie,www.luju.ro,0,1,0,1,-1.0,1.0
Madalina Afrasinie,www.luju.ro,0,2,0,2,-1.0,1.0
Valentin Teodorescu,www.luju.ro,0,0,1,1,0.0,0.0
fost,www.luju.ro,0,0,1,1,0.0,0.0
maior,www.luju.ro,0,1,0,1,-1.0,1.0
Lia Olguța Vasilescu,www.antena3.ro,0,2,0,2,-1.0,1.0
Olguța Vasilescu,www.antena3.ro,0,1,0,1,-1.0,1.0
Vasilescu,www.antena3.ro,0,1,0,1,-1.0,1.0
Borza,adevarul.ro,0,1,0,1,-1.0,1.0
Remus Borza,adevarul.ro,0,0,1,1,0.0,0.0
Bogdan Aurescu,www.mediafax.ro,0,0,1,1,0.0,0.0
Gabriela Szabo,www.mediafax.ro,0,0,1,1,0.0,0.0
Sorin Câmpeanu,www.mediafax.ro,0,0,1,1,0.0,0.0
militar,www.mediafax.ro,0,0,1,1,0.0,0.0
pomper,www.mediafax.ro,0,1,0,1,-1.0,1.0
Claudiu Manda,www.news.ro,0,0,1,1,0.0,0.0
Dan Nica,www.news.ro,0,0,1,1,0.0,0.0
Dragoș Benea,www.news.ro,0,0,1,1,0.0,0.0
Maria Grapini,www.news.ro,0,0,1,1,0.0,0.0
Ștefan Mușoiu,www.news.ro,0,0,1,1,0.0,0.0
educatoare,recorder.ro,0,1,0,1,-1.0,1.0
Caciauna,www.digi24.ro,0,0,1,1,0.0,0.0
Cătălin Firoiu,www.digi24.ro,0,0,1,1,0.0,0.0
Mihai Viteazul,www.digi24.ro,1,0,0,1,1.0,1.0
operator,www.digi24.ro,0,0,1,1,0.0,0.0
interlocutor,www.digi24.ro,0,1,0,1,-1.0,1.0
niciunul,www.digi24.ro,0,1,0,1,-1.0,1.0
prietene,www.digi24.ro,1,0,0,1,1.0,1.0
săteni,www.digi24.ro,0,1,0,1,-1.0,1.0
Ionuț Militaru,www.luju.ro,0,0,1,1,0.0,0.0
Statul Român,www.luju.ro,0,1,0,1,-1.0,1.0
subsemnatul,www.luju.ro,0,0,1,1,0.0,0.0
Werner,www.luju.ro,0,2,0,2,-1.0,1.0
Alexe,www.aktual24.ro,0,0,1,1,0.0,0.0
Dan Alexe,www.aktual24.ro,0,0,1,1,0.0,0.0
Heidi Reichinnek,www.euronews.ro,0,0,1,1,0.0,0.0
Lars Klingbeil,www.euronews.ro,0,0,1,1,0.0,0.0
Sören Pellmann,www.euronews.ro,0,0,1,1,0.0,0.0
copreședinte,www.euronews.ro,0,0,2,2,0.0,0.0
Alex Nicodim,www.aktual24.ro,0,0,1,1,0.0,0.0
Coldea,www.aktual24.ro,0,2,0,2,-1.0,1.0
Ioan Rus,www.aktual24.ro,0,0,3,3,0.0,0.0
Rus,www.aktual24.ro,0,2,1,3,-0.6666666666666666,0.6666666666666666
Snoop,www.aktual24.ro,0,0,2,2,0.0,0.0
Chelaru,www.aktual24.ro,0,2,0,2,-1.0,1.0
George Becali,www.aktual24.ro,0,2,0,2,-1.0,1.0
Lasca,www.aktual24.ro,0,2,0,2,-1.0,1.0
Petrisor Peiu,www.aktual24.ro,0,0,2,2,0.0,0.0
rege,www.aktual24.ro,0,3,0,3,-1.0,1.0
Assen,recorder.ro,0,0,1,1,0.0,0.0
Auschwitz,recorder.ro,0,1,0,1,-1.0,1.0
Columbia,recorder.ro,0,0,2,2,0.0,0.0
Congo,recorder.ro,0,0,1,1,0.0,0.0
Coțofenești,recorder.ro,0,0,1,1,0.0,0.0
Ernest Târnoveanu,recorder.ro,0,0,1,1,0.0,0.0
mercenar,recorder.ro,0,1,0,1,-1.0,1.0
Pavel Șușară,recorder.ro,0,1,0,1,-1.0,1.0
Raluca Turcan,recorder.ro,0,1,1,2,-0.5,0.5
Andrei Pogăciaș,recorder.ro,0,0,1,1,0.0,0.0
Marcel Ciolac,primanews.ro,0,0,1,1,0.0,0.0
Bogdan Deleanu,pressone.ro,0,0,1,1,0.0,0.0
Giorgio Meloni,pressone.ro,0,0,1,1,0.0,0.0
Tana Foarfă,pressone.ro,0,0,1,1,0.0,0.0
Ioan Stanomir,pressone.ro,0,0,1,1,0.0,0.0
Mihai Seitan,a1.ro,0,1,0,1,-1.0,1.0
Sorin Andi Pandele,a1.ro,0,1,0,1,-1.0,1.0
Elena Lăsconi,www.activenews.ro,0,1,0,1,-1.0,1.0
diplomat,www.activenews.ro,0,0,1,1,0.0,0.0
indecit,www.activenews.ro,0,1,0,1,-1.0,1.0
inginer,www.activenews.ro,0,1,0,1,-1.0,1.0
polițist,www.activenews.ro,0,2,0,2,-1.0,1.0
pompier,www.activenews.ro,0,1,0,1,-1.0,1.0
Berceanu,a1.ro,0,0,1,1,0.0,0.0
Vantu,a1.ro,0,1,0,1,-1.0,1.0
Andrei Badiu,www.g4media.ro,0,0,1,1,0.0,0.0
Bogdan Jelea,www.g4media.ro,0,0,1,1,0.0,0.0
Cosmin Smighelschi,www.g4media.ro,0,0,1,1,0.0,0.0
Lucian Judele,www.g4media.ro,0,0,1,1,0.0,0.0
mitoman,observatornews.ro,0,1,0,1,-1.0,1.0
Dudu Ionescu,adevarul.ro,0,0,1,1,0.0,0.0
Remus Opris,adevarul.ro,0,0,1,1,0.0,0.0
sabotor,adevarul.ro,0,2,0,2,-1.0,1.0
Tovarăș,adevarul.ro,0,1,0,1,-1.0,1.0
inculpat,adevarul.ro,0,1,0,1,-1.0,1.0
sprijinitor,adevarul.ro,0,1,0,1,-1.0,1.0
vrajmas,adevarul.ro,0,1,0,1,-1.0,1.0
mireasă,a1.ro,0,0,1,1,0.0,0.0
Ambii,www.antena3.ro,0,0,1,1,0.0,0.0
Bucureștean,www.antena3.ro,0,0,1,1,0.0,0.0
primar general,www.antena3.ro,0,0,3,3,0.0,0.0
Jens Stoltenberg,adevarul.ro,0,0,1,1,0.0,0.0
Stoltenberg,adevarul.ro,0,0,1,1,0.0,0.0
Valeri Chali,adevarul.ro,0,0,1,1,0.0,0.0
Volodimir Zelenski,adevarul.ro,0,0,2,2,0.0,0.0
Paris,www.mediafax.ro,1,0,0,1,1.0,1.0
Joe Biden,www.mediafax.ro,0,0,4,4,0.0,0.0
promotor,www.mediafax.ro,1,0,0,1,1.0,1.0
ranger,www.mediafax.ro,0,0,1,1,0.0,0.0
Bahamas,pressone.ro,0,0,1,1,0.0,0.0
Boris Johnson,pressone.ro,0,1,0,1,-1.0,1.0
Daniel,pressone.ro,0,0,1,1,0.0,0.0
Radu Vancu,pressone.ro,0,0,3,3,0.0,0.0
arhiepiscop,pressone.ro,0,0,1,1,0.0,0.0
doamna Șoșoacă,pressone.ro,0,1,0,1,-1.0,1.0
nevaccinat,pressone.ro,0,1,0,1,-1.0,1.0
Cutare,www.digi24.ro,0,1,0,1,-1.0,1.0
nimeni,www.digi24.ro,0,1,0,1,-1.0,1.0
David Cameron,stirileprotv.ro,0,1,0,1,-1.0,1.0
Toti,stirileprotv.ro,1,0,0,1,1.0,1.0
emigrant,stirileprotv.ro,1,0,0,1,1.0,1.0
Ana Birchall,www.digi24.ro,0,0,1,1,0.0,0.0
Anei Birchall,www.digi24.ro,0,0,1,1,0.0,0.0
Birchall,www.digi24.ro,0,0,1,1,0.0,0.0
patron,www.cotidianul.ro,0,2,0,2,-1.0,1.0
Andy Ogles,www.antena3.ro,0,0,2,2,0.0,0.0
Anna Paulina Luna,www.antena3.ro,0,0,2,2,0.0,0.0
Cosmin Corendea,www.antena3.ro,0,0,1,1,0.0,0.0
Ramona Ioana Bruynseels,www.antena3.ro,0,0,1,1,0.0,0.0
Tennessee,www.antena3.ro,0,0,1,1,0.0,0.0
nevoiaș,www.romaniatv.net,0,1,0,1,-1.0,1.0
Angel Tâlvar,stirileprotv.ro,0,0,1,1,0.0,0.0
Corina Bokor,www.mediafax.ro,0,0,2,2,0.0,0.0
Helmut Lerner,www.mediafax.ro,0,0,1,1,0.0,0.0
Adrian Axinia,www.gandul.ro,0,0,1,1,0.0,0.0
Dragoș Benea,www.gandul.ro,0,0,1,1,0.0,0.0
Nicu Ștefănuță,www.gandul.ro,0,0,1,1,0.0,0.0
Gabriela,observatornews.ro,0,0,1,1,0.0,0.0
Bitză,www.romaniatv.net,0,0,1,1,0.0,0.0
Imperiul Țarist,www.romaniatv.net,0,1,0,1,-1.0,1.0
nimeni,www.romaniatv.net,0,0,1,1,0.0,0.0
Tiraspol,www.romaniatv.net,0,0,1,1,0.0,0.0
Vladimir Voronin,www.romaniatv.net,0,0,1,1,0.0,0.0
Adrian Gărdean,www.mediafax.ro,0,0,1,1,0.0,0.0
acolit,www.mediafax.ro,0,1,0,1,-1.0,1.0
azilant,www.mediafax.ro,0,0,1,1,0.0,0.0
general,www.mediafax.ro,0,1,1,2,-0.5,0.5
mamă,www.mediafax.ro,0,1,1,2,-0.5,0.5
Csoma Botond,www.cotidianul.ro,0,0,1,1,0.0,0.0
dottore,www.cotidianul.ro,0,0,1,1,0.0,0.0
procuror șef,stirileprotv.ro,0,0,1,1,0.0,0.0
operator,www.antena3.ro,0,1,0,1,-1.0,1.0
Buzău,www.antena3.ro,0,0,3,3,0.0,0.0
Congo,www.antena3.ro,0,0,1,1,0.0,0.0
Gheorghe Călin,www.antena3.ro,0,0,1,1,0.0,0.0
Horațiu,www.antena3.ro,0,1,0,1,-1.0,1.0
Ilfov,www.antena3.ro,0,0,1,1,0.0,0.0
mercenar,www.antena3.ro,0,2,0,2,-1.0,1.0
Potra Horățiu,www.antena3.ro,0,0,1,1,0.0,0.0
CTP,www.news.ro,1,0,0,1,1.0,1.0
Cristian Tudor Popescu,www.news.ro,1,0,0,1,1.0,1.0
Cristoiu,www.news.ro,0,0,1,1,0.0,0.0
Popescu,www.news.ro,1,0,0,1,1.0,1.0
gazetar,www.news.ro,0,0,1,1,0.0,0.0
intelectual,www.news.ro,0,0,1,1,0.0,0.0
personalitate,www.news.ro,0,0,2,2,0.0,0.0
Amar Ienea,recorder.ro,0,0,1,1,0.0,0.0
inspector-șef,recorder.ro,1,0,0,1,1.0,1.0
inspectorul Ienea,recorder.ro,0,1,0,1,-1.0,1.0
Ion Diaconescu,pressone.ro,0,0,1,1,0.0,0.0
păpușar,pressone.ro,0,1,0,1,-1.0,1.0
țărăniște,pressone.ro,0,1,0,1,-1.0,1.0
Dimitriu,www.b1tv.ro,0,1,0,1,-1.0,1.0
X,www.b1tv.ro,0,0,1,1,0.0,0.0
Y,www.b1tv.ro,0,1,0,1,-1.0,1.0
Z,www.b1tv.ro,0,1,0,1,-1.0,1.0
Sorin Ionita,www.aktual24.ro,0,0,1,1,0.0,0.0
Camelie,www.luju.ro,0,0,1,1,0.0,0.0
Elisabeta Lipă,observatornews.ro,0,0,1,1,0.0,0.0
Florin Jianu,observatornews.ro,0,0,1,1,0.0,0.0
Gheorghe Șoldan,observatornews.ro,0,0,1,1,0.0,0.0
Mihnea Costoiu,observatornews.ro,0,0,1,1,0.0,0.0
Victoria Stoiciu,observatornews.ro,0,0,1,1,0.0,0.0
sărac,observatornews.ro,0,1,0,1,-1.0,1.0
Adriana Ciobanu,www.g4media.ro,0,0,1,1,0.0,0.0
Aurelian Manolica,www.g4media.ro,0,0,1,1,0.0,0.0
Lorenz Mîndru,www.g4media.ro,0,0,1,1,0.0,0.0
Costel Fotea,www.g4media.ro,0,0,1,1,0.0,0.0
Dan Ujeuca,www.g4media.ro,0,0,1,1,0.0,0.0
Dan Ujeucă,www.g4media.ro,0,0,1,1,0.0,0.0
Doina Cărbunescu,www.g4media.ro,0,0,1,1,0.0,0.0
Doinița Ghițescu,www.g4media.ro,0,0,1,1,0.0,0.0
Dragoș Nicolae Cilibiu,www.g4media.ro,0,0,1,1,0.0,0.0
Emanoil Glonțea,www.g4media.ro,0,0,1,1,0.0,0.0
Florina Mariana Alexandru,www.g4media.ro,0,0,1,1,0.0,0.0
Gîdei,www.g4media.ro,0,0,1,1,0.0,0.0
Ioana Carmen Lică,www.g4media.ro,0,0,1,1,0.0,0.0
Laurențiu Viorel Gîdei,www.g4media.ro,0,0,1,1,0.0,0.0
Luminița Gheorghiu,www.g4media.ro,0,0,1,1,0.0,0.0
Maria Scacicov,www.g4media.ro,0,0,1,1,0.0,0.0
Mihaela Răduță,www.g4media.ro,0,0,1,1,0.0,0.0
Mihai Cacoveanu,www.g4media.ro,0,0,1,1,0.0,0.0
Mioara Bădițoiu,www.g4media.ro,0,0,1,1,0.0,0.0
Nicolae Dragoș Răduț,www.g4media.ro,0,0,1,1,0.0,0.0
Oana Crețu,www.g4media.ro,0,0,2,2,0.0,0.0
Pitești,www.g4media.ro,0,0,1,1,0.0,0.0
Sava Elena,www.g4media.ro,0,0,1,1,0.0,0.0
Teodora Ghinescu,www.g4media.ro,0,0,1,1,0.0,0.0
arhitect,www.g4media.ro,0,0,2,2,0.0,0.0
economist,www.g4media.ro,0,0,2,2,0.0,0.0
economișt,www.g4media.ro,0,0,1,1,0.0,0.0
hidrolog,www.g4media.ro,0,0,1,1,0.0,0.0
pensionară,www.g4media.ro,0,0,1,1,0.0,0.0
solist,www.g4media.ro,0,0,1,1,0.0,0.0
tapițer,www.g4media.ro,0,0,1,1,0.0,0.0
Ștefan Dobre,www.g4media.ro,0,0,1,1,0.0,0.0
Ștefan Tănase,www.g4media.ro,0,0,1,1,0.0,0.0
Lucian Romașanu,www.gandul.ro,0,0,1,1,0.0,0.0
cercetător,www.mediafax.ro,0,0,2,2,0.0,0.0
juriști,www.mediafax.ro,0,0,1,1,0.0,0.0
utilizator,www.mediafax.ro,1,0,0,1,1.0,1.0
Marcel,www.euronews.ro,0,0,1,1,0.0,0.0
Nicu,www.euronews.ro,0,1,0,1,-1.0,1.0
Andrei Duda,observatornews.ro,0,1,0,1,-1.0,1.0
Popescu,observatornews.ro,0,0,1,1,0.0,0.0
Kamala Harris,observatornews.ro,0,1,0,1,-1.0,1.0
Mark Rutte,observatornews.ro,0,0,1,1,0.0,0.0
negociator,observatornews.ro,0,1,1,2,-0.5,0.5
Ștefan Popescu,observatornews.ro,0,0,1,1,0.0,0.0
Laura Bouriaud,pressone.ro,0,0,2,2,0.0,0.0
Măguri Răcătău,pressone.ro,0,0,1,1,0.0,0.0
Tanczs Barna,www.antena3.ro,0,0,1,1,0.0,0.0
Le Pen,recorder.ro,0,1,0,1,-1.0,1.0
Mateusz Morawiecki,recorder.ro,0,0,1,1,0.0,0.0
Matteo Salvini,recorder.ro,0,0,1,1,0.0,0.0
absent,recorder.ro,0,1,0,1,-1.0,1.0
infractor,a1.ro,0,1,0,1,-1.0,1.0
vizitator,a1.ro,0,0,1,1,0.0,0.0
Silvia Mușătoiu,recorder.ro,0,0,1,1,0.0,0.0
Andronescu,recorder.ro,0,0,1,1,0.0,0.0
domnie,recorder.ro,0,0,1,1,0.0,0.0
Ministrul Ecaterina Andronescu,recorder.ro,0,1,0,1,-1.0,1.0
Cristian Preda,adevarul.ro,0,0,1,1,0.0,0.0
demolator,www.gandul.ro,0,1,0,1,-1.0,1.0
dezvoltator,www.gandul.ro,0,1,0,1,-1.0,1.0
Iugoslavia,pressone.ro,0,1,0,1,-1.0,1.0
Kovács Peter,pressone.ro,0,1,0,1,-1.0,1.0
Marko,pressone.ro,0,0,1,1,0.0,0.0
dentist,pressone.ro,0,0,1,1,0.0,0.0
Orbán,pressone.ro,0,0,1,1,0.0,0.0
minoritar,pressone.ro,0,1,0,1,-1.0,1.0
parșiv,pressone.ro,0,1,0,1,-1.0,1.0
reformat,pressone.ro,0,1,0,1,-1.0,1.0
secuime,pressone.ro,0,0,1,1,0.0,0.0
István Szekely,pressone.ro,0,1,0,1,-1.0,1.0
Claudiu Manda,www.luju.ro,0,0,1,1,0.0,0.0
Dan Sova,www.luju.ro,0,0,1,1,0.0,0.0
Dumitru Cristea,www.luju.ro,0,0,1,1,0.0,0.0
Elena Marcu,www.luju.ro,0,0,1,1,0.0,0.0
Gheorghe Valentin Chitidean,www.luju.ro,0,0,1,1,0.0,0.0
Hermina Iancu,www.luju.ro,0,0,1,1,0.0,0.0
Ioana Bogdan,www.luju.ro,0,0,1,1,0.0,0.0
Jean Uncheselu,www.luju.ro,0,2,0,2,-1.0,1.0
Lavinia Lefterache,www.luju.ro,0,0,1,1,0.0,0.0
Manda,www.luju.ro,0,1,0,1,-1.0,1.0
Marius Simcescu,www.luju.ro,0,0,1,1,0.0,0.0
Oana Burnel,www.luju.ro,0,0,1,1,0.0,0.0
Rodica Cosma,www.luju.ro,0,0,1,1,0.0,0.0
Uncheselu,www.luju.ro,0,1,0,1,-1.0,1.0
Attal,www.cotidianul.ro,0,1,0,1,-1.0,1.0
Gabriel Attal,www.cotidianul.ro,0,0,1,1,0.0,0.0
Mihai Attal,www.cotidianul.ro,0,1,0,1,-1.0,1.0
Stéphane Séjourné,www.cotidianul.ro,0,0,1,1,0.0,0.0
Séjourné,www.cotidianul.ro,0,1,0,1,-1.0,1.0
loialist,www.cotidianul.ro,1,0,0,1,1.0,1.0
strateg,www.cotidianul.ro,1,0,0,1,1.0,1.0
Dan Andronic,www.romaniatv.net,0,0,1,1,0.0,0.0
Robert Turcescu,www.romaniatv.net,0,0,1,1,0.0,0.0
Adela Popescu,pressone.ro,0,0,1,1,0.0,0.0
Alexandru Marius Tudor,pressone.ro,0,0,1,1,0.0,0.0
Ana Maria Tudor,pressone.ro,0,0,1,1,0.0,0.0
Aurelian Cezar Țolescu,pressone.ro,0,0,1,1,0.0,0.0
Constantin Onișor,pressone.ro,0,0,2,2,0.0,0.0
Constantin Romanoschi,pressone.ro,0,0,1,1,0.0,0.0
Corina Michaela Jîjîie,pressone.ro,0,0,1,1,0.0,0.0
Costică Țenu,pressone.ro,0,0,1,1,0.0,0.0
Cristian Troncotă,pressone.ro,0,0,1,1,0.0,0.0
Câmpanu,pressone.ro,0,1,0,1,-1.0,1.0
Călin Radu Nae,pressone.ro,0,0,1,1,0.0,0.0
Cătălin Chivu,pressone.ro,0,0,1,1,0.0,0.0
Cătălin Ștefan Ibănescu,pressone.ro,0,0,1,1,0.0,0.0
Daniel Moldoveanu,pressone.ro,0,0,2,2,0.0,0.0
Ella Magdalena Ciupercă,pressone.ro,0,0,1,1,0.0,0.0
Florian Răpan,pressone.ro,0,0,1,1,0.0,0.0
Florian Lungu,pressone.ro,0,0,1,1,0.0,0.0
Florina Vevera,pressone.ro,0,0,1,1,0.0,0.0
Gabriel Naghi,pressone.ro,0,0,1,1,0.0,0.0
Gheorghe Ștefan,pressone.ro,0,0,2,2,0.0,0.0
Gheorghe Toma,pressone.ro,0,0,2,2,0.0,0.0
Giarmata,pressone.ro,0,0,1,1,0.0,0.0
Ioan Șandru,pressone.ro,0,0,1,1,0.0,0.0
Ionel Claudiu Pasăre,pressone.ro,0,0,1,1,0.0,0.0
Ionel Goian,pressone.ro,0,0,1,1,0.0,0.0
Ionelia Valentina Morcovescu,pressone.ro,0,0,1,1,0.0,0.0
Iulian Lăzărescu,pressone.ro,0,0,2,2,0.0,0.0
Liviu Câmapanu,pressone.ro,0,0,1,1,0.0,0.0
Liviu Câmpanu,pressone.ro,0,1,0,1,-1.0,1.0
Lăzărescu,pressone.ro,0,0,1,1,0.0,0.0
Marius Hanganu,pressone.ro,0,0,1,1,0.0,0.0
Marius Sticlaru,pressone.ro,0,0,1,1,0.0,0.0
Mihai Vătășoiu,pressone.ro,0,0,1,1,0.0,0.0
Mihai Stănișoară,pressone.ro,0,1,1,2,-0.5,0.5
Radu Stroe,pressone.ro,0,1,1,2,-0.5,0.5
Romeo Oiță,pressone.ro,0,0,1,1,0.0,0.0
Romică Udeanu,pressone.ro,0,0,1,1,0.0,0.0
Sorin Gabriel Cozma,pressone.ro,0,0,1,1,0.0,0.0
Vasile Bucinschi,pressone.ro,0,0,1,1,0.0,0.0
Vasile Rus,pressone.ro,0,0,1,1,0.0,0.0
Victor Adrian Vevera,pressone.ro,0,0,1,1,0.0,0.0
Victor,www.mediafax.ro,0,1,0,1,-1.0,1.0
Alina Achim,www.comisarul.ro,1,0,0,1,1.0,1.0
Ana Maria Cătăuță,www.comisarul.ro,0,0,2,2,0.0,0.0
Liviu Iolu,www.comisarul.ro,1,0,0,1,1.0,1.0
Sandei Nicola,www.comisarul.ro,1,0,0,1,1.0,1.0
Tal Hanan,www.comisarul.ro,0,0,1,1,0.0,0.0
coordonatoare,www.comisarul.ro,0,1,0,1,-1.0,1.0
Cătăuță,www.comisarul.ro,0,0,1,1,0.0,0.0
dansă,www.comisarul.ro,0,0,1,1,0.0,0.0
manager,www.comisarul.ro,0,0,1,1,0.0,0.0
Andrei Popoviciu,www.romaniatv.net,0,0,1,1,0.0,0.0
autor,www.romaniatv.net,0,0,1,1,0.0,0.0
Tim Ross,www.romaniatv.net,0,0,1,1,0.0,0.0
administrator,www.activenews.ro,0,0,2,2,0.0,0.0
Andrei Baciu,www.activenews.ro,0,0,1,1,0.0,0.0
Badulescu,www.activenews.ro,0,0,1,1,0.0,0.0
Bădulescu,www.activenews.ro,0,1,0,1,-1.0,1.0
Cornel Nistorescu,www.activenews.ro,0,0,1,1,0.0,0.0
Dan Ioan Popescu,www.activenews.ro,0,0,1,1,0.0,0.0
Dinu,www.activenews.ro,0,0,1,1,0.0,0.0
Dinu Patriciu,www.activenews.ro,0,0,1,1,0.0,0.0
Doru,www.activenews.ro,0,0,1,1,0.0,0.0
Doru Baduleascu,www.activenews.ro,0,0,1,1,0.0,0.0
Doru Badulescu,www.activenews.ro,0,0,2,2,0.0,0.0
Doru Laurian Bădulescu,www.activenews.ro,0,1,0,1,-1.0,1.0
Haga,www.activenews.ro,0,0,1,1,0.0,0.0
Laurian Badulescu,www.activenews.ro,0,0,1,1,0.0,0.0
Libia,www.activenews.ro,0,0,1,1,0.0,0.0
Nicolae Vidu,www.activenews.ro,0,0,1,1,0.0,0.0
Patriciu,www.activenews.ro,0,0,1,1,0.0,0.0
Petru Buzescu,www.activenews.ro,0,0,2,2,0.0,0.0
Radu,www.activenews.ro,0,0,1,1,0.0,0.0
Raluca Bădulescu,www.activenews.ro,0,0,1,1,0.0,0.0
Socrul,www.activenews.ro,0,0,1,1,0.0,0.0
Stamen Stanchev,www.activenews.ro,0,0,1,1,0.0,0.0
Stamen Stantchev,www.activenews.ro,0,0,1,1,0.0,0.0
Vali Punga,www.activenews.ro,0,0,1,1,0.0,0.0
actionar,www.activenews.ro,0,0,1,1,0.0,0.0
cumnată,www.activenews.ro,0,1,0,1,-1.0,1.0
fotomodel,www.activenews.ro,0,1,0,1,-1.0,1.0
ginere,www.activenews.ro,0,0,1,1,0.0,0.0
interlocutor,www.activenews.ro,0,0,1,1,0.0,0.0
investitor,www.activenews.ro,0,0,1,1,0.0,0.0
Donciu,www.activenews.ro,0,1,0,1,-1.0,1.0
tip,www.activenews.ro,0,0,1,1,0.0,0.0
Dumbrăvița,www.g4media.ro,0,0,1,1,0.0,0.0
Lugoj,www.g4media.ro,0,0,1,1,0.0,0.0
Molnar,www.g4media.ro,0,0,1,1,0.0,0.0
Molnar Andrei,www.g4media.ro,0,0,2,2,0.0,0.0
Molnar Zsolt,www.g4media.ro,0,0,1,1,0.0,0.0
Moșnița Nouă,www.g4media.ro,0,0,1,1,0.0,0.0
Otelec,www.g4media.ro,0,0,1,1,0.0,0.0
Tormac,www.g4media.ro,0,0,1,1,0.0,0.0
Alina Tănăsescu,recorder.ro,0,0,2,2,0.0,0.0
Constantin Nicolescu,recorder.ro,0,1,0,1,-1.0,1.0
Neculai Bereanu,recorder.ro,0,0,1,1,0.0,0.0
Pavel Marian,recorder.ro,0,0,1,1,0.0,0.0
Simona Bucura Oprescu,recorder.ro,0,1,0,1,-1.0,1.0
Bacalbașa,observatornews.ro,0,0,1,1,0.0,0.0
Nicolae Bacalbașa,observatornews.ro,0,1,2,3,-0.3333333333333333,0.3333333333333333
admirator,adevarul.ro,1,0,0,1,1.0,1.0
Kosovo,a1.ro,0,1,0,1,-1.0,1.0
László Tőkés,a1.ro,0,0,1,1,0.0,0.0
Toro Tibor,a1.ro,0,0,1,1,0.0,0.0
Tibor Toro,a1.ro,0,0,1,1,0.0,0.0
Tusnad,a1.ro,0,0,1,1,0.0,0.0
Tokes Laszlo,a1.ro,0,1,0,1,-1.0,1.0
Călin Popescu Tăriceanu,www.activenews.ro,0,0,1,1,0.0,0.0
Lulea,www.activenews.ro,0,0,1,1,0.0,0.0
inamic,www.activenews.ro,0,1,0,1,-1.0,1.0
pilon,www.activenews.ro,0,1,0,1,-1.0,1.0
Costandache,www.aktual24.ro,0,0,1,1,0.0,0.0
Lulea,www.aktual24.ro,0,0,1,1,0.0,0.0
Marian Oprisan,www.aktual24.ro,0,1,0,1,-1.0,1.0
Oriana Costandache,www.aktual24.ro,0,0,1,1,0.0,0.0
Ticu Costandache,www.aktual24.ro,0,0,1,1,0.0,0.0
Vrancea,www.aktual24.ro,0,0,1,1,0.0,0.0
ginere,www.aktual24.ro,0,0,2,2,0.0,0.0
ideolog,www.aktual24.ro,0,1,0,1,-1.0,1.0
Gabriel Diaconu,www.aktual24.ro,0,0,1,1,0.0,0.0
romancea,www.aktual24.ro,0,2,0,2,-1.0,1.0
Adrian Goldsworthy,recorder.ro,0,0,1,1,0.0,0.0
Christine Tellmann,recorder.ro,0,0,1,1,0.0,0.0
Claudiu Marinel Mureșan,recorder.ro,0,0,1,1,0.0,0.0
Emilie Șercan,recorder.ro,0,0,2,2,0.0,0.0
Hadrian,recorder.ro,0,0,1,1,0.0,0.0
Horațiu Lucian Marin,recorder.ro,0,0,1,1,0.0,0.0
Marius Chivu,recorder.ro,0,0,1,1,0.0,0.0
Nicolae Neagu,recorder.ro,0,0,1,1,0.0,0.0
Roald Dahl,recorder.ro,0,0,1,1,0.0,0.0
Vlad Alexandru Vasiu,recorder.ro,0,0,1,1,0.0,0.0
chior,recorder.ro,0,1,0,1,-1.0,1.0
medieș,recorder.ro,1,0,0,1,1.0,1.0
sibian,recorder.ro,0,0,1,1,0.0,0.0
Radu Moldovan,stirileprotv.ro,0,0,1,1,0.0,0.0
Adrian Coman,www.activenews.ro,0,0,1,1,0.0,0.0
Coman,www.activenews.ro,0,0,1,1,0.0,0.0
Adrian Relu Coman,www.activenews.ro,0,0,1,1,0.0,0.0
solicitant,www.activenews.ro,0,1,0,1,-1.0,1.0
canidat,www.mediafax.ro,0,0,1,1,0.0,0.0
Ciprian,www.romaniatv.net,0,0,1,1,0.0,0.0
Emilia Milutinovici,www.romaniatv.net,0,0,1,1,0.0,0.0
Eugen Milutinovici,www.romaniatv.net,0,0,1,1,0.0,0.0
Gelu Milutinovici,www.romaniatv.net,0,0,1,1,0.0,0.0
Milutinovici,www.romaniatv.net,0,0,1,1,0.0,0.0
Timișoara,www.romaniatv.net,0,0,1,1,0.0,0.0
Dmytro Kuleba,observatornews.ro,0,0,1,1,0.0,0.0
Kuleba,observatornews.ro,0,0,1,1,0.0,0.0
Jean-Yves Le Drian,observatornews.ro,0,0,1,1,0.0,0.0
prim,www.gandul.ro,0,0,1,1,0.0,0.0
latifundiar,www.comisarul.ro,0,1,0,1,-1.0,1.0
Pipera,www.comisarul.ro,0,0,1,1,0.0,0.0
Anamaria Gavrila,a1.ro,0,0,1,1,0.0,0.0
director general,a1.ro,0,0,1,1,0.0,0.0
California,a1.ro,0,0,1,1,0.0,0.0
Carolina de Sud,a1.ro,0,0,1,1,0.0,0.0
Cei,a1.ro,0,1,0,1,-1.0,1.0
Constantin Popescu,a1.ro,0,0,1,1,0.0,0.0
Câmpulung,a1.ro,0,0,1,1,0.0,0.0
Emiratele Arabe Unite,a1.ro,0,0,1,1,0.0,0.0
Familia Antonescu,a1.ro,0,0,1,1,0.0,0.0
Familia Funeriu,a1.ro,0,0,1,1,0.0,0.0
Terheș,a1.ro,0,0,2,2,0.0,0.0
John Banu,a1.ro,0,0,2,2,0.0,0.0
Liechtenstein,a1.ro,0,0,1,1,0.0,0.0
Predeal,a1.ro,0,0,1,1,0.0,0.0
Simion,a1.ro,0,0,1,1,0.0,0.0
Sălaj,a1.ro,0,0,1,1,0.0,0.0
Timiș,a1.ro,0,0,1,1,0.0,0.0
Turcia,a1.ro,0,0,1,1,0.0,0.0
Vâlcea,a1.ro,0,0,1,1,0.0,0.0
acționar,a1.ro,0,0,1,1,0.0,0.0
Predoiu,a1.ro,0,0,1,1,0.0,0.0
personaj politic,a1.ro,0,1,0,1,-1.0,1.0
pretendent,a1.ro,0,1,0,1,-1.0,1.0
reprezentantă,a1.ro,0,0,1,1,0.0,0.0
Andrei Țărnea,www.b1tv.ro,0,0,1,1,0.0,0.0
Elon Musk,www.b1tv.ro,0,0,3,3,0.0,0.0
Musk,www.b1tv.ro,0,0,1,1,0.0,0.0
țăran,www.b1tv.ro,0,0,1,1,0.0,0.0
Călărași,www.digi24.ro,0,0,1,1,0.0,0.0
Iacomi,www.digi24.ro,0,0,1,1,0.0,0.0
Iulian Iacomi,www.digi24.ro,0,0,2,2,0.0,0.0
călărăș,www.digi24.ro,1,0,1,2,0.5,0.5
Vasile Iliuță,www.digi24.ro,1,0,1,2,0.5,0.5
Hellvid,stirileprotv.ro,0,1,0,1,-1.0,1.0
Hellvig,stirileprotv.ro,0,0,1,1,0.0,0.0
bucureștean,www.cotidianul.ro,0,1,0,1,-1.0,1.0
Adrian Iovan,www.news.ro,0,1,1,2,-0.5,0.5
Aura Ion,www.news.ro,0,1,0,1,-1.0,1.0
Romanița Iovan,www.news.ro,0,0,1,1,0.0,0.0
creatoare,www.news.ro,0,0,1,1,0.0,0.0
Radu Stroe,www.news.ro,0,0,1,1,0.0,0.0
studentă,www.news.ro,0,1,0,1,-1.0,1.0
Andrei Roman,www.antena3.ro,0,0,1,1,0.0,0.0
Ana Ciceală,www.digi24.ro,0,0,1,1,0.0,0.0
Marius Gheorghe,www.digi24.ro,0,0,1,1,0.0,0.0
Nicu Ștefănuță,www.digi24.ro,0,0,1,1,0.0,0.0
Tudor Benga,www.digi24.ro,0,0,1,1,0.0,0.0
senatorul Cristi Ghica,www.digi24.ro,0,0,1,1,0.0,0.0
Claudiu Târziu,www.realitatea.net,0,0,1,1,0.0,0.0
Marian Neacșu,www.digi24.ro,0,0,1,1,0.0,0.0
Diana Buzoianu,www.antena3.ro,0,0,2,2,0.0,0.0
Irineu Darău,www.antena3.ro,0,1,0,1,-1.0,1.0
secretariat general,www.antena3.ro,0,0,1,1,0.0,0.0
America,stirileprotv.ro,1,0,0,1,1.0,1.0
David Hale,stirileprotv.ro,0,0,1,1,0.0,0.0
George Maior,stirileprotv.ro,0,0,1,1,0.0,0.0
Meleșcanu,stirileprotv.ro,0,0,1,1,0.0,0.0
Mike Pompeo,stirileprotv.ro,0,0,1,1,0.0,0.0
Philip Reeker,stirileprotv.ro,0,0,1,1,0.0,0.0
Pompeo,stirileprotv.ro,0,0,1,1,0.0,0.0
Statele,stirileprotv.ro,1,0,0,1,1.0,1.0
Washington,stirileprotv.ro,0,0,1,1,0.0,0.0
Toader,www.news.ro,0,0,1,1,0.0,0.0
corespondent,www.gandul.ro,0,0,1,1,0.0,0.0
Karnitschnig,www.gandul.ro,0,1,0,1,-1.0,1.0
Matthew Karnitschnig,www.gandul.ro,0,0,2,2,0.0,0.0
prezentator,www.gandul.ro,0,0,1,1,0.0,0.0
ÖVP,www.gandul.ro,0,1,0,1,-1.0,1.0
domn,a1.ro,0,1,0,1,-1.0,1.0
doamna Lasconi,a1.ro,0,0,1,1,0.0,0.0
învingător,a1.ro,0,0,1,1,0.0,0.0
Dâmbovița,www.activenews.ro,0,0,1,1,0.0,0.0
Profesioniști,www.activenews.ro,1,0,0,1,1.0,1.0
Y,www.activenews.ro,0,1,0,1,-1.0,1.0
filantrop,www.activenews.ro,0,0,1,1,0.0,0.0
eu,www.activenews.ro,0,1,0,1,-1.0,1.0
iubitor,www.activenews.ro,0,1,0,1,-1.0,1.0
l,www.activenews.ro,1,0,0,1,1.0,1.0
pedestru,www.activenews.ro,0,1,0,1,-1.0,1.0
personalitate,www.activenews.ro,0,0,1,1,0.0,0.0
profesionist,www.activenews.ro,1,0,0,1,1.0,1.0
cântăreață,www.gandul.ro,1,0,0,1,1.0,1.0
Dick Cheney,www.gandul.ro,0,1,0,1,-1.0,1.0
JD Vance,www.gandul.ro,0,2,0,2,-1.0,1.0
Swift,www.gandul.ro,0,0,1,1,0.0,0.0
Taylor Swift,www.gandul.ro,0,0,1,1,0.0,0.0
Tim Walz,www.gandul.ro,0,0,1,1,0.0,0.0
artist,www.gandul.ro,0,0,1,1,0.0,0.0
vedetă,www.gandul.ro,0,1,0,1,-1.0,1.0
vedet,www.gandul.ro,0,1,1,2,-0.5,0.5
Alexandru Manda,pressone.ro,0,0,1,1,0.0,0.0
Alexandru Muraru,pressone.ro,0,1,2,3,-0.3333333333333333,0.3333333333333333
Ana Predescu,pressone.ro,0,0,1,1,0.0,0.0
Ariana,pressone.ro,0,0,1,1,0.0,0.0
Dan Jurcan,pressone.ro,0,0,1,1,0.0,0.0
Lavinia Niță,pressone.ro,0,0,1,1,0.0,0.0
Marin Preda,pressone.ro,0,0,1,1,0.0,0.0
Mălina Gîndu Lavinia Niță,pressone.ro,0,0,1,1,0.0,0.0
NE,pressone.ro,0,0,1,1,0.0,0.0
Oana Țoiu,pressone.ro,0,0,1,1,0.0,0.0
Ramona Strugariu,pressone.ro,0,0,1,1,0.0,0.0
Andrei Gerea,www.mediafax.ro,0,0,2,2,0.0,0.0
Călin Popescu Tariceanu,www.mediafax.ro,0,1,0,1,-1.0,1.0
Dansul,www.mediafax.ro,0,0,1,1,0.0,0.0
cântăreț,www.mediafax.ro,0,1,0,1,-1.0,1.0
Grindeanu,www.mediafax.ro,0,1,0,1,-1.0,1.0
papă,www.activenews.ro,0,0,2,2,0.0,0.0
Sfântul Apostol,www.activenews.ro,0,0,1,1,0.0,0.0
Sfântul Petru,www.activenews.ro,1,0,0,1,1.0,1.0
Suveranul Pontif,www.activenews.ro,0,0,1,1,0.0,0.0
Vatican,www.activenews.ro,0,0,1,1,0.0,0.0
Papa Leon al X-lea,www.activenews.ro,0,0,1,1,0.0,0.0
Alexandru Sandulescu,a1.ro,0,0,1,1,0.0,0.0
Cehia,a1.ro,0,0,1,1,0.0,0.0
Cogealac,a1.ro,0,0,1,1,0.0,0.0
Cati Hristu,a1.ro,0,0,1,1,0.0,0.0
Levi Elekes,recorder.ro,0,0,1,1,0.0,0.0
Aleș,stirileprotv.ro,0,1,0,1,-1.0,1.0
datornic,www.gandul.ro,0,1,0,1,-1.0,1.0
Adrian,www.euronews.ro,0,0,1,1,0.0,0.0
Iliescu,www.euronews.ro,0,0,1,1,0.0,0.0
precedent,www.euronews.ro,0,1,0,1,-1.0,1.0
Alfred Laurentiu Mihai,adevarul.ro,0,0,1,1,0.0,0.0
Dominic,adevarul.ro,1,0,0,1,1.0,1.0
consilieră,adevarul.ro,0,0,1,1,0.0,0.0
nemuritor,adevarul.ro,0,1,0,1,-1.0,1.0
Hellvig,www.news.ro,0,0,1,1,0.0,0.0
Cătălin Cătoiu,a1.ro,0,0,1,1,0.0,0.0
Catoiu,a1.ro,0,0,1,1,0.0,0.0
bugetar,a1.ro,0,1,0,1,-1.0,1.0
cameraman,a1.ro,0,0,1,1,0.0,0.0
corupt,a1.ro,0,1,0,1,-1.0,1.0
Mihai Ungureanu,a1.ro,0,0,1,1,0.0,0.0
Nicola Procaccini,www.romaniatv.net,0,0,1,1,0.0,0.0
Procaccini,www.romaniatv.net,0,0,1,1,0.0,0.0
fan,www.news.ro,0,1,1,2,-0.5,0.5
Dumitru Dumitriu,www.comisarul.ro,0,1,0,1,-1.0,1.0
Filoti,www.comisarul.ro,0,0,1,1,0.0,0.0
Gică Popescu,www.comisarul.ro,0,1,0,1,-1.0,1.0
Ion Vlădoiu,www.comisarul.ro,0,0,1,1,0.0,0.0
Jean Vlădoiu,www.comisarul.ro,0,0,1,1,0.0,0.0
Jose Batista,www.comisarul.ro,0,1,0,1,-1.0,1.0
Radu Niculescu,www.comisarul.ro,0,1,0,1,-1.0,1.0
Scoția,www.comisarul.ro,0,0,1,1,0.0,0.0
Uruguay,www.comisarul.ro,0,0,1,1,0.0,0.0
Vlădoiu,www.comisarul.ro,0,0,1,1,0.0,0.0
atacant,www.comisarul.ro,0,1,0,1,-1.0,1.0
Dan Filoti,www.comisarul.ro,0,0,1,1,0.0,0.0
mustăcios,www.comisarul.ro,0,1,0,1,-1.0,1.0
Nigeria,www.realitatea.net,0,1,0,1,-1.0,1.0
Mihai Constantin,primanews.ro,0,0,1,1,0.0,0.0
Asztalos,www.mediafax.ro,0,0,1,1,0.0,0.0
Asztalos Csaba,www.mediafax.ro,1,0,0,1,1.0,1.0
Csaba Asztalos,www.mediafax.ro,0,0,1,1,0.0,0.0
Dan Diaconescu,www.mediafax.ro,0,0,2,2,0.0,0.0
sector,www.mediafax.ro,0,0,1,1,0.0,0.0
agresor,www.mediafax.ro,0,1,0,1,-1.0,1.0
Mircea Dinescu,www.news.ro,0,0,1,1,0.0,0.0
Alin Stoica,stirileprotv.ro,0,0,1,1,0.0,0.0
Corina Atanasiu,stirileprotv.ro,0,0,1,1,0.0,0.0
George Cățean,stirileprotv.ro,0,0,1,1,0.0,0.0
Iulia Popovici,stirileprotv.ro,0,0,1,1,0.0,0.0
Mihai Goțiu,stirileprotv.ro,0,0,1,1,0.0,0.0
Monica Berescu,stirileprotv.ro,0,0,1,1,0.0,0.0
Nicu Fălcoi,stirileprotv.ro,0,0,1,1,0.0,0.0
Oana Țoiu,stirileprotv.ro,0,0,1,1,0.0,0.0
politică,stirileprotv.ro,0,1,0,1,-1.0,1.0
Tudor Pop Dacian Cioloș,stirileprotv.ro,0,0,1,1,0.0,0.0
Dmitri Medvedev,www.euronews.ro,0,1,0,1,-1.0,1.0
Federația Rusă,www.euronews.ro,0,1,0,1,-1.0,1.0
Madeira,www.euronews.ro,0,0,1,1,0.0,0.0
Medvedev,www.euronews.ro,0,1,0,1,-1.0,1.0
nerezident,www.euronews.ro,0,0,1,1,0.0,0.0
Alexia Iris,www.antena3.ro,0,0,1,1,0.0,0.0
Andrei Filip,www.antena3.ro,0,0,1,1,0.0,0.0
asociat,www.antena3.ro,0,0,1,1,0.0,0.0
Chestor,www.antena3.ro,0,0,1,1,0.0,0.0
Cornel Pitiș,www.antena3.ro,0,0,1,1,0.0,0.0
Dumitru Dobrică,www.antena3.ro,0,1,0,1,-1.0,1.0
Hayssam,www.antena3.ro,0,0,1,1,0.0,0.0
Ion Vasile,www.antena3.ro,0,0,2,2,0.0,0.0
Omar Hayssam,www.antena3.ro,0,1,0,1,-1.0,1.0
prefect,www.antena3.ro,0,0,2,2,0.0,0.0
Regatul Belgiei,www.antena3.ro,0,0,1,1,0.0,0.0
Regatul Unit al Marii Britanii și Irlandei de Nord,www.antena3.ro,0,0,1,1,0.0,0.0
Zambia,www.antena3.ro,0,0,1,1,0.0,0.0
Roxana,www.antena3.ro,0,0,1,1,0.0,0.0
Roxana Ciolacu,www.antena3.ro,0,0,1,1,0.0,0.0
Spania,www.antena3.ro,0,0,1,1,0.0,0.0
Cezar Preda,www.antena3.ro,0,0,1,1,0.0,0.0
mir,www.antena3.ro,0,0,1,1,0.0,0.0
sef,www.aktual24.ro,0,1,0,1,-1.0,1.0
Antonel Tănase,pressone.ro,0,1,0,1,-1.0,1.0
Caracotă,pressone.ro,0,1,0,1,-1.0,1.0
cascador,pressone.ro,0,2,0,2,-1.0,1.0
Chiuariu,pressone.ro,0,1,0,1,-1.0,1.0
Ciumacenco,pressone.ro,0,0,1,1,0.0,0.0
Doris Gabriela Moldovan,pressone.ro,0,0,1,1,0.0,0.0
Doris Moldovan,pressone.ro,0,0,1,1,0.0,0.0
Eugen Pîrvulescu,pressone.ro,0,0,2,2,0.0,0.0
Fane,pressone.ro,0,0,1,1,0.0,0.0
Fătu,pressone.ro,0,0,1,1,0.0,0.0
Giugea,pressone.ro,0,1,0,1,-1.0,1.0
Iancu Caracotă,pressone.ro,0,1,0,1,-1.0,1.0
Nagy Zsolt,pressone.ro,0,0,1,1,0.0,0.0
Nicușor Ciumacenco,pressone.ro,0,0,2,2,0.0,0.0
Nițulescu,pressone.ro,0,0,1,1,0.0,0.0
Ovidiu Silaghi,pressone.ro,0,0,1,1,0.0,0.0
Nicolae Giugea,pressone.ro,0,0,1,1,0.0,0.0
Protejata,pressone.ro,0,0,1,1,0.0,0.0
Relu Fenechiu,pressone.ro,0,0,1,1,0.0,0.0
Scântei,pressone.ro,0,1,0,1,-1.0,1.0
Teodor Nițulescu,pressone.ro,0,1,0,1,-1.0,1.0
Tudor Chiuariu,pressone.ro,0,1,0,1,-1.0,1.0
ambii,pressone.ro,0,0,1,1,0.0,0.0
cel Mare,pressone.ro,0,0,1,1,0.0,0.0
Radu Berceanu,pressone.ro,0,0,1,1,0.0,0.0
sinistrat,pressone.ro,0,1,0,1,-1.0,1.0
Adrian Gâdea,www.g4media.ro,0,0,1,1,0.0,0.0
Alexandria,www.g4media.ro,0,0,1,1,0.0,0.0
Ciprian Ionuț Ciuperceanu,www.g4media.ro,0,0,1,1,0.0,0.0
Cătălin Ionuț Gîlcă,www.g4media.ro,0,0,1,1,0.0,0.0
Iuliana Vișan,www.g4media.ro,0,0,1,1,0.0,0.0
Zimnicea,www.g4media.ro,0,0,1,1,0.0,0.0
Aleksandr Formin,primanews.ro,0,0,1,1,0.0,0.0
Andrii Sîbiga,primanews.ro,0,0,1,1,0.0,0.0
Mihail Galuzin,primanews.ro,0,0,1,1,0.0,0.0
adjunct,primanews.ro,0,0,1,1,0.0,0.0
Lia,www.luju.ro,0,1,0,1,-1.0,1.0
Pirlog,www.luju.ro,0,1,0,1,-1.0,1.0
cowboy,www.luju.ro,0,0,1,1,0.0,0.0
pistol,www.luju.ro,0,1,0,1,-1.0,1.0
pistolari,www.luju.ro,0,1,0,1,-1.0,1.0
Bogdan Pirlog,www.luju.ro,0,1,0,1,-1.0,1.0
Sorin Lia,www.luju.ro,0,1,0,1,-1.0,1.0
Scrasnila Voda,www.luju.ro,0,1,0,1,-1.0,1.0
Razvan Ionescu,www.luju.ro,0,1,0,1,-1.0,1.0
inca,www.luju.ro,0,1,0,1,-1.0,1.0
mamă,www.luju.ro,0,0,1,1,0.0,0.0
premiu,www.luju.ro,0,0,1,1,0.0,0.0
Beijing,www.g4media.ro,0,0,1,1,0.0,0.0
Belgrad,www.g4media.ro,0,0,1,1,0.0,0.0
Caragiale,www.g4media.ro,0,1,1,2,-0.5,0.5
Ioanid,www.g4media.ro,0,1,0,1,-1.0,1.0
Nicolae Grigorescu,www.g4media.ro,0,0,1,1,0.0,0.0
Pretoria,www.g4media.ro,0,0,1,1,0.0,0.0
Riyadh,www.g4media.ro,0,0,1,1,0.0,0.0
numiț,www.g4media.ro,0,1,0,1,-1.0,1.0
stăpân,www.g4media.ro,0,1,0,1,-1.0,1.0
taliban,www.g4media.ro,0,1,0,1,-1.0,1.0
trimis,www.g4media.ro,0,1,0,1,-1.0,1.0
Beliș,www.antena3.ro,0,0,1,1,0.0,0.0
Adrian Wiener,recorder.ro,0,0,1,1,0.0,0.0
"Daniel David, Ștefania Patricia Dinga",recorder.ro,0,0,1,1,0.0,0.0
Dino Buzzati,recorder.ro,0,0,1,1,0.0,0.0
Eusebiu,recorder.ro,0,0,1,1,0.0,0.0
Ioan Cristina,recorder.ro,0,0,1,1,0.0,0.0
Lazăr Faur,recorder.ro,0,0,1,1,0.0,0.0
Mihai Fifor,recorder.ro,0,1,0,1,-1.0,1.0
Mihai Pașca,recorder.ro,0,0,1,1,0.0,0.0
Oanei Pellea,recorder.ro,0,0,1,1,0.0,0.0
Petriș,recorder.ro,0,0,1,1,0.0,0.0
Petru Farago,recorder.ro,0,0,1,1,0.0,0.0
Sergiu Bîlcea,recorder.ro,0,0,1,1,0.0,0.0
Steve Jobs,recorder.ro,0,0,1,1,0.0,0.0
birocrat,recorder.ro,0,1,0,1,-1.0,1.0
idiot,recorder.ro,0,1,0,1,-1.0,1.0
Constantin Titian Filip,adevarul.ro,0,0,1,1,0.0,0.0
Gelu Drăgan,adevarul.ro,0,0,1,1,0.0,0.0
Budapesta,recorder.ro,0,0,1,1,0.0,0.0
papă,recorder.ro,0,0,1,1,0.0,0.0
Spioni,recorder.ro,0,1,0,1,-1.0,1.0
Administrația Biden,www.antena3.ro,0,0,1,1,0.0,0.0
Bușoi,www.antena3.ro,0,1,0,1,-1.0,1.0
Cristian Bușoi,www.antena3.ro,0,0,1,1,0.0,0.0
Rutte,www.antena3.ro,0,1,1,2,-0.5,0.5
Alba Iulia,www.activenews.ro,0,0,2,2,0.0,0.0
Benke,www.activenews.ro,0,1,1,2,-0.5,0.5
Cărbunaru,www.activenews.ro,0,1,0,1,-1.0,1.0
Enache,www.activenews.ro,0,0,1,1,0.0,0.0
Horea și Cloșca,www.activenews.ro,0,0,1,1,0.0,0.0
Pricopie,www.activenews.ro,0,1,0,1,-1.0,1.0
torționar,www.activenews.ro,0,1,0,1,-1.0,1.0
antiromân,www.activenews.ro,0,1,0,1,-1.0,1.0
camaraz,www.activenews.ro,0,1,0,1,-1.0,1.0
cioban,www.activenews.ro,1,0,0,1,1.0,1.0
cârtiță,www.activenews.ro,0,1,0,1,-1.0,1.0
decident,www.activenews.ro,0,1,0,1,-1.0,1.0
executant,www.activenews.ro,0,1,0,1,-1.0,1.0
idezirabil,www.activenews.ro,0,1,0,1,-1.0,1.0
informat,www.activenews.ro,0,1,0,1,-1.0,1.0
iobag,www.activenews.ro,0,1,0,1,-1.0,1.0
legionar,www.activenews.ro,0,1,0,1,-1.0,1.0
mafiot,www.activenews.ro,0,1,0,1,-1.0,1.0
nemernic,www.activenews.ro,0,1,0,1,-1.0,1.0
pietricean,www.activenews.ro,0,0,1,1,0.0,0.0
strămoș,www.activenews.ro,1,0,0,1,1.0,1.0
vecin,www.activenews.ro,0,1,0,1,-1.0,1.0
vânzător,www.activenews.ro,0,1,0,1,-1.0,1.0
Drulă,www.b1tv.ro,0,0,1,1,0.0,0.0
Mădălina Turza,recorder.ro,0,0,1,1,0.0,0.0
beneficiar,a1.ro,0,0,1,1,0.0,0.0
Corneliu Ciontu,a1.ro,0,0,1,1,0.0,0.0
informat,a1.ro,0,1,0,1,-1.0,1.0
sustinator,a1.ro,0,0,1,1,0.0,0.0
Berca,stirileprotv.ro,0,0,1,1,0.0,0.0
Dumbravă,pressone.ro,0,2,1,3,-0.6666666666666666,0.6666666666666666
Loredana Radu,pressone.ro,0,0,2,2,0.0,0.0
Romeo Raicu,pressone.ro,0,0,1,1,0.0,0.0
Stănișoară,pressone.ro,0,1,0,1,-1.0,1.0
nepoată,pressone.ro,0,0,1,1,0.0,0.0
Adrian Ivan,pressone.ro,0,0,2,2,0.0,0.0
Zmeu,www.antena3.ro,0,1,0,1,-1.0,1.0
premiu,www.antena3.ro,0,1,0,1,-1.0,1.0
slugă,www.antena3.ro,0,1,0,1,-1.0,1.0
stăpân,www.antena3.ro,0,2,0,2,-1.0,1.0
Sandomierz,www.aktual24.ro,0,0,1,1,0.0,0.0
Slawomir Menzen,www.aktual24.ro,0,0,1,1,0.0,0.0
Trszkowski,www.aktual24.ro,0,1,0,1,-1.0,1.0
Trzaskowski,www.aktual24.ro,0,0,1,1,0.0,0.0
Claudia Boghicevici,www.digi24.ro,0,0,1,1,0.0,0.0
Cristian Bodea,www.digi24.ro,0,0,1,1,0.0,0.0
Cristina Pocora,www.digi24.ro,0,0,1,1,0.0,0.0
Eforie Sud,www.digi24.ro,0,0,1,1,0.0,0.0
Etiopia,www.digi24.ro,1,0,0,1,1.0,1.0
Fethiye,www.digi24.ro,0,0,1,1,0.0,0.0
Grecia,www.digi24.ro,0,0,2,2,0.0,0.0
Istanbul,www.digi24.ro,0,0,1,1,0.0,0.0
Mahmudia,www.digi24.ro,0,0,1,1,0.0,0.0
Moneasa,www.digi24.ro,0,0,1,1,0.0,0.0
pacient,stirileprotv.ro,0,0,1,1,0.0,0.0
Ana Birchall,primanews.ro,0,0,2,2,0.0,0.0
Florin Iordache,primanews.ro,0,1,0,1,-1.0,1.0
New York,primanews.ro,0,0,1,1,0.0,0.0
Vaslui,primanews.ro,0,0,1,1,0.0,0.0
consilieră,primanews.ro,0,0,1,1,0.0,0.0
Adina Florea,primanews.ro,0,1,0,1,-1.0,1.0
Tudorel Toader,primanews.ro,0,1,0,1,-1.0,1.0
AR,www.activenews.ro,0,1,0,1,-1.0,1.0
Adrian Nap,www.activenews.ro,0,1,0,1,-1.0,1.0
Alexandru Cordoș,www.activenews.ro,0,0,1,1,0.0,0.0
Avram Iancu,www.activenews.ro,0,1,0,1,-1.0,1.0
Cordoș,www.activenews.ro,0,0,1,1,0.0,0.0
Cristian Matei,www.activenews.ro,0,1,0,1,-1.0,1.0
Câmpia Turzii,www.activenews.ro,0,0,1,1,0.0,0.0
Dorin Lojigan,www.activenews.ro,0,0,2,2,0.0,0.0
Iancu,www.activenews.ro,0,1,1,2,-0.5,0.5
Marisel,www.activenews.ro,0,0,1,1,0.0,0.0
Ioan Rațiu,www.activenews.ro,0,2,0,2,-1.0,1.0
Cristian Octavian Matei,www.activenews.ro,0,1,0,1,-1.0,1.0
Sorin Săveanu,www.activenews.ro,0,2,0,2,-1.0,1.0
Tiberiu Groza,www.activenews.ro,0,1,0,1,-1.0,1.0
Turda,www.activenews.ro,0,1,0,1,-1.0,1.0
Turz,www.activenews.ro,0,1,0,1,-1.0,1.0
Virgil Blasiu,www.activenews.ro,0,1,0,1,-1.0,1.0
arhitect,www.activenews.ro,0,1,0,1,-1.0,1.0
moț,www.activenews.ro,0,0,1,1,0.0,0.0
predecesor,www.activenews.ro,0,1,0,1,-1.0,1.0
Ștefănie,www.activenews.ro,0,1,0,1,-1.0,1.0
Răzvan Ciortea,www.activenews.ro,0,0,1,1,0.0,0.0
Cotroceni,www.g4media.ro,0,0,2,2,0.0,0.0
Geoană,www.g4media.ro,0,0,1,1,0.0,0.0
Cristi Andrei,www.g4media.ro,0,1,0,1,-1.0,1.0
pesediști,www.g4media.ro,0,1,0,1,-1.0,1.0
pescar,www.g4media.ro,0,1,0,1,-1.0,1.0
Emmanuel Macron,www.b1tv.ro,0,0,2,2,0.0,0.0
Ionel Bogdan,www.b1tv.ro,0,0,1,1,0.0,0.0
Alexandru Cordoș,recorder.ro,0,0,1,1,0.0,0.0
director general,recorder.ro,0,0,1,1,0.0,0.0
Clujan,recorder.ro,0,0,1,1,0.0,0.0
Cosmin Costaș,recorder.ro,0,0,1,1,0.0,0.0
Cristian Bordei,recorder.ro,0,0,1,1,0.0,0.0
Cristina Burciu,recorder.ro,0,0,1,1,0.0,0.0
Csoma Botond,recorder.ro,0,0,1,1,0.0,0.0
Estonia,recorder.ro,0,0,1,1,0.0,0.0
Huedin,recorder.ro,0,0,1,1,0.0,0.0
Ioan Sabin Sărmaș,recorder.ro,0,0,1,1,0.0,0.0
Jane Austen,recorder.ro,0,0,1,1,0.0,0.0
László Attila,recorder.ro,0,0,1,1,0.0,0.0
Michael Wolff,recorder.ro,0,0,2,2,0.0,0.0
Mircea Minea,recorder.ro,0,0,1,1,0.0,0.0
Mircea Moroșan,recorder.ro,0,0,1,1,0.0,0.0
Mona Muscă,recorder.ro,0,0,1,1,0.0,0.0
Nicolae Steinhardt,recorder.ro,0,0,1,1,0.0,0.0
Năstase,recorder.ro,0,0,1,1,0.0,0.0
Oana Murariu,recorder.ro,0,0,1,1,0.0,0.0
Ovidiu Câmpean,recorder.ro,0,0,1,1,0.0,0.0
Radu Moisin,recorder.ro,0,0,1,1,0.0,0.0
Raymond Boudon,recorder.ro,0,0,1,1,0.0,0.0
Remus Lăpușan,recorder.ro,0,0,1,1,0.0,0.0
Sorin Moldovan,recorder.ro,0,0,1,1,0.0,0.0
alpinist,recorder.ro,0,0,1,1,0.0,0.0
Pârvulescu,recorder.ro,0,0,1,1,0.0,0.0
infectat,recorder.ro,0,1,0,1,-1.0,1.0
pediatru,recorder.ro,0,0,1,1,0.0,0.0
pelerin,recorder.ro,0,1,0,1,-1.0,1.0
Dumitrescu,recorder.ro,0,0,1,1,0.0,0.0
Ionescu,recorder.ro,0,0,1,1,0.0,0.0
ministrul Boloș,primanews.ro,0,0,1,1,0.0,0.0
Camil,www.g4media.ro,0,0,1,1,0.0,0.0
Ionuț Vulpescu,www.g4media.ro,0,0,1,1,0.0,0.0
Nichita Stănescu,www.g4media.ro,0,0,1,1,0.0,0.0
Robert Schuman,www.g4media.ro,0,0,1,1,0.0,0.0
Schuman,www.g4media.ro,0,0,1,1,0.0,0.0
Ioan Aurel Pop,www.g4media.ro,0,0,1,1,0.0,0.0
rector,www.g4media.ro,0,0,3,3,0.0,0.0
Aurel Bălășoiu,primanews.ro,0,2,0,2,-1.0,1.0
politică,primanews.ro,0,1,0,1,-1.0,1.0
Soacra,primanews.ro,0,1,0,1,-1.0,1.0
vecin,primanews.ro,0,1,0,1,-1.0,1.0
băiat,primanews.ro,0,0,2,2,0.0,0.0
ginere,primanews.ro,0,1,0,1,-1.0,1.0
minor,primanews.ro,0,1,0,1,-1.0,1.0
Alberto Fujimori,www.mediafax.ro,0,1,0,1,-1.0,1.0
Chile,www.mediafax.ro,0,0,1,1,0.0,0.0
Fujimori,www.mediafax.ro,0,1,0,1,-1.0,1.0
Japonia,www.mediafax.ro,0,0,1,1,0.0,0.0
Keiko,www.mediafax.ro,0,0,1,1,0.0,0.0
Keiko Fujimori,www.mediafax.ro,0,0,1,1,0.0,0.0
Peru,www.mediafax.ro,0,0,1,1,0.0,0.0
fiică,www.mediafax.ro,0,0,1,1,0.0,0.0
Chelariu,www.news.ro,0,1,0,1,-1.0,1.0
Constanța,www.news.ro,0,1,1,2,-0.5,0.5
Ermil Chelariu,www.news.ro,0,0,1,1,0.0,0.0
Lupu,www.news.ro,0,1,0,1,-1.0,1.0
Mangalia,www.news.ro,0,0,1,1,0.0,0.0
Mihai Lupu,www.news.ro,0,2,0,2,-1.0,1.0
Năvodari,www.news.ro,0,0,1,1,0.0,0.0
Adomniței,www.mediafax.ro,0,1,0,1,-1.0,1.0
Iulian Iancu,www.mediafax.ro,0,0,1,1,0.0,0.0
Ivan,observatornews.ro,0,0,1,1,0.0,0.0
Rubio,observatornews.ro,0,0,1,1,0.0,0.0
Chirilă,www.comisarul.ro,1,0,0,1,1.0,1.0
Montană,www.comisarul.ro,0,0,1,1,0.0,0.0
Tudor Chirilă,www.comisarul.ro,1,0,0,1,1.0,1.0
solist,www.comisarul.ro,0,0,1,1,0.0,0.0
Kosovo,www.realitatea.net,0,0,1,1,0.0,0.0
fotbalist,www.realitatea.net,0,0,1,1,0.0,0.0
jucător,www.realitatea.net,0,0,1,1,0.0,0.0
Albin Kurti,www.realitatea.net,0,0,1,1,0.0,0.0
Iulian Lorincz,www.comisarul.ro,0,0,1,1,0.0,0.0
Vlad Petreanu,www.comisarul.ro,0,0,4,4,0.0,0.0
Natalia-Elena Intotero,www.euronews.ro,0,0,1,1,0.0,0.0
institutor,www.euronews.ro,0,0,1,1,0.0,0.0
vicelider,www.euronews.ro,0,1,1,2,-0.5,0.5
Gigel Știrbu,www.comisarul.ro,0,0,1,1,0.0,0.0
Dacian Cioloș,www.news.ro,0,0,1,1,0.0,0.0
Gabriel Oprea,www.news.ro,0,2,0,2,-1.0,1.0
Ungureanu,www.news.ro,0,1,0,1,-1.0,1.0
acar,www.news.ro,0,1,0,1,-1.0,1.0
Jackson Lee,www.realitatea.net,0,0,1,1,0.0,0.0
Sheila Jackson Lee,www.realitatea.net,1,0,0,1,1.0,1.0
Texas,www.realitatea.net,0,0,1,1,0.0,0.0
Vietnam,www.realitatea.net,0,0,1,1,0.0,0.0
Dansul,pressone.ro,0,0,1,1,0.0,0.0
Gabriel Andronache,pressone.ro,0,0,1,1,0.0,0.0
Ionuț Moșteanu,pressone.ro,0,0,1,1,0.0,0.0
Moșteanu,pressone.ro,0,0,1,1,0.0,0.0
dascăl,pressone.ro,0,0,1,1,0.0,0.0
Bădulescu,pressone.ro,0,0,1,1,0.0,0.0
Cseke,pressone.ro,0,0,1,1,0.0,0.0
Attila Cseke,pressone.ro,0,0,1,1,0.0,0.0
Dorin Bădulescu,pressone.ro,0,0,2,2,0.0,0.0
Leș,pressone.ro,0,0,1,1,0.0,0.0
Nicoleta Pauliuc,pressone.ro,0,0,2,2,0.0,0.0
Marinela Brumar,agerpres.ro,0,0,1,1,0.0,0.0
neam,agerpres.ro,1,0,0,1,1.0,1.0
Luiz Muntenegru,www.aktual24.ro,0,0,1,1,0.0,0.0
Muntenegru,www.aktual24.ro,0,1,0,1,-1.0,1.0
Pedro Nuno Santos,www.aktual24.ro,0,0,1,1,0.0,0.0
Cătălin Cherecheș,www.aktual24.ro,0,1,0,1,-1.0,1.0
Henri Coandă,www.aktual24.ro,0,0,1,1,0.0,0.0
Puscas,www.aktual24.ro,0,0,1,1,0.0,0.0
Vasile Puscas,www.aktual24.ro,0,0,1,1,0.0,0.0
afacerist,www.aktual24.ro,0,1,0,1,-1.0,1.0
Cătălin Tolontan,www.aktual24.ro,0,0,1,1,0.0,0.0
pieton,www.aktual24.ro,0,0,1,1,0.0,0.0
Donald Trump Jr,www.news.ro,0,0,1,1,0.0,0.0
Tbilisi,recorder.ro,0,1,0,1,-1.0,1.0
perdanț,recorder.ro,0,1,0,1,-1.0,1.0
Michel Barnier,recorder.ro,0,1,0,1,-1.0,1.0
Bogdan Ciucă,www.g4media.ro,0,0,1,1,0.0,0.0
Bogdan Ion Jelea,www.g4media.ro,0,0,1,1,0.0,0.0
Cristian Barbu,www.g4media.ro,0,0,1,1,0.0,0.0
Daniel Ionașcu,www.g4media.ro,0,0,1,1,0.0,0.0
Eugenia Șerban,www.g4media.ro,0,0,1,1,0.0,0.0
Ionel Gae,www.g4media.ro,0,0,1,1,0.0,0.0
Lia Ardelean,www.g4media.ro,0,0,1,1,0.0,0.0
Liviu Pop,www.g4media.ro,0,0,1,1,0.0,0.0
Mugur Ciuvică,www.g4media.ro,0,0,1,1,0.0,0.0
Popescu Piedone,www.g4media.ro,0,1,0,1,-1.0,1.0
Raluca Bugnar,www.g4media.ro,0,0,1,1,0.0,0.0
Cosmin Călin,www.g4media.ro,0,0,1,1,0.0,0.0
Cristian Mitrică,www.g4media.ro,0,0,1,1,0.0,0.0
Daniel Alexandru Ion,www.g4media.ro,0,0,1,1,0.0,0.0
Gheorghe Popa,www.g4media.ro,0,0,1,1,0.0,0.0
Irina Broscaru,www.g4media.ro,0,0,1,1,0.0,0.0
Nicușor Roșca,www.g4media.ro,0,0,1,1,0.0,0.0
Veta Păsculescu,www.g4media.ro,0,0,1,1,0.0,0.0
inspector general,www.g4media.ro,0,0,1,1,0.0,0.0
Băsist,www.antena3.ro,0,1,0,1,-1.0,1.0
Grațiela Gavrilescu,www.antena3.ro,0,0,1,1,0.0,0.0
Cristian Barbu,www.antena3.ro,0,0,1,1,0.0,0.0
strateg,www.antena3.ro,0,0,1,1,0.0,0.0
Domnic Fritz,www.romaniatv.net,0,0,1,1,0.0,0.0
actionar,www.aktual24.ro,0,0,1,1,0.0,0.0
Toader,www.gandul.ro,0,0,1,1,0.0,0.0
decident,www.gandul.ro,0,0,1,1,0.0,0.0
Municipiul București,www.g4media.ro,0,0,1,1,0.0,0.0
publicist,www.romaniatv.net,0,1,0,1,-1.0,1.0
Câmpulung Muscel,www.romaniatv.net,1,0,0,1,1.0,1.0
mediator,www.romaniatv.net,0,1,0,1,-1.0,1.0
Hașotti,www.mediafax.ro,0,0,1,1,0.0,0.0
Puiu Hașotti,www.mediafax.ro,0,0,1,1,0.0,0.0
Pete Hegseth,www.euronews.ro,0,0,1,1,0.0,0.0
Nicușor Dana,www.euronews.ro,0,0,1,1,0.0,0.0
Gauthier Le Bret,www.activenews.ro,0,0,1,1,0.0,0.0
Remy Guerin,www.activenews.ro,0,0,1,1,0.0,0.0
Antal Lóránt,www.news.ro,0,0,1,1,0.0,0.0
Azerbaijan,www.news.ro,0,0,2,2,0.0,0.0
Baku,www.news.ro,0,0,1,1,0.0,0.0
Cristian Niculescu,www.news.ro,0,0,1,1,0.0,0.0
Eugen Cristian Șipoș,www.news.ro,0,0,1,1,0.0,0.0
George Enescu,www.news.ro,1,0,0,1,1.0,1.0
Milli Majlis,www.news.ro,0,0,1,1,0.0,0.0
Mircea Abrudean,www.news.ro,0,0,1,1,0.0,0.0
Republica Azerbaidjan,www.news.ro,0,0,1,1,0.0,0.0
Sebastian Cernic,www.news.ro,0,0,1,1,0.0,0.0
compozitor,www.news.ro,1,0,0,1,1.0,1.0
Adrian Solomon,www.news.ro,0,0,1,1,0.0,0.0
Sahiba Gafarova,www.news.ro,0,0,1,1,0.0,0.0
Ali Asadov,www.news.ro,0,0,1,1,0.0,0.0
Răzvan Munteanu,adevarul.ro,0,0,1,1,0.0,0.0
Andrei Muraru,adevarul.ro,0,1,0,1,-1.0,1.0
Adrian Veștea,recorder.ro,0,0,1,1,0.0,0.0
Allen Coliban,recorder.ro,0,1,1,2,-0.5,0.5
George Scripcaru,recorder.ro,0,1,0,1,-1.0,1.0
Rășnov,recorder.ro,0,0,1,1,0.0,0.0
Scripcaru,recorder.ro,0,1,0,1,-1.0,1.0
Băluță,www.g4media.ro,0,0,2,2,0.0,0.0
auditor,www.luju.ro,0,0,2,2,0.0,0.0
or,www.luju.ro,0,1,0,1,-1.0,1.0
Liliana Ruse,www.comisarul.ro,0,0,1,1,0.0,0.0
useriștean,www.comisarul.ro,0,1,0,1,-1.0,1.0
jurnalistă,www.comisarul.ro,0,0,1,1,0.0,0.0
Adrian Oros,pressone.ro,0,0,1,1,0.0,0.0
Anca Dragu,pressone.ro,1,0,0,1,1.0,1.0
Monica Anisie,pressone.ro,0,1,0,1,-1.0,1.0
usurpator,pressone.ro,0,1,0,1,-1.0,1.0
Muraru,agerpres.ro,0,0,1,1,0.0,0.0
Borodianka,www.euronews.ro,0,1,0,1,-1.0,1.0
Bucha,www.euronews.ro,0,1,0,1,-1.0,1.0
Irpin,www.euronews.ro,0,1,0,1,-1.0,1.0
Florian Bodog,primanews.ro,0,0,1,1,0.0,0.0
Mihai Goțiu,www.cotidianul.ro,0,0,1,1,0.0,0.0
Case Albe,www.aktual24.ro,0,1,0,1,-1.0,1.0
Ontario,www.aktual24.ro,0,0,1,1,0.0,0.0
Ottawa,www.aktual24.ro,0,0,1,1,0.0,0.0
Quebec,www.aktual24.ro,0,0,1,1,0.0,0.0
concetățean,www.digi24.ro,0,1,0,1,-1.0,1.0
Yoon Suk Yeol,www.gandul.ro,1,0,0,1,1.0,1.0
Republica Coreea,www.gandul.ro,0,0,1,1,0.0,0.0
Seul,www.gandul.ro,0,0,1,1,0.0,0.0
Matei Balș,recorder.ro,0,0,1,1,0.0,0.0
Vasile Voiculescu Iulian,recorder.ro,0,0,1,1,0.0,0.0
Victor Babeș,recorder.ro,0,0,1,1,0.0,0.0
Voiculescu,recorder.ro,0,0,1,1,0.0,0.0
Anca Dragu,recorder.ro,0,0,1,1,0.0,0.0
Alin Trășculescu,www.digi24.ro,0,2,0,2,-1.0,1.0
Trășculescu,www.digi24.ro,0,1,0,1,-1.0,1.0
Vrancea,www.digi24.ro,0,0,1,1,0.0,0.0
Aicea,pressone.ro,0,1,0,1,-1.0,1.0
Alex,pressone.ro,1,0,0,1,1.0,1.0
Alex Fechete,pressone.ro,0,0,1,1,0.0,0.0
bătrânică,pressone.ro,1,0,0,1,1.0,1.0
Dallas,pressone.ro,0,0,1,1,0.0,0.0
demon,pressone.ro,0,1,0,1,-1.0,1.0
Demon,pressone.ro,0,1,0,1,-1.0,1.0
Erji,pressone.ro,0,1,0,1,-1.0,1.0
Erjiche,pressone.ro,0,1,0,1,-1.0,1.0
Kovesiun,pressone.ro,0,1,0,1,-1.0,1.0
Pata Rât,pressone.ro,0,1,0,1,-1.0,1.0
Pata Râtul,pressone.ro,0,1,0,1,-1.0,1.0
Pepe,pressone.ro,1,0,0,1,1.0,1.0
Pichea,pressone.ro,0,1,0,1,-1.0,1.0
Simion Georgescu,pressone.ro,1,0,0,1,1.0,1.0
Săndel,pressone.ro,0,0,1,1,0.0,0.0
Vance,pressone.ro,0,1,0,1,-1.0,1.0
bandit,pressone.ro,0,3,0,3,-1.0,1.0
cizmă,pressone.ro,0,1,0,1,-1.0,1.0
clujen,pressone.ro,0,1,0,1,-1.0,1.0
facilitator,pressone.ro,0,0,1,1,0.0,0.0
patarâteni,pressone.ro,0,2,0,2,-1.0,1.0
tâlhar,pressone.ro,0,1,0,1,-1.0,1.0
ăia,pressone.ro,0,1,0,1,-1.0,1.0
Andreea Dumitrescu,www.antena3.ro,0,0,1,1,0.0,0.0
Cernavodă,www.antena3.ro,0,0,1,1,0.0,0.0
Cătălin Porumbel,www.antena3.ro,0,0,1,1,0.0,0.0
domnului,www.antena3.ro,0,0,1,1,0.0,0.0
Mădălina Mihalache,www.antena3.ro,0,0,1,1,0.0,0.0
corupt,www.antena3.ro,0,1,0,1,-1.0,1.0
Kelemen,www.antena3.ro,0,0,1,1,0.0,0.0
Marian Ceaușescu,www.antena3.ro,0,1,0,1,-1.0,1.0
domnul Ponta,www.antena3.ro,0,1,0,1,-1.0,1.0
economist,www.antena3.ro,0,0,1,1,0.0,0.0
jurist,www.antena3.ro,0,1,0,1,-1.0,1.0
necăjit,www.antena3.ro,0,1,0,1,-1.0,1.0
păpușar,www.antena3.ro,0,2,0,2,-1.0,1.0
rezervist,www.antena3.ro,0,1,0,1,-1.0,1.0
soldat,www.antena3.ro,0,2,0,2,-1.0,1.0
Ierusalim,www.news.ro,0,0,2,2,0.0,0.0
Bulai,stirileprotv.ro,0,0,1,1,0.0,0.0
Elon,www.gandul.ro,0,0,1,1,0.0,0.0
Mario Nawfal,www.gandul.ro,0,1,0,1,-1.0,1.0
Mateusz Morawiecki,www.gandul.ro,0,0,1,1,0.0,0.0
Robert Fico,www.gandul.ro,0,0,1,1,0.0,0.0
Slovac,www.gandul.ro,0,0,1,1,0.0,0.0
musk,www.gandul.ro,0,1,0,1,-1.0,1.0
dumnealui,www.antena3.ro,0,1,0,1,-1.0,1.0
butler,primanews.ro,0,0,1,1,0.0,0.0
Comey,primanews.ro,0,1,0,1,-1.0,1.0
Don Jr,primanews.ro,0,1,0,1,-1.0,1.0
Florida,primanews.ro,0,0,1,1,0.0,0.0
James Comey,primanews.ro,0,1,0,1,-1.0,1.0
Palm Beach,primanews.ro,0,0,1,1,0.0,0.0
Pennsylvania,primanews.ro,0,0,1,1,0.0,0.0
asasin,primanews.ro,0,0,1,1,0.0,0.0
tată,primanews.ro,0,1,0,1,-1.0,1.0
ultraș,www.euronews.ro,0,1,0,1,-1.0,1.0
aliaț,observatornews.ro,0,0,1,1,0.0,0.0
Buică,snoop.ro,0,0,1,1,0.0,0.0
Mitulețu,snoop.ro,0,0,1,1,0.0,0.0
auditor,snoop.ro,0,0,1,1,0.0,0.0
Che Guevara,www.digi24.ro,0,0,1,1,0.0,0.0
Constanșa,www.digi24.ro,0,1,0,1,-1.0,1.0
Judecător Badiu,www.comisarul.ro,0,0,1,1,0.0,0.0
Ionel Stoica,www.comisarul.ro,0,1,0,1,-1.0,1.0
Judecător,www.comisarul.ro,1,0,0,1,1.0,1.0
mătușă,www.comisarul.ro,0,1,0,1,-1.0,1.0
Adrian Iorgulescu,adevarul.ro,0,0,1,1,0.0,0.0
Aurel Novac,adevarul.ro,0,0,1,1,0.0,0.0
Batistei,adevarul.ro,0,1,0,1,-1.0,1.0
Constantin Titel Petrescu,adevarul.ro,0,0,1,1,0.0,0.0
Cornel Protopopescu,adevarul.ro,0,1,1,2,-0.5,0.5
Deva,adevarul.ro,0,0,1,1,0.0,0.0
Domnul Tabara,adevarul.ro,0,0,1,1,0.0,0.0
ecologist,adevarul.ro,0,0,1,1,0.0,0.0
Eduard-Victor Gugui,adevarul.ro,0,0,1,1,0.0,0.0
Ilie Sarbu,adevarul.ro,0,0,1,1,0.0,0.0
Ioan Gavra,adevarul.ro,0,0,1,1,0.0,0.0
Iorgulescu,adevarul.ro,0,0,1,1,0.0,0.0
Iosif Gavril Chiuzbaian,adevarul.ro,0,0,1,1,0.0,0.0
Laurentiu Ulici,adevarul.ro,0,0,1,1,0.0,0.0
Luminita,adevarul.ro,0,0,1,1,0.0,0.0
Marian Munteanu,adevarul.ro,0,0,1,1,0.0,0.0
Mehedinti,adevarul.ro,0,0,1,1,0.0,0.0
Monte Carlo,adevarul.ro,0,0,1,1,0.0,0.0
Munteanu,adevarul.ro,0,1,0,1,-1.0,1.0
negustor,adevarul.ro,0,0,1,1,0.0,0.0
Otto Weber,adevarul.ro,0,1,0,1,-1.0,1.0
Ovidiu Cretu,adevarul.ro,0,0,1,1,0.0,0.0
Paul Ghitiu,adevarul.ro,0,0,1,1,0.0,0.0
Petru Steolea,adevarul.ro,0,0,1,1,0.0,0.0
Ramnicu Valcea,adevarul.ro,0,0,1,1,0.0,0.0
Sorin Ovidiu Vântu,adevarul.ro,0,1,0,1,-1.0,1.0
Tabara,adevarul.ro,0,0,1,1,0.0,0.0
Valeriu Tabara,adevarul.ro,0,0,1,1,0.0,0.0
Vasile Secara,adevarul.ro,0,0,1,1,0.0,0.0
Virgil Magureanu,adevarul.ro,0,1,0,1,-1.0,1.0
Vosganian,adevarul.ro,0,0,1,1,0.0,0.0
Wim Van Welzen,adevarul.ro,1,0,0,1,1.0,1.0
a,adevarul.ro,0,1,0,1,-1.0,1.0
amic,adevarul.ro,0,1,1,2,-0.5,0.5
coautor,adevarul.ro,1,0,0,1,1.0,1.0
domnul Barbulescu,adevarul.ro,0,2,0,2,-1.0,1.0
finanțist,adevarul.ro,0,1,0,1,-1.0,1.0
Varujan Tabara,adevarul.ro,0,1,0,1,-1.0,1.0
sefilor,adevarul.ro,0,1,0,1,-1.0,1.0
somn,adevarul.ro,0,1,0,1,-1.0,1.0
tot,adevarul.ro,0,0,1,1,0.0,0.0
Tudorel Toader,www.realitatea.net,0,1,0,1,-1.0,1.0
Gâdea,www.realitatea.net,0,0,1,1,0.0,0.0
propagandist,www.realitatea.net,0,1,0,1,-1.0,1.0
competitor,a1.ro,0,1,0,1,-1.0,1.0
Biden,www.antena3.ro,0,0,1,1,0.0,0.0
Jake Sullivan,www.antena3.ro,0,0,1,1,0.0,0.0
Sullivan,www.antena3.ro,0,1,0,1,-1.0,1.0
Vern Buchanan,www.b1tv.ro,0,0,1,1,0.0,0.0
președinte interimar,www.b1tv.ro,0,0,1,1,0.0,0.0
POT,observatornews.ro,0,1,0,1,-1.0,1.0
Radu Pally,observatornews.ro,0,0,1,1,0.0,0.0
Silviu Predoiu,observatornews.ro,0,1,0,1,-1.0,1.0
Antal,www.news.ro,0,0,1,1,0.0,0.0
Antal Arpad,www.news.ro,0,0,1,1,0.0,0.0
Arpad,www.news.ro,0,0,1,1,0.0,0.0
Sfântul Gheorghe,www.news.ro,0,0,1,1,0.0,0.0
Mihai Jurca,www.realitatea.net,0,0,1,1,0.0,0.0
Federația Rusă,www.mediafax.ro,0,2,0,2,-1.0,1.0
Igor Dodon,www.mediafax.ro,0,1,0,1,-1.0,1.0
Ion Tăbârță,www.mediafax.ro,0,0,1,1,0.0,0.0
Sergei Lavrov,www.mediafax.ro,0,1,1,2,-0.5,0.5
M,www.mediafax.ro,0,1,0,1,-1.0,1.0
Maia Sandu,www.mediafax.ro,0,2,3,5,-0.4,0.4
Serb,www.mediafax.ro,0,0,2,2,0.0,0.0
Vladimir Plahotniuc,www.mediafax.ro,0,1,0,1,-1.0,1.0
doamna Sandu,www.mediafax.ro,0,0,1,1,0.0,0.0
dumneaei,www.mediafax.ro,0,1,0,1,-1.0,1.0
filor,www.mediafax.ro,0,1,0,1,-1.0,1.0
moldovean,www.mediafax.ro,0,0,1,1,0.0,0.0
Hristos,recorder.ro,0,0,1,1,0.0,0.0
Luisa Bărboiu,recorder.ro,0,1,0,1,-1.0,1.0
Nifon Mihăiță,recorder.ro,0,0,1,1,0.0,0.0
Nucet,recorder.ro,0,0,1,1,0.0,0.0
Târgoviștean,recorder.ro,0,0,1,1,0.0,0.0
mitropolit,recorder.ro,0,1,0,1,-1.0,1.0
neomarxist,recorder.ro,0,1,0,1,-1.0,1.0
Natalia Morari,www.digi24.ro,0,1,1,2,-0.5,0.5
Crețu,www.digi24.ro,0,0,1,1,0.0,0.0
baronet,pressone.ro,0,1,0,1,-1.0,1.0
generație,pressone.ro,0,0,1,1,0.0,0.0
întârziat,pressone.ro,0,1,0,1,-1.0,1.0
Oprea,agerpres.ro,0,0,1,1,0.0,0.0
Archar,www.mediafax.ro,0,0,1,1,0.0,0.0
Belgardul,www.mediafax.ro,0,0,1,1,0.0,0.0
cetate,www.mediafax.ro,0,0,1,1,0.0,0.0
Dobri Dol,www.mediafax.ro,0,1,0,1,-1.0,1.0
Krassimir Assenov,www.mediafax.ro,0,0,1,1,0.0,0.0
Kudelin,www.mediafax.ro,0,0,1,1,0.0,0.0
Lom,www.mediafax.ro,0,1,0,1,-1.0,1.0
Nikopol,www.mediafax.ro,0,0,1,1,0.0,0.0
pompier,www.mediafax.ro,0,0,1,1,0.0,0.0
Vidin,www.mediafax.ro,0,0,1,1,0.0,0.0
Zelezni Vrata,www.mediafax.ro,0,0,1,1,0.0,0.0
dispecer,www.mediafax.ro,0,0,1,1,0.0,0.0
Austria,www.b1tv.ro,0,0,1,1,0.0,0.0
Canada,www.b1tv.ro,0,0,1,1,0.0,0.0
Hodor,www.b1tv.ro,0,0,1,1,0.0,0.0
Mădălin Hodor,www.b1tv.ro,0,0,2,2,0.0,0.0
George-Valentin Grigore,www.b1tv.ro,0,0,1,1,0.0,0.0
domnie,www.b1tv.ro,0,1,0,1,-1.0,1.0
inginer,www.b1tv.ro,0,0,1,1,0.0,0.0
victimă,www.b1tv.ro,0,1,0,1,-1.0,1.0
agent,www.mediafax.ro,0,0,2,2,0.0,0.0
Florida,www.mediafax.ro,0,0,1,1,0.0,0.0
Merrick Garland,www.mediafax.ro,0,0,1,1,0.0,0.0
Roger Trump,www.mediafax.ro,0,0,1,1,0.0,0.0
Mike Pence,www.mediafax.ro,0,1,0,1,-1.0,1.0
Elena Udrea,www.b1tv.ro,0,0,1,1,0.0,0.0
Oradea,www.antena3.ro,0,0,1,1,0.0,0.0
alb,www.b1tv.ro,0,0,1,1,0.0,0.0
Alin Andrioni,www.b1tv.ro,0,0,1,1,0.0,0.0
Andrioni,www.b1tv.ro,0,1,0,1,-1.0,1.0
Bocea,www.b1tv.ro,0,2,0,2,-1.0,1.0
Deva,www.b1tv.ro,0,1,0,1,-1.0,1.0
director,www.b1tv.ro,0,0,2,2,0.0,0.0
Dvs,www.b1tv.ro,0,1,0,1,-1.0,1.0
Gabriel Paun,www.b1tv.ro,0,1,0,1,-1.0,1.0
Gabriel Păun,www.b1tv.ro,1,0,2,3,0.3333333333333333,0.3333333333333333
Mihai Goțiu,www.b1tv.ro,0,0,1,1,0.0,0.0
Mihalache Bocea,www.b1tv.ro,0,1,0,1,-1.0,1.0
Raluca Nicolae,www.b1tv.ro,0,0,2,2,0.0,0.0
Raul Alb,www.b1tv.ro,0,1,0,1,-1.0,1.0
Thomas Waitz,www.b1tv.ro,0,0,1,1,0.0,0.0
activist,www.b1tv.ro,0,2,2,4,-0.5,0.5
amică,www.b1tv.ro,0,0,1,1,0.0,0.0
Catalina Radulescu,www.b1tv.ro,0,0,1,1,0.0,0.0
colegă,www.b1tv.ro,0,0,1,1,0.0,0.0
Cristian Ghinea,www.b1tv.ro,0,0,1,1,0.0,0.0
om de afaceri,www.b1tv.ro,0,1,1,2,-0.5,0.5
ales,primanews.ro,0,1,0,1,-1.0,1.0
Adrian Neacșu,www.news.ro,0,1,0,1,-1.0,1.0
Neacșu,www.news.ro,0,0,1,1,0.0,0.0
Toni Neacșu,www.news.ro,0,1,1,2,-0.5,0.5
Chișinău,www.antena3.ro,0,0,1,1,0.0,0.0
Igor Grosu,www.antena3.ro,0,0,1,1,0.0,0.0
Angel Tîlvăr,www.aktual24.ro,0,0,1,1,0.0,0.0
cabinet,www.aktual24.ro,0,0,1,1,0.0,0.0
Marcel Boloș,www.aktual24.ro,0,0,1,1,0.0,0.0
chestor,www.romaniatv.net,0,0,1,1,0.0,0.0
delegat,www.romaniatv.net,0,0,1,1,0.0,0.0
referent,www.romaniatv.net,0,0,1,1,0.0,0.0
Abela,www.romaniatv.net,0,0,1,1,0.0,0.0
Bas Eickhout,www.romaniatv.net,0,0,1,1,0.0,0.0
Belgia,www.romaniatv.net,0,0,2,2,0.0,0.0
Chinei,www.romaniatv.net,0,0,1,1,0.0,0.0
Clare Daly,www.romaniatv.net,0,0,1,1,0.0,0.0
Croația,www.romaniatv.net,0,0,1,1,0.0,0.0
Danemarca,www.romaniatv.net,0,0,1,1,0.0,0.0
Dumitru Șoșoacă,www.romaniatv.net,0,0,1,1,0.0,0.0
Estonia,www.romaniatv.net,1,0,0,1,1.0,1.0
Fidias Panayiotou,www.romaniatv.net,0,0,1,1,0.0,0.0
Finlanda,www.romaniatv.net,0,0,1,1,0.0,0.0
Frans Timmermans,www.romaniatv.net,0,0,1,1,0.0,0.0
Frații,www.romaniatv.net,0,1,0,1,-1.0,1.0
Geert Wilders,www.romaniatv.net,0,1,0,1,-1.0,1.0
Hlas,www.romaniatv.net,0,0,1,1,0.0,0.0
Jordan Bardella,www.romaniatv.net,0,0,1,1,0.0,0.0
Letonia,www.romaniatv.net,0,0,1,1,0.0,0.0
Lituania,www.romaniatv.net,0,0,1,1,0.0,0.0
Luxemburg,www.romaniatv.net,0,0,1,1,0.0,0.0
Malta,www.romaniatv.net,0,0,1,1,0.0,0.0
Maximilian Krah,www.romaniatv.net,0,0,1,1,0.0,0.0
Mick Wallace,www.romaniatv.net,0,0,1,1,0.0,0.0
Nicolae Ștefănuță,www.romaniatv.net,0,0,1,1,0.0,0.0
Niels Schnecker,www.romaniatv.net,0,1,0,1,-1.0,1.0
oligarh,www.romaniatv.net,0,1,0,1,-1.0,1.0
Praga,www.romaniatv.net,0,0,1,1,0.0,0.0
Republica Cehă,www.romaniatv.net,0,0,1,1,0.0,0.0
Robert Fico,www.romaniatv.net,0,0,2,2,0.0,0.0
Roberta Metsola,www.romaniatv.net,0,0,1,1,0.0,0.0
Slovenia,www.romaniatv.net,0,0,1,1,0.0,0.0
Smer,www.romaniatv.net,0,0,1,1,0.0,0.0
Strasbourg,www.romaniatv.net,0,0,1,1,0.0,0.0
Teresa Ribera,www.romaniatv.net,0,0,1,1,0.0,0.0
Venstre,www.romaniatv.net,0,0,1,1,0.0,0.0
Vlaams Belang,www.romaniatv.net,0,1,0,1,-1.0,1.0
Vlad Gheorghe,www.romaniatv.net,0,0,1,1,0.0,0.0
Walter Baier,www.romaniatv.net,0,0,1,1,0.0,0.0
bandă,www.romaniatv.net,0,1,0,1,-1.0,1.0
comisar,www.romaniatv.net,0,0,1,1,0.0,0.0
figură,www.romaniatv.net,0,1,0,1,-1.0,1.0
influencer,www.romaniatv.net,0,0,1,1,0.0,0.0
omolog,www.romaniatv.net,0,0,1,1,0.0,0.0
perdanț,www.romaniatv.net,0,1,0,1,-1.0,1.0
Mette Frederiksen,www.romaniatv.net,0,0,1,1,0.0,0.0
Petteri Orpo,www.romaniatv.net,0,0,1,1,0.0,0.0
Robert Abela,www.romaniatv.net,0,0,1,1,0.0,0.0
spion,www.romaniatv.net,0,1,0,1,-1.0,1.0
vicepremier,www.romaniatv.net,0,0,1,1,0.0,0.0
Roxana Mînzatu,www.b1tv.ro,0,0,1,1,0.0,0.0
Ursula von der Leyen,www.b1tv.ro,0,0,1,1,0.0,0.0
reprezentantă,www.gandul.ro,0,0,1,1,0.0,0.0
Coreea de Sud,www.digi24.ro,0,0,1,1,0.0,0.0
Emiratele Arabe Unite,www.digi24.ro,1,0,0,1,1.0,1.0
Hiroshima,www.digi24.ro,0,0,1,1,0.0,0.0
camaraz,www.digi24.ro,1,0,0,1,1.0,1.0
Baru,a1.ro,0,0,1,1,0.0,0.0
Cristian Marius Vladu,a1.ro,0,0,1,1,0.0,0.0
Cristian Vladu,a1.ro,0,0,1,1,0.0,0.0
Mariana Campeanu,a1.ro,0,1,0,1,-1.0,1.0
director adjunct,a1.ro,0,0,1,1,0.0,0.0
fruntaș,a1.ro,0,1,0,1,-1.0,1.0
Ilan Laufer,www.romaniatv.net,0,0,1,1,0.0,0.0
Laufer,www.romaniatv.net,0,0,1,1,0.0,0.0
Claudiu Manda,adevarul.ro,0,0,1,1,0.0,0.0
Hava,adevarul.ro,0,0,1,1,0.0,0.0
Marian Jean Marinescu,adevarul.ro,0,0,1,1,0.0,0.0
Mircea Hava,adevarul.ro,0,0,1,1,0.0,0.0
decan,adevarul.ro,0,0,2,2,0.0,0.0
Călin,www.b1tv.ro,0,1,0,1,-1.0,1.0
Theodor Paleologu,www.b1tv.ro,0,2,0,2,-1.0,1.0
cuplu,www.b1tv.ro,0,0,1,1,0.0,0.0
martor,www.b1tv.ro,0,1,0,1,-1.0,1.0
Adrian Rus,primanews.ro,0,0,1,1,0.0,0.0
Andrei Burcă,primanews.ro,0,0,1,1,0.0,0.0
Denis Drăguș,primanews.ro,0,1,0,1,-1.0,1.0
Canada,primanews.ro,1,0,1,2,0.5,0.5
Dennis Man,primanews.ro,0,0,1,1,0.0,0.0
Florinel Coman,primanews.ro,0,0,1,1,0.0,0.0
Andrei Fundași Rațiu,primanews.ro,0,0,1,1,0.0,0.0
George Pușcaș,primanews.ro,0,0,1,1,0.0,0.0
Horațiu Moldovan,primanews.ro,0,0,1,1,0.0,0.0
Ionuț Nedelcearu,primanews.ro,0,0,1,1,0.0,0.0
Ionuț Radu,primanews.ro,0,0,1,1,0.0,0.0
Mexic,primanews.ro,0,0,1,1,0.0,0.0
Marius Marin,primanews.ro,0,0,1,1,0.0,0.0
Nicolae Stanciu,primanews.ro,0,0,1,1,0.0,0.0
Olimpiu Moruțan,primanews.ro,0,0,1,1,0.0,0.0
Pisa,primanews.ro,0,0,1,1,0.0,0.0
Florin Niță,primanews.ro,0,0,1,1,0.0,0.0
Răzvan Marin,primanews.ro,0,0,1,1,0.0,0.0
Mircea Lucescu,primanews.ro,0,0,1,1,0.0,0.0
Valentin Mihăilă,primanews.ro,0,0,1,1,0.0,0.0
Viena,primanews.ro,0,0,1,1,0.0,0.0
Vlad Dragomir,primanews.ro,0,0,1,1,0.0,0.0
străin,primanews.ro,0,0,1,1,0.0,0.0
Cipru,www.g4media.ro,0,0,1,1,0.0,0.0
Grecia,www.g4media.ro,0,0,1,1,0.0,0.0
Howard Lutnick,www.g4media.ro,0,0,1,1,0.0,0.0
cumpărător,www.g4media.ro,0,0,1,1,0.0,0.0
migrant,www.g4media.ro,1,0,0,1,1.0,1.0
oligarh,www.g4media.ro,0,1,0,1,-1.0,1.0
impostor,stirileprotv.ro,0,1,0,1,-1.0,1.0
Alinei Mungiu,www.activenews.ro,0,1,0,1,-1.0,1.0
Cristian Ghinea,www.activenews.ro,0,0,1,1,0.0,0.0
Daniel Gheorghe,www.activenews.ro,0,0,1,1,0.0,0.0
Domnia Sa,www.activenews.ro,0,1,0,1,-1.0,1.0
Domnule Ghinea,www.activenews.ro,0,1,0,1,-1.0,1.0
Gheorghe,www.activenews.ro,0,1,0,1,-1.0,1.0
Ghinea,www.activenews.ro,0,1,0,1,-1.0,1.0
Plumb,www.activenews.ro,0,1,0,1,-1.0,1.0
dr. Nicolae Bacalbașa,www.activenews.ro,0,0,1,1,0.0,0.0
iști,www.activenews.ro,0,1,0,1,-1.0,1.0
Marko,www.mediafax.ro,0,0,1,1,0.0,0.0
majoritate,www.mediafax.ro,0,0,1,1,0.0,0.0
Ishiba,www.aktual24.ro,0,1,0,1,-1.0,1.0
Kishida,www.aktual24.ro,0,1,0,1,-1.0,1.0
Noda,www.aktual24.ro,0,0,1,1,0.0,0.0
contabil,www.aktual24.ro,0,1,0,1,-1.0,1.0
Fumio Kishida,www.aktual24.ro,0,1,0,1,-1.0,1.0
Shigeru Ishiba,www.aktual24.ro,0,0,1,1,0.0,0.0
Gheorghe Piperea,www.realitatea.net,0,2,0,2,-1.0,1.0
guvernator,www.realitatea.net,0,0,1,1,0.0,0.0
Isărescu,www.realitatea.net,0,0,1,1,0.0,0.0
Năstase,www.realitatea.net,0,1,0,1,-1.0,1.0
pilot,www.realitatea.net,0,1,0,1,-1.0,1.0
refugiat,www.realitatea.net,0,1,0,1,-1.0,1.0
Focșani,www.cotidianul.ro,0,0,2,2,0.0,0.0
jandarm,www.antena3.ro,0,1,0,1,-1.0,1.0
Tătaru,observatornews.ro,0,1,0,1,-1.0,1.0
Varujan Vosganian,observatornews.ro,0,0,1,1,0.0,0.0
Adamescu,pressone.ro,0,0,1,1,0.0,0.0
Adrian Solomon,pressone.ro,0,0,1,1,0.0,0.0
Cosmin Vasile,pressone.ro,0,0,1,1,0.0,0.0
Harmel,pressone.ro,0,0,1,1,0.0,0.0
Janda,pressone.ro,0,0,1,1,0.0,0.0
Luypaert,pressone.ro,0,0,1,1,0.0,0.0
Petre Manole,pressone.ro,0,0,1,1,0.0,0.0
Răzvan Petri,pressone.ro,0,0,1,1,0.0,0.0
Roxana Mînzatu,pressone.ro,0,1,1,2,-0.5,0.5
Ruxandra Ivan,pressone.ro,0,0,1,1,0.0,0.0
Schlesinger,pressone.ro,0,0,1,1,0.0,0.0
Victoria Stoiciu,pressone.ro,1,0,0,1,1.0,1.0
purtătoare de cuvânt,pressone.ro,0,0,1,1,0.0,0.0
Berești,recorder.ro,0,0,1,1,0.0,0.0
Mariei Grapini,recorder.ro,0,0,2,2,0.0,0.0
Andreea Archip,recorder.ro,0,0,1,1,0.0,0.0
Puciști,www.comisarul.ro,0,1,0,1,-1.0,1.0
Ciucu,observatornews.ro,0,0,1,1,0.0,0.0
Alexandru Ioan Cuza,www.comisarul.ro,0,0,1,1,0.0,0.0
Alexandru Ipsilanti,www.comisarul.ro,1,0,0,1,1.0,1.0
Alexandru Moruzi,www.comisarul.ro,0,0,1,1,0.0,0.0
Carol I,www.comisarul.ro,0,1,1,2,-0.5,0.5
Constantin Argetoianu,www.comisarul.ro,0,0,1,1,0.0,0.0
Constantin Brâncoveanu,www.comisarul.ro,0,0,1,1,0.0,0.0
Constantinopol,www.comisarul.ro,1,0,0,1,1.0,1.0
Dionisie,www.comisarul.ro,0,0,1,1,0.0,0.0
Foișor,www.comisarul.ro,0,0,1,1,0.0,0.0
Gabriel Constantin,www.comisarul.ro,0,0,1,1,0.0,0.0
Grigore Ionescu,www.comisarul.ro,0,0,1,1,0.0,0.0
Mihai Cantacuzino,www.comisarul.ro,0,0,1,1,0.0,0.0
Neculai Mavrocordat,www.comisarul.ro,0,0,1,1,0.0,0.0
Padova,www.comisarul.ro,0,0,1,1,0.0,0.0
Paul Gottereau,www.comisarul.ro,0,0,1,1,0.0,0.0
Petru Groza,www.comisarul.ro,0,0,1,1,0.0,0.0
Preda,www.comisarul.ro,0,0,1,1,0.0,0.0
Carol,www.comisarul.ro,0,0,1,1,0.0,0.0
Regele Mihai,www.comisarul.ro,1,0,0,1,1.0,1.0
Regele Ferdinand,www.comisarul.ro,1,0,0,1,1.0,1.0
Ferdinand I,www.comisarul.ro,1,0,0,1,1.0,1.0
Regina Maria,www.comisarul.ro,0,0,1,1,0.0,0.0
Rusciuc,www.comisarul.ro,0,0,1,1,0.0,0.0
Serghie,www.comisarul.ro,0,0,1,1,0.0,0.0
Stoica,www.comisarul.ro,0,0,1,1,0.0,0.0
Tudor Vladimirescu,www.comisarul.ro,0,0,1,1,0.0,0.0
domnitor,www.comisarul.ro,0,0,1,1,0.0,0.0
Vah,www.comisarul.ro,0,0,1,1,0.0,0.0
boierime,www.comisarul.ro,0,1,0,1,-1.0,1.0
călugăr,www.comisarul.ro,0,0,1,1,0.0,0.0
Suveran,www.comisarul.ro,0,1,0,1,-1.0,1.0
Constantin Mavrocordat,www.comisarul.ro,0,0,1,1,0.0,0.0
Gheorghe Duca,www.comisarul.ro,0,1,0,1,-1.0,1.0
Carol Davila,www.comisarul.ro,0,0,1,1,0.0,0.0
fecior,www.comisarul.ro,0,0,1,1,0.0,0.0
norod,www.comisarul.ro,0,0,1,1,0.0,0.0
pionier,www.comisarul.ro,1,1,0,2,0.0,0.0
Ferdinand de Hohenzollern,www.comisarul.ro,0,0,1,1,0.0,0.0
sfânt,www.comisarul.ro,0,0,1,1,0.0,0.0
soldat,www.comisarul.ro,0,0,1,1,0.0,0.0
trecător,www.comisarul.ro,0,1,0,1,-1.0,1.0
Matei bătrânul,www.comisarul.ro,0,0,1,1,0.0,0.0
țară,www.comisarul.ro,0,0,1,1,0.0,0.0
țăran,www.comisarul.ro,0,0,1,1,0.0,0.0
Elena Albu,adevarul.ro,0,0,1,1,0.0,0.0
Alexandru Pânișoară,adevarul.ro,0,0,1,1,0.0,0.0
Alexandru Pănișoară,adevarul.ro,0,0,1,1,0.0,0.0
Antony Octavian Andre,adevarul.ro,0,0,1,1,0.0,0.0
Chitic Mircea Victor Daniel,adevarul.ro,0,0,1,1,0.0,0.0
Claudiu Tîrziu,adevarul.ro,0,0,1,1,0.0,0.0
Craiu Ana,adevarul.ro,0,0,1,1,0.0,0.0
Dan Puric,adevarul.ro,0,0,1,1,0.0,0.0
George Becali,adevarul.ro,0,1,0,1,-1.0,1.0
Cătălin Georgescu,adevarul.ro,0,0,1,1,0.0,0.0
Gheorghe Piperea,adevarul.ro,0,0,1,1,0.0,0.0
Narcis Viorel Florin,adevarul.ro,0,0,1,1,0.0,0.0
Nawfal,adevarul.ro,0,0,1,1,0.0,0.0
Petria Eugeniu Dragoș,adevarul.ro,0,0,1,1,0.0,0.0
Norita Popescu,adevarul.ro,0,0,1,1,0.0,0.0
Pânișoară,adevarul.ro,0,0,1,1,0.0,0.0
Radu Elena,adevarul.ro,0,0,1,1,0.0,0.0
Rapcea Mihai,adevarul.ro,0,0,1,1,0.0,0.0
Cristian Adrian Secu,adevarul.ro,0,0,1,1,0.0,0.0
Sorin Constantinescu,adevarul.ro,0,0,1,1,0.0,0.0
Tamalis Taloi Maria,adevarul.ro,0,0,1,1,0.0,0.0
Tănase Georgeta,adevarul.ro,0,0,1,1,0.0,0.0
Nicu Stănescu,www.realitatea.net,0,1,0,1,-1.0,1.0
Timișoara,www.realitatea.net,0,0,1,1,0.0,0.0
Ancăi Dragu,stirileprotv.ro,0,0,1,1,0.0,0.0
Guvernul Cîțu,stirileprotv.ro,0,1,0,1,-1.0,1.0
Sandu,primanews.ro,1,0,0,1,1.0,1.0
Buchanan,www.antena3.ro,0,0,1,1,0.0,0.0
Vern Buchanan,www.antena3.ro,0,0,2,2,0.0,0.0
Dmitri Peskov,www.romaniatv.net,0,0,1,1,0.0,0.0
Maria Zaharova,www.romaniatv.net,0,1,0,1,-1.0,1.0
Pavel Durov,www.romaniatv.net,0,0,1,1,0.0,0.0
Regatul Unit,www.romaniatv.net,0,0,1,1,0.0,0.0
prorus,www.romaniatv.net,0,1,0,1,-1.0,1.0
Chinei,adevarul.ro,0,1,0,1,-1.0,1.0
Coldea,adevarul.ro,0,1,0,1,-1.0,1.0
maior,adevarul.ro,0,0,1,1,0.0,0.0
uzurpator,adevarul.ro,0,1,0,1,-1.0,1.0
Andronescu,stirileprotv.ro,0,0,1,1,0.0,0.0
Cătălin Nechifor,stirileprotv.ro,0,0,1,1,0.0,0.0
Dumitru Coarnă,stirileprotv.ro,0,0,1,1,0.0,0.0
Gabriela Podașcă,stirileprotv.ro,0,0,1,1,0.0,0.0
Ioana Petrescu,stirileprotv.ro,0,0,2,2,0.0,0.0
Nicolae Bănicioiu,stirileprotv.ro,0,0,1,1,0.0,0.0
Nicolae Bănicoiu,stirileprotv.ro,0,0,1,1,0.0,0.0
Sorin Câmpeanu,stirileprotv.ro,0,0,1,1,0.0,0.0
turism,stirileprotv.ro,0,0,1,1,0.0,0.0
Daniel Fenechiu,primanews.ro,0,0,1,1,0.0,0.0
om politic,www.euronews.ro,0,0,1,1,0.0,0.0
ins,www.romaniatv.net,0,1,0,1,-1.0,1.0
adunare,snoop.ro,0,0,1,1,0.0,0.0
Balșa,snoop.ro,0,0,1,1,0.0,0.0
Alexandru Bexa,snoop.ro,0,0,1,1,0.0,0.0
Boboescu Ilie,snoop.ro,0,0,1,1,0.0,0.0
Bradu,snoop.ro,0,0,1,1,0.0,0.0
Breda Lajos,snoop.ro,0,0,1,1,0.0,0.0
Bujor Petrică,snoop.ro,0,0,1,1,0.0,0.0
Bărbulești,snoop.ro,0,0,1,1,0.0,0.0
Carei,snoop.ro,0,0,1,1,0.0,0.0
Cati Hristu,snoop.ro,0,0,1,1,0.0,0.0
Ceptura,snoop.ro,0,0,1,1,0.0,0.0
Cincu,snoop.ro,0,0,1,1,0.0,0.0
Cogealac,snoop.ro,0,0,1,1,0.0,0.0
Ion Cojocaru,snoop.ro,0,0,1,1,0.0,0.0
Colibași,snoop.ro,0,0,1,1,0.0,0.0
Cosmin Andrei,snoop.ro,0,0,1,1,0.0,0.0
Cranță Gicu,snoop.ro,0,0,1,1,0.0,0.0
Crișeni,snoop.ro,0,0,1,1,0.0,0.0
Călinești,snoop.ro,0,0,1,1,0.0,0.0
Daia Dănuț,snoop.ro,0,0,1,1,0.0,0.0
Danciu Gabriel,snoop.ro,0,0,1,1,0.0,0.0
Iacobici,snoop.ro,0,0,3,3,0.0,0.0
Drăganu,snoop.ro,0,0,1,1,0.0,0.0
Dulamă,snoop.ro,0,1,0,1,-1.0,1.0
Dulcești,snoop.ro,0,0,1,1,0.0,0.0
Eșelnița,snoop.ro,0,0,1,1,0.0,0.0
Făure,snoop.ro,0,0,1,1,0.0,0.0
Gabriela,snoop.ro,0,0,1,1,0.0,0.0
Mihai Georgescu,snoop.ro,0,0,1,1,0.0,0.0
Gheorghe Grigore,snoop.ro,0,0,1,1,0.0,0.0
Godeni,snoop.ro,0,0,1,1,0.0,0.0
Gîngioveanu,snoop.ro,0,0,1,1,0.0,0.0
Găești,snoop.ro,0,0,1,1,0.0,0.0
Gălbinași,snoop.ro,0,0,1,1,0.0,0.0
Ilfovul,snoop.ro,0,0,1,1,0.0,0.0
Ion Iacobici,snoop.ro,0,0,2,2,0.0,0.0
Ionel Dulamă,snoop.ro,0,0,1,1,0.0,0.0
Violeta Ionescu,snoop.ro,0,0,1,1,0.0,0.0
Isvoarele,snoop.ro,0,0,1,1,0.0,0.0
Iulian Dumitrescu,snoop.ro,0,0,1,1,0.0,0.0
Jantea Mirel,snoop.ro,0,0,1,1,0.0,0.0
Traian Felician,snoop.ro,0,0,1,1,0.0,0.0
Jugureni,snoop.ro,0,0,1,1,0.0,0.0
Eugen Kovacs,snoop.ro,0,0,1,1,0.0,0.0
Leuștean Dumitru,snoop.ro,0,0,1,1,0.0,0.0
Liță Vasile,snoop.ro,0,0,1,1,0.0,0.0
Nicușor,snoop.ro,0,0,1,1,0.0,0.0
Malu,snoop.ro,0,0,1,1,0.0,0.0
Mark Endre,snoop.ro,0,0,1,1,0.0,0.0
Mihaela Roșu,snoop.ro,0,0,1,1,0.0,0.0
Vasile Călin,snoop.ro,0,0,1,1,0.0,0.0
Mărcoceanu Constantin,snoop.ro,0,0,1,1,0.0,0.0
Nahoi Gheorghe,snoop.ro,0,0,1,1,0.0,0.0
Nași,snoop.ro,0,1,0,1,-1.0,1.0
Niculae Traian,snoop.ro,0,0,1,1,0.0,0.0
Novaci,snoop.ro,0,0,1,1,0.0,0.0
Nucșoara,snoop.ro,0,0,1,1,0.0,0.0
Ogrezeni,snoop.ro,0,0,1,1,0.0,0.0
Olariu Dumitru,snoop.ro,0,0,1,1,0.0,0.0
Ormeniș,snoop.ro,0,0,1,1,0.0,0.0
Ovidiu,snoop.ro,0,0,1,1,0.0,0.0
Pantelimon,snoop.ro,0,1,0,1,-1.0,1.0
Ioan Pasere,snoop.ro,0,0,1,1,0.0,0.0
Posa Georgeta Maria,snoop.ro,0,0,1,1,0.0,0.0
Jan Cătălin Preda,snoop.ro,0,0,1,1,0.0,0.0
Prejmer,snoop.ro,0,0,1,1,0.0,0.0
Primăria,snoop.ro,0,1,0,1,-1.0,1.0
Pădureanu Ion,snoop.ro,0,0,1,1,0.0,0.0
Radu Paul,snoop.ro,0,0,1,1,0.0,0.0
Reghin,snoop.ro,0,0,1,1,0.0,0.0
Rucăr,snoop.ro,0,0,1,1,0.0,0.0
Vasile George Stanciu,snoop.ro,0,0,1,1,0.0,0.0
Stoica Constantin,snoop.ro,0,0,1,1,0.0,0.0
Darius Mihai Săvulescu,snoop.ro,0,0,1,1,0.0,0.0
Titu,snoop.ro,0,0,1,1,0.0,0.0
Toplița,snoop.ro,0,0,1,1,0.0,0.0
Traian Niculae,snoop.ro,0,0,2,2,0.0,0.0
Uniunea,snoop.ro,0,1,1,2,-0.5,0.5
Vașca Marius Emilian,snoop.ro,0,0,1,1,0.0,0.0
Vârșolț,snoop.ro,0,0,1,1,0.0,0.0
badantă,snoop.ro,0,1,0,1,-1.0,1.0
contabilă,snoop.ro,0,0,1,1,0.0,0.0
cuscri,snoop.ro,0,1,0,1,-1.0,1.0
Daragiu,snoop.ro,0,0,1,1,0.0,0.0
etic,snoop.ro,0,1,0,1,-1.0,1.0
familia Cosma,snoop.ro,0,1,0,1,-1.0,1.0
gagic,snoop.ro,0,1,0,1,-1.0,1.0
independent,snoop.ro,0,0,1,1,0.0,0.0
locatar,snoop.ro,0,0,1,1,0.0,0.0
nevastă,snoop.ro,0,1,0,1,-1.0,1.0
primăriță,snoop.ro,0,0,1,1,0.0,0.0
viceprimăriță,snoop.ro,0,1,0,1,-1.0,1.0
Ștefan Ionescu,snoop.ro,0,0,1,1,0.0,0.0
Boxtown,www.aktual24.ro,0,1,0,1,-1.0,1.0
Memphis,www.aktual24.ro,0,0,1,1,0.0,0.0
Schengen,adevarul.ro,0,0,1,1,0.0,0.0
Paul Chisnoiu,www.luju.ro,0,0,2,2,0.0,0.0
Irina Elena Costencu,www.luju.ro,0,0,1,1,0.0,0.0
Dumitrascu Aureliu Decebal,www.luju.ro,0,0,1,1,0.0,0.0
Vadim Corneliu,www.luju.ro,0,0,1,1,0.0,0.0
Ruse Vadim Corneliu,www.luju.ro,0,0,1,1,0.0,0.0
S,www.luju.ro,0,1,0,1,-1.0,1.0
Luciana Spineanu-Georgescu,www.luju.ro,0,0,1,1,0.0,0.0
administrator public,www.luju.ro,0,1,0,1,-1.0,1.0
funcționar public,www.luju.ro,0,2,0,2,-1.0,1.0
Funeriu,www.comisarul.ro,0,1,0,1,-1.0,1.0
Livezeni,www.cotidianul.ro,0,0,1,1,0.0,0.0
Lonea,www.cotidianul.ro,0,0,1,1,0.0,0.0
Lupeni,www.cotidianul.ro,0,0,1,1,0.0,0.0
Vulcan,www.cotidianul.ro,0,0,1,1,0.0,0.0
posesor,a1.ro,0,0,1,1,0.0,0.0
Auckland,www.romaniatv.net,0,0,1,1,0.0,0.0
Noua Zeelandă,www.romaniatv.net,0,0,2,2,0.0,0.0
Singapore,www.romaniatv.net,0,0,1,1,0.0,0.0
Gruia,www.comisarul.ro,0,0,1,1,0.0,0.0
Neluțu Varga,www.comisarul.ro,0,0,1,1,0.0,0.0
Varga,www.comisarul.ro,0,1,0,1,-1.0,1.0
cel,www.comisarul.ro,0,0,1,1,0.0,0.0
Stelian Ion,www.luju.ro,0,2,0,2,-1.0,1.0
useristilor,www.luju.ro,0,1,0,1,-1.0,1.0
George Rareș,primanews.ro,0,1,0,1,-1.0,1.0
Gigi,primanews.ro,0,0,1,1,0.0,0.0
nea Gigi,primanews.ro,0,1,0,1,-1.0,1.0
Leonard Bărăscu,www.b1tv.ro,0,0,1,1,0.0,0.0
Ministrul Câciu,www.b1tv.ro,0,1,0,1,-1.0,1.0
sindicalist,www.b1tv.ro,0,1,0,1,-1.0,1.0
Andreea Esca,www.gandul.ro,0,0,1,1,0.0,0.0
Cristian Terheș,agerpres.ro,0,0,1,1,0.0,0.0
Daniel Funeriu,agerpres.ro,0,0,1,1,0.0,0.0
John Ion Banu,agerpres.ro,0,0,1,1,0.0,0.0
Lavinia Șandru,agerpres.ro,0,0,1,1,0.0,0.0
Sebastian Popescu,agerpres.ro,0,0,1,1,0.0,0.0
respondent,agerpres.ro,0,0,2,2,0.0,0.0
Cluj Napoca,adevarul.ro,0,0,1,1,0.0,0.0
Dan Tanasă,www.digi24.ro,0,0,1,1,0.0,0.0
Tucker Carlson,adevarul.ro,0,0,1,1,0.0,0.0
Sprînceană,www.antena3.ro,0,1,0,1,-1.0,1.0
acesta,www.realitatea.net,0,0,1,1,0.0,0.0
Cristi Danileț,www.realitatea.net,0,0,1,1,0.0,0.0
scriitor,www.cotidianul.ro,0,0,1,1,0.0,0.0
Stelian Tănase,www.cotidianul.ro,0,0,1,1,0.0,0.0
Tănase,www.cotidianul.ro,0,0,1,1,0.0,0.0
afirmă,adevarul.ro,0,0,1,1,0.0,0.0
spune,adevarul.ro,0,0,1,1,0.0,0.0
Gojira,www.mediafax.ro,0,0,1,1,0.0,0.0
Ralph Gonsalves,www.luju.ro,1,0,0,1,1.0,1.0
Guyana,www.luju.ro,0,0,1,1,0.0,0.0
Mihai Daraban,www.luju.ro,0,0,1,1,0.0,0.0
Sfântul Vincent și Grenadine,www.luju.ro,0,0,1,1,0.0,0.0
Venezuela,www.luju.ro,0,0,1,1,0.0,0.0
secretar general adjunct,www.aktual24.ro,0,0,1,1,0.0,0.0
Claudiu Năsui,www.digi24.ro,0,1,0,1,-1.0,1.0
Ghigiu,www.digi24.ro,0,0,1,1,0.0,0.0
Mihai Ghigiu,www.digi24.ro,0,0,1,1,0.0,0.0
meditator,www.digi24.ro,0,1,0,1,-1.0,1.0
Petrișor Peiu,www.digi24.ro,0,0,1,1,0.0,0.0
Arpad Antal,adevarul.ro,0,0,1,1,0.0,0.0
Gheorghieni,adevarul.ro,0,0,1,1,0.0,0.0
Janos Mezei,adevarul.ro,0,0,1,1,0.0,0.0
Robert Raduly,adevarul.ro,0,0,1,1,0.0,0.0
Semjen,adevarul.ro,0,1,0,1,-1.0,1.0
Sfântu Gheorghe,adevarul.ro,0,0,1,1,0.0,0.0
Zsolt Semjen,adevarul.ro,0,0,1,1,0.0,0.0
Dan Cristian Popescu,www.gandul.ro,0,0,1,1,0.0,0.0
Dan-Cristian Popescu,www.gandul.ro,0,0,1,1,0.0,0.0
Marian Petrache,www.gandul.ro,0,0,1,1,0.0,0.0
Alexandra Cornea,pressone.ro,0,1,0,1,-1.0,1.0
Alexandru Ene,pressone.ro,0,0,3,3,0.0,0.0
Gabriel Turcu,pressone.ro,0,0,3,3,0.0,0.0
Dumitru Sandu,pressone.ro,0,0,5,5,0.0,0.0
Ene,pressone.ro,0,1,0,1,-1.0,1.0
Foster,pressone.ro,0,1,0,1,-1.0,1.0
Ioan Pleșa,pressone.ro,0,1,2,3,-0.3333333333333333,0.3333333333333333
Ionel Jinga,pressone.ro,0,1,1,2,-0.5,0.5
Jinga,pressone.ro,0,1,0,1,-1.0,1.0
Mircea Cărtărescu,pressone.ro,0,0,1,1,0.0,0.0
Nițu,pressone.ro,0,0,1,1,0.0,0.0
Oana Alina Nițu,pressone.ro,0,0,1,1,0.0,0.0
Pleșa,pressone.ro,0,1,0,1,-1.0,1.0
Marian Popesu,pressone.ro,0,1,0,1,-1.0,1.0
Marian Popescu,pressone.ro,1,0,2,3,0.3333333333333333,0.3333333333333333
Ribkin,pressone.ro,0,1,0,1,-1.0,1.0
Turcu,pressone.ro,0,0,1,1,0.0,0.0
Dumitru Săndoiu,pressone.ro,0,0,1,1,0.0,0.0
fraudator,pressone.ro,0,1,0,1,-1.0,1.0
Melania Cincea,pressone.ro,0,0,1,1,0.0,0.0
Vasile Brînzănescu,pressone.ro,0,0,1,1,0.0,0.0
Brînzănescu,pressone.ro,0,1,0,1,-1.0,1.0
Marius Manole,www.antena3.ro,0,0,2,2,0.0,0.0
Manole,www.antena3.ro,0,0,1,1,0.0,0.0
Andrei Muraru,www.digi24.ro,0,0,2,2,0.0,0.0
Biden,www.digi24.ro,0,0,1,1,0.0,0.0
Croația,www.digi24.ro,0,0,1,1,0.0,0.0
Qatar,www.digi24.ro,0,0,1,1,0.0,0.0
Steve Witkoff,www.digi24.ro,0,0,1,1,0.0,0.0
Teodora Tompea,www.digi24.ro,0,0,1,1,0.0,0.0
doamna Tompea,www.digi24.ro,0,0,1,1,0.0,0.0
Vance,www.digi24.ro,0,0,1,1,0.0,0.0
însărcinat special,www.digi24.ro,0,0,1,1,0.0,0.0
ambii,www.romaniatv.net,0,0,1,1,0.0,0.0
sociopol,www.romaniatv.net,0,0,1,1,0.0,0.0
Hațeg,a1.ro,0,0,1,1,0.0,0.0
Leontin Florea,a1.ro,0,0,1,1,0.0,0.0
interpret,a1.ro,0,1,0,1,-1.0,1.0
minier,a1.ro,0,0,1,1,0.0,0.0
Alex Soros,www.aktual24.ro,0,0,1,1,0.0,0.0
Davos,www.aktual24.ro,0,1,0,1,-1.0,1.0
Kamala Harris,www.aktual24.ro,0,0,1,1,0.0,0.0
Mihail Neamțu,www.aktual24.ro,0,0,1,1,0.0,0.0
Florin Calinescu,www.aktual24.ro,0,0,1,1,0.0,0.0
Paul Ispas,www.realitatea.net,0,0,2,2,0.0,0.0
Frankfurt,observatornews.ro,0,0,1,1,0.0,0.0
Slovacia,observatornews.ro,0,0,1,1,0.0,0.0
Antonie Iorgovan,pressone.ro,0,0,1,1,0.0,0.0
Avocat al Poporului,pressone.ro,0,0,1,1,0.0,0.0
Dvs,pressone.ro,0,0,1,1,0.0,0.0
Poporul,pressone.ro,0,0,1,1,0.0,0.0
uz,pressone.ro,0,1,0,1,-1.0,1.0
avocatul poporului,pressone.ro,0,1,0,1,-1.0,1.0
avocat al poporului,pressone.ro,0,1,0,1,-1.0,1.0
etic,pressone.ro,0,1,0,1,-1.0,1.0
ombudsman,pressone.ro,1,0,0,1,1.0,1.0
Iisus Hristos,www.news.ro,1,0,0,1,1.0,1.0
credincios,www.news.ro,0,0,1,1,0.0,0.0
Burduja,primanews.ro,0,0,1,1,0.0,0.0
Coreea de Sud,primanews.ro,0,0,1,1,0.0,0.0
Draghi,primanews.ro,0,0,1,1,0.0,0.0
Japonia,primanews.ro,0,0,1,1,0.0,0.0
Ialta,www.activenews.ro,0,1,0,1,-1.0,1.0
JD Vance,www.activenews.ro,0,1,0,1,-1.0,1.0
Micul Căprar,www.activenews.ro,0,1,0,1,-1.0,1.0
München,www.activenews.ro,0,1,0,1,-1.0,1.0
Nastratin Hogea,www.activenews.ro,0,0,1,1,0.0,0.0
Orwell,www.activenews.ro,0,1,0,1,-1.0,1.0
Von der Leyen,www.activenews.ro,0,1,0,1,-1.0,1.0
Doinei Pană,www.antena3.ro,0,0,1,1,0.0,0.0
Pană,www.antena3.ro,0,1,0,1,-1.0,1.0
Mihaela Geoana,a1.ro,0,0,1,1,0.0,0.0
Faro,www.romaniatv.net,0,0,1,1,0.0,0.0
Johannis,adevarul.ro,0,1,0,1,-1.0,1.0
Marcel,adevarul.ro,0,1,0,1,-1.0,1.0
cioflingar,adevarul.ro,0,1,0,1,-1.0,1.0
ăia,adevarul.ro,0,1,0,1,-1.0,1.0
Dumitrescu,observatornews.ro,0,1,0,1,-1.0,1.0
Iulian Dumitrescu,observatornews.ro,0,2,1,3,-0.6666666666666666,0.6666666666666666
Romeo Lungu,www.cotidianul.ro,0,0,1,1,0.0,0.0
Crin,a1.ro,1,0,0,1,1.0,1.0
Gabriela Firea,a1.ro,1,0,0,1,1.0,1.0
Alexandru Nicolschi,www.luju.ro,0,1,0,1,-1.0,1.0
Ferreira,www.luju.ro,0,0,1,1,0.0,0.0
Pitești,www.luju.ro,0,0,1,1,0.0,0.0
Teohari Georgescu,www.luju.ro,0,1,0,1,-1.0,1.0
Victoria Baltag,www.luju.ro,0,0,2,2,0.0,0.0
Ion Caramitru,www.luju.ro,0,0,1,1,0.0,0.0
Gabriela Baltag,www.luju.ro,0,0,1,1,0.0,0.0
regizoare,www.luju.ro,0,0,1,1,0.0,0.0
Andrzej,www.comisarul.ro,0,0,1,1,0.0,0.0
Batyr,www.comisarul.ro,0,1,0,1,-1.0,1.0
Gdansk,www.comisarul.ro,0,0,1,1,0.0,0.0
Grzegorz Braun,www.comisarul.ro,0,0,1,1,0.0,0.0
Nikodem Skotarczak,www.comisarul.ro,0,0,1,1,0.0,0.0
Oxford,www.comisarul.ro,0,0,1,1,0.0,0.0
politică,www.comisarul.ro,0,1,0,1,-1.0,1.0
Sławomir Mentzen,www.comisarul.ro,0,0,1,1,0.0,0.0
străbunic,www.comisarul.ro,0,0,1,1,0.0,0.0
Tadeusz Batyr,www.comisarul.ro,0,1,0,1,-1.0,1.0
eurofil,www.comisarul.ro,0,0,1,1,0.0,0.0
gangster,www.comisarul.ro,0,1,1,2,-0.5,0.5
neonazist,www.comisarul.ro,0,1,0,1,-1.0,1.0
pianist,www.comisarul.ro,1,0,0,1,1.0,1.0
refugiat,www.comisarul.ro,0,1,1,2,-0.5,0.5
Pechea,www.cotidianul.ro,0,1,0,1,-1.0,1.0
idol,www.romaniatv.net,0,2,0,2,-1.0,1.0
Nicolae-Ionel Ciucă,observatornews.ro,1,0,0,1,1.0,1.0
Mircea Snegur,www.euronews.ro,0,0,1,1,0.0,0.0
Sinwar,www.euronews.ro,0,0,1,1,0.0,0.0
Yahya Sinwar,www.euronews.ro,0,1,1,2,-0.5,0.5
ostaș,www.euronews.ro,0,2,0,2,-1.0,1.0
rudă,www.euronews.ro,0,1,0,1,-1.0,1.0
Dragoș Sprînceană,stirileprotv.ro,0,0,2,2,0.0,0.0
Mar,stirileprotv.ro,0,0,1,1,0.0,0.0
Mike Waltz,stirileprotv.ro,0,0,1,1,0.0,0.0
cosmonaut,stirileprotv.ro,1,0,0,1,1.0,1.0
David,stirileprotv.ro,0,0,1,1,0.0,0.0
condamnat,a1.ro,0,1,0,1,-1.0,1.0
independent,a1.ro,0,0,1,1,0.0,0.0
olimpic,a1.ro,0,1,0,1,-1.0,1.0
Ivanka,a1.ro,0,0,1,1,0.0,0.0
Maryland,a1.ro,0,0,1,1,0.0,0.0
Mezinul,a1.ro,0,0,1,1,0.0,0.0
Potomac,a1.ro,0,0,1,1,0.0,0.0
Volodimir Zelenski,a1.ro,0,1,1,2,-0.5,0.5
Fini,www.mediafax.ro,0,1,0,1,-1.0,1.0
Hașdeu,www.mediafax.ro,0,0,1,1,0.0,0.0
Iar Fini,www.mediafax.ro,0,0,1,1,0.0,0.0
Iorga,www.mediafax.ro,0,0,1,1,0.0,0.0
Iulian,www.mediafax.ro,0,0,1,1,0.0,0.0
Cătălin Tolontan,www.luju.ro,0,1,0,1,-1.0,1.0
Dumitru Dumbravă,www.luju.ro,0,0,1,1,0.0,0.0
Eugen Nicolicea,www.luju.ro,0,1,0,1,-1.0,1.0
Florin Iordache,www.luju.ro,0,1,0,1,-1.0,1.0
Nastase,www.luju.ro,0,1,0,1,-1.0,1.0
Tolontan,www.luju.ro,0,1,0,1,-1.0,1.0
apropiat,www.luju.ro,0,1,0,1,-1.0,1.0
derbedeu,www.luju.ro,0,1,0,1,-1.0,1.0
jurnalista,www.luju.ro,0,0,1,1,0.0,0.0
Valeriu Voineag,www.luju.ro,0,0,1,1,0.0,0.0
emisar,www.luju.ro,0,1,0,1,-1.0,1.0
evazionist,www.luju.ro,0,1,0,1,-1.0,1.0
extremist,www.luju.ro,0,1,0,1,-1.0,1.0
jurnalistă,www.luju.ro,0,0,1,1,0.0,0.0
matusa,www.luju.ro,0,1,0,1,-1.0,1.0
minor,www.luju.ro,0,1,0,1,-1.0,1.0
sustinatoare,www.luju.ro,0,0,1,1,0.0,0.0
traficant,www.luju.ro,0,1,0,1,-1.0,1.0
aleș,adevarul.ro,1,0,0,1,1.0,1.0
consumator,adevarul.ro,1,0,0,1,1.0,1.0
doritor,adevarul.ro,0,1,0,1,-1.0,1.0
mamelor,adevarul.ro,1,0,0,1,1.0,1.0
Petrețchi,www.g4media.ro,0,0,1,1,0.0,0.0
Angeles,www.euronews.ro,0,0,1,1,0.0,0.0
Delaware,www.euronews.ro,0,0,1,1,0.0,0.0
Gabriel Popoviciu,www.euronews.ro,0,0,1,1,0.0,0.0
Hunter Biden,www.euronews.ro,0,1,0,1,-1.0,1.0
Popoviciu,www.euronews.ro,0,0,1,1,0.0,0.0
Puiu Popoviciu,www.euronews.ro,0,0,1,1,0.0,0.0
Wilmington,www.euronews.ro,0,1,0,1,-1.0,1.0
afacerist,www.euronews.ro,0,0,1,1,0.0,0.0
Chrupalla,www.antena3.ro,0,0,1,1,0.0,0.0
copreședinte,www.antena3.ro,0,0,1,1,0.0,0.0
Tino Chrupalla,www.antena3.ro,0,0,1,1,0.0,0.0
Weidel,www.antena3.ro,0,0,1,1,0.0,0.0
bugetari,www.euronews.ro,0,1,1,2,-0.5,0.5
demnitar,www.euronews.ro,0,1,0,1,-1.0,1.0
Bogdan Oprea,a1.ro,0,0,1,1,0.0,0.0
Cristian Petrescu,a1.ro,0,0,1,1,0.0,0.0
Dacianei Sarbu,a1.ro,0,0,1,1,0.0,0.0
Mang,a1.ro,0,0,1,1,0.0,0.0
Le Pen,adevarul.ro,0,0,1,1,0.0,0.0
Macron,adevarul.ro,0,0,1,1,0.0,0.0
Melenchon,adevarul.ro,0,0,1,1,0.0,0.0
macronist,adevarul.ro,0,1,0,1,-1.0,1.0
François Hollande,adevarul.ro,0,0,1,1,0.0,0.0
Antalya,www.digi24.ro,0,0,1,1,0.0,0.0
Bosnia și Herțegovina,www.digi24.ro,0,0,1,1,0.0,0.0
Bangladesh,www.digi24.ro,0,0,1,1,0.0,0.0
Turciei,www.digi24.ro,0,0,1,1,0.0,0.0
Înaltul Reprezentant,www.digi24.ro,0,0,1,1,0.0,0.0
Ana Blandiana,www.g4media.ro,0,0,1,1,0.0,0.0
Liiceanu,www.g4media.ro,0,0,1,1,0.0,0.0
Pleșu,www.g4media.ro,0,0,1,1,0.0,0.0
Petrov,www.g4media.ro,0,1,0,1,-1.0,1.0
bariton,www.g4media.ro,0,0,1,1,0.0,0.0
meșter,www.g4media.ro,0,1,0,1,-1.0,1.0
Antonia,pressone.ro,0,0,1,1,0.0,0.0
Arafat,pressone.ro,0,1,0,1,-1.0,1.0
cruce,pressone.ro,0,0,1,1,0.0,0.0
Danei Budeanu,pressone.ro,0,0,1,1,0.0,0.0
Daniel Gașpar,pressone.ro,0,0,1,1,0.0,0.0
Marius Manole,pressone.ro,0,1,0,1,-1.0,1.0
Mihai Eminescu,pressone.ro,0,0,1,1,0.0,0.0
prietena,pressone.ro,0,1,0,1,-1.0,1.0
enoriaș,pressone.ro,0,1,0,1,-1.0,1.0
Vlad Pârău,pressone.ro,0,1,1,2,-0.5,0.5
habotnic,pressone.ro,0,1,0,1,-1.0,1.0
haiduc,pressone.ro,0,0,1,1,0.0,0.0
hoardă,pressone.ro,0,1,0,1,-1.0,1.0
Breton,primanews.ro,0,0,1,1,0.0,0.0
Musk,primanews.ro,0,1,0,1,-1.0,1.0
Thierry Breton,primanews.ro,0,0,1,1,0.0,0.0
milionar,primanews.ro,0,1,0,1,-1.0,1.0
Belgrad,www.cotidianul.ro,0,0,1,1,0.0,0.0
Răzvan Nicolescu,www.cotidianul.ro,0,1,0,1,-1.0,1.0
căpitan,www.cotidianul.ro,0,0,1,1,0.0,0.0
Harry Kane,www.cotidianul.ro,1,0,0,1,1.0,1.0
Kane,www.cotidianul.ro,0,0,1,1,0.0,0.0
Kylian Mbappe,www.cotidianul.ro,0,0,1,1,0.0,0.0
Serhou Guirassy,www.cotidianul.ro,0,0,1,1,0.0,0.0
marcator,www.cotidianul.ro,0,0,1,1,0.0,0.0
Adrian Papahagi,www.digi24.ro,0,0,1,1,0.0,0.0
Mihai Răzvan Ungureanu,www.digi24.ro,0,0,1,1,0.0,0.0
Sebastian Lăzăroiu,www.digi24.ro,0,0,1,1,0.0,0.0
Mihai Morar,www.comisarul.ro,0,0,1,1,0.0,0.0
Morar,www.comisarul.ro,0,0,1,1,0.0,0.0
realizator,www.comisarul.ro,0,0,1,1,0.0,0.0
individ,www.gandul.ro,0,0,1,1,0.0,0.0
Florin Colceag,snoop.ro,0,0,1,1,0.0,0.0
doamna Șoșoacă,snoop.ro,0,0,1,1,0.0,0.0
domnul Rotariu,snoop.ro,0,0,1,1,0.0,0.0
Snoop Victor Ilie,snoop.ro,0,1,0,1,-1.0,1.0
Austria,www.cotidianul.ro,0,0,2,2,0.0,0.0
Barcelona,www.cotidianul.ro,0,0,1,1,0.0,0.0
Basarabia,www.cotidianul.ro,0,1,0,1,-1.0,1.0
Cipru,www.cotidianul.ro,0,1,0,1,-1.0,1.0
Căușeni,www.cotidianul.ro,0,0,1,1,0.0,0.0
Dublin,www.cotidianul.ro,0,0,1,1,0.0,0.0
Elche,www.cotidianul.ro,0,0,1,1,0.0,0.0
Hâncești,www.cotidianul.ro,0,1,0,1,-1.0,1.0
Ialoveni,www.cotidianul.ro,0,0,1,1,0.0,0.0
Innsbruck,www.cotidianul.ro,0,0,1,1,0.0,0.0
Irlanda,www.cotidianul.ro,0,0,1,1,0.0,0.0
Liverpool,www.cotidianul.ro,0,1,0,1,-1.0,1.0
Palmas de Gran Canaria,www.cotidianul.ro,0,0,1,1,0.0,0.0
Vaslui,www.cotidianul.ro,0,1,0,1,-1.0,1.0
martor,www.cotidianul.ro,0,0,1,1,0.0,0.0
Botoșani,www.antena3.ro,0,0,1,1,0.0,0.0
Lucian Judele,www.antena3.ro,0,0,1,1,0.0,0.0
Piatra Neamț,www.antena3.ro,0,0,1,1,0.0,0.0
administrator public,www.antena3.ro,0,0,1,1,0.0,0.0
trecător,www.antena3.ro,0,1,0,1,-1.0,1.0
voluntar,www.antena3.ro,0,0,1,1,0.0,0.0
penal,stirileprotv.ro,0,1,0,1,-1.0,1.0
Roșia Montane,stirileprotv.ro,0,0,1,1,0.0,0.0
Mihail,snoop.ro,0,0,1,1,0.0,0.0
Cristian Tudor Popescu,www.g4media.ro,0,0,1,1,0.0,0.0
Guvern,www.g4media.ro,0,1,0,1,-1.0,1.0
Zsombor Vajda,www.g4media.ro,0,1,0,1,-1.0,1.0
birocrat,www.g4media.ro,0,1,0,1,-1.0,1.0
jucător,www.g4media.ro,0,0,1,1,0.0,0.0
Cristi Danileț,www.g4media.ro,0,2,0,2,-1.0,1.0
Constantin Ana,recorder.ro,0,0,1,1,0.0,0.0
Cristina Munteanu,www.gandul.ro,0,1,0,1,-1.0,1.0
Dorina Bănișor,www.gandul.ro,0,0,1,1,0.0,0.0
Manuel Vieru,www.gandul.ro,0,0,1,1,0.0,0.0
Manuela Mureșan,www.gandul.ro,0,0,1,1,0.0,0.0
Oliver Păiuși,www.gandul.ro,0,1,0,1,-1.0,1.0
victima,stirileprotv.ro,0,1,0,1,-1.0,1.0
Alex Micsik,agerpres.ro,0,0,1,1,0.0,0.0
Angel Tîlvăr,agerpres.ro,0,0,1,1,0.0,0.0
Barbu,agerpres.ro,0,0,1,1,0.0,0.0
Bogdan Ivan,agerpres.ro,0,0,1,1,0.0,0.0
Burduja,agerpres.ro,0,0,1,1,0.0,0.0
cabinet,agerpres.ro,0,0,1,1,0.0,0.0
Florin Barbu,agerpres.ro,0,0,1,1,0.0,0.0
Natalia Intotero,agerpres.ro,0,0,1,1,0.0,0.0
Radu Tuta,agerpres.ro,0,0,1,1,0.0,0.0
Radu Marinescu,agerpres.ro,0,0,1,1,0.0,0.0
Sorin Grindeanu,agerpres.ro,0,0,1,1,0.0,0.0
Sorin Mihai Grindeanu,agerpres.ro,0,0,1,1,0.0,0.0
Tîlvăr,agerpres.ro,0,0,1,1,0.0,0.0
cu,agerpres.ro,0,0,1,1,0.0,0.0
Adrian Zăbavă,observatornews.ro,0,0,1,1,0.0,0.0
comandant,www.gandul.ro,0,0,1,1,0.0,0.0
Cristian Diaconescu,www.comisarul.ro,0,0,1,1,0.0,0.0
Dina Titus,www.antena3.ro,0,0,1,1,0.0,0.0
Ilhan Omar,www.antena3.ro,0,0,1,1,0.0,0.0
Lloyd Doggett,www.antena3.ro,0,0,1,1,0.0,0.0
Neal Dunn,www.antena3.ro,0,0,1,1,0.0,0.0
Ted Lieu,www.antena3.ro,0,0,1,1,0.0,0.0
Volodimir Zelenski,www.g4media.ro,0,1,1,2,-0.5,0.5
Adrian Anghelescu,primanews.ro,0,0,1,1,0.0,0.0
Lulea,www.luju.ro,0,1,0,1,-1.0,1.0
Marius Lulea,www.luju.ro,0,0,1,1,0.0,0.0
propagandist,www.luju.ro,0,1,0,1,-1.0,1.0
Alexandru Ioan Cuza,adevarul.ro,0,0,1,1,0.0,0.0
Kursk,adevarul.ro,0,0,1,1,0.0,0.0
Lector universitar,adevarul.ro,0,0,1,1,0.0,0.0
George Simon,adevarul.ro,0,1,0,1,-1.0,1.0
dezvoltator,adevarul.ro,0,2,0,2,-1.0,1.0
primăriță,adevarul.ro,0,2,0,2,-1.0,1.0
social,adevarul.ro,0,0,1,1,0.0,0.0
D. Berciu,www.comisarul.ro,0,0,1,1,0.0,0.0
purtător,www.comisarul.ro,0,1,0,1,-1.0,1.0
Bacău,www.activenews.ro,0,0,1,1,0.0,0.0
Botoșani,www.activenews.ro,0,0,1,1,0.0,0.0
Iași,www.activenews.ro,0,0,1,1,0.0,0.0
Neamț,www.activenews.ro,0,1,0,1,-1.0,1.0
Piatra Neamț,www.activenews.ro,0,0,1,1,0.0,0.0
Sfântul Andrei,www.activenews.ro,0,0,1,1,0.0,0.0
conațional,www.activenews.ro,0,0,1,1,0.0,0.0
politruc,www.activenews.ro,0,2,0,2,-1.0,1.0
regim,www.activenews.ro,0,1,0,1,-1.0,1.0
reprezentantă,www.activenews.ro,0,1,0,1,-1.0,1.0
Țării Românești,www.activenews.ro,0,0,1,1,0.0,0.0
Cirprian Ciucu,www.digi24.ro,0,0,1,1,0.0,0.0
Florentin Pandele,observatornews.ro,0,0,1,1,0.0,0.0
Hubert Thuma,observatornews.ro,0,0,1,1,0.0,0.0
Intotero,observatornews.ro,0,0,1,1,0.0,0.0
Simona Bucura-Oprescu,observatornews.ro,0,0,1,1,0.0,0.0
soț,observatornews.ro,0,0,1,1,0.0,0.0
Mihai Zmenta,www.news.ro,0,1,0,1,-1.0,1.0
Trădătorul de,www.news.ro,0,1,0,1,-1.0,1.0
vlogger,www.news.ro,0,1,1,2,-0.5,0.5
Fritz,stirileprotv.ro,0,0,1,1,0.0,0.0
Călin Giorcescu,pressone.ro,0,1,0,1,-1.0,1.0
Eduard Vinatoru Simion,pressone.ro,0,0,1,1,0.0,0.0
Führer,pressone.ro,0,1,0,1,-1.0,1.0
Gheorghiu,pressone.ro,0,1,0,1,-1.0,1.0
Hrebenciuc,pressone.ro,0,1,0,1,-1.0,1.0
Izvorani,pressone.ro,0,0,1,1,0.0,0.0
Mussolini,pressone.ro,0,0,1,1,0.0,0.0
Unora,pressone.ro,0,1,0,1,-1.0,1.0
plângăcios,pressone.ro,0,1,0,1,-1.0,1.0
Ștefan Gheorghiu,pressone.ro,0,1,0,1,-1.0,1.0
Caesar Kunikov,www.aktual24.ro,0,0,1,1,0.0,0.0
Sergey Kotov,www.aktual24.ro,0,0,1,1,0.0,0.0
Alexandru Petrescu,pressone.ro,0,0,1,1,0.0,0.0
Augustin Jianu,pressone.ro,0,0,1,1,0.0,0.0
Marius Nica,pressone.ro,0,0,1,1,0.0,0.0
consilier prezidențial,www.digi24.ro,0,0,1,1,0.0,0.0
Ștefan Popescu,www.gandul.ro,0,0,1,1,0.0,0.0
Brazilia,www.cotidianul.ro,0,0,1,1,0.0,0.0
a,www.cotidianul.ro,0,1,0,1,-1.0,1.0
Adrian Pițigoi,recorder.ro,0,0,1,1,0.0,0.0
Alexandru Iacobescu,recorder.ro,0,1,0,1,-1.0,1.0
Alexandru Nazare,recorder.ro,0,0,1,1,0.0,0.0
Alvin Toeffler,recorder.ro,0,0,1,1,0.0,0.0
Aurel Oprinoiu,recorder.ro,0,0,1,1,0.0,0.0
Bob Woodward,recorder.ro,0,0,1,1,0.0,0.0
Bogdan Toader,recorder.ro,0,0,1,1,0.0,0.0
Catherine Merridale,recorder.ro,0,0,1,1,0.0,0.0
Ci,recorder.ro,0,0,1,1,0.0,0.0
Codruța Kovesi,recorder.ro,0,0,1,1,0.0,0.0
Câmpina,recorder.ro,0,1,0,1,-1.0,1.0
Cécile Vigour,recorder.ro,0,0,1,1,0.0,0.0
Daniel David,recorder.ro,0,0,1,1,0.0,0.0
George Ionescu,recorder.ro,0,0,1,1,0.0,0.0
Gijs van Hensbergen,recorder.ro,0,0,1,1,0.0,0.0
Grațiela Gavrilescu,recorder.ro,0,0,1,1,0.0,0.0
Andrei Răzvan Lupu,recorder.ro,0,0,1,1,0.0,0.0
Margaret MacMillan,recorder.ro,0,0,1,1,0.0,0.0
Mircea Roșca,recorder.ro,0,0,1,1,0.0,0.0
Narcis Cătălin Beciu,recorder.ro,0,0,1,1,0.0,0.0
Rifkin,recorder.ro,0,0,1,1,0.0,0.0
Robert Kaplan,recorder.ro,0,0,1,1,0.0,0.0
Roberta Anastase,recorder.ro,0,0,1,1,0.0,0.0
Răzvan Prișcă,recorder.ro,0,0,1,1,0.0,0.0
Simona Maya Teodoroiu,recorder.ro,0,0,1,1,0.0,0.0
Cosma,recorder.ro,0,1,0,1,-1.0,1.0
grefier,recorder.ro,1,0,0,1,1.0,1.0
haștag,recorder.ro,0,1,0,1,-1.0,1.0
legiuitor,recorder.ro,0,1,0,1,-1.0,1.0
lăcătuș,recorder.ro,0,1,0,1,-1.0,1.0
pan,recorder.ro,0,0,1,1,0.0,0.0
sudor,recorder.ro,0,1,0,1,-1.0,1.0
Claudiu Palaz,stirileprotv.ro,0,0,2,2,0.0,0.0
Palaz,stirileprotv.ro,0,1,0,1,-1.0,1.0
inițiator,observatornews.ro,0,0,1,1,0.0,0.0
rezident,observatornews.ro,1,0,0,1,1.0,1.0
Simonis,www.romaniatv.net,0,0,1,1,0.0,0.0
Ferdinand Nagy,www.news.ro,1,0,1,2,0.5,0.5
Ion Mincu,www.news.ro,0,0,1,1,0.0,0.0
Janina Sitaru,www.news.ro,0,0,2,2,0.0,0.0
Kansai,www.news.ro,0,0,1,1,0.0,0.0
Osaka,www.news.ro,0,0,1,1,0.0,0.0
Ovidiu Raețchi,www.news.ro,1,0,1,2,0.5,0.5
Regatul Unit al Marii Britanii și Irlandei de Nord,www.news.ro,0,0,1,1,0.0,0.0
Regatul Țărilor de Jos,www.news.ro,0,0,1,1,0.0,0.0
înalt,www.news.ro,0,0,1,1,0.0,0.0
angajator,www.euronews.ro,0,1,0,1,-1.0,1.0
Maica Domnului,www.euronews.ro,0,0,1,1,0.0,0.0
salariați,www.euronews.ro,0,0,1,1,0.0,0.0
Sfântul Andrei,www.euronews.ro,0,0,1,1,0.0,0.0
Sfântul Ioan Botezătorul,www.euronews.ro,0,0,1,1,0.0,0.0
Alex Jones,www.gandul.ro,0,1,0,1,-1.0,1.0
Tucker Carlson,www.gandul.ro,0,0,1,1,0.0,0.0
federație,www.antena3.ro,0,0,1,1,0.0,0.0
exponent,www.antena3.ro,0,1,0,1,-1.0,1.0
finanțator,www.antena3.ro,0,0,1,1,0.0,0.0
Alin Borcan,recorder.ro,0,0,1,1,0.0,0.0
Clienți,recorder.ro,0,1,0,1,-1.0,1.0
Predoiu,recorder.ro,0,0,1,1,0.0,0.0
Silviu Predoiu,recorder.ro,0,0,1,1,0.0,0.0
Suedia,recorder.ro,0,0,1,1,0.0,0.0
Virgil Zidaru,recorder.ro,0,0,1,1,0.0,0.0
curier,recorder.ro,0,0,1,1,0.0,0.0
Davos,www.comisarul.ro,0,0,1,1,0.0,0.0
Ion Rațiu,www.comisarul.ro,0,0,1,1,0.0,0.0
Nicolae,www.comisarul.ro,0,0,1,1,0.0,0.0
Nicolae Rațiu,www.comisarul.ro,0,0,1,1,0.0,0.0
Rațiu,www.comisarul.ro,0,0,1,1,0.0,0.0
afacere,www.comisarul.ro,1,0,0,1,1.0,1.0
filantrop,www.comisarul.ro,1,0,0,1,1.0,1.0
Marcel Ion Vela,www.realitatea.net,0,0,1,1,0.0,0.0
Argeș,www.romaniatv.net,0,0,1,1,0.0,0.0
Australia,www.romaniatv.net,0,0,1,1,0.0,0.0
Caraș,www.romaniatv.net,0,0,1,1,0.0,0.0
Columbia,www.romaniatv.net,0,0,1,1,0.0,0.0
Covasna,www.romaniatv.net,0,0,1,1,0.0,0.0
Călărași,www.romaniatv.net,0,0,1,1,0.0,0.0
Gorj,www.romaniatv.net,0,0,1,1,0.0,0.0
Harghita,www.romaniatv.net,0,0,1,1,0.0,0.0
Maramureș,www.romaniatv.net,0,0,1,1,0.0,0.0
Mureș,www.romaniatv.net,0,0,1,1,0.0,0.0
Neamț,www.romaniatv.net,0,0,1,1,0.0,0.0
Peru,www.romaniatv.net,0,0,1,1,0.0,0.0
Severin,www.romaniatv.net,0,0,1,1,0.0,0.0
Sălaj,www.romaniatv.net,0,0,1,1,0.0,0.0
Vrancea,www.romaniatv.net,0,0,1,1,0.0,0.0
Vâlcea,www.romaniatv.net,0,0,1,1,0.0,0.0
Oarba de Mureș,www.antena3.ro,0,0,1,1,0.0,0.0
erou,www.antena3.ro,1,0,0,1,1.0,1.0
Gheorghe Avramescu,www.antena3.ro,0,0,1,1,0.0,0.0
Horia Ivanovici,www.romaniatv.net,1,0,0,1,1.0,1.0
Ivanovici,www.romaniatv.net,0,0,1,1,0.0,0.0
Catana,www.aktual24.ro,0,0,1,1,0.0,0.0
Constante,www.aktual24.ro,0,0,1,1,0.0,0.0
Dumitru Ioniță,www.aktual24.ro,0,1,0,1,-1.0,1.0
Felix,www.aktual24.ro,0,0,1,1,0.0,0.0
Io,www.aktual24.ro,0,0,1,1,0.0,0.0
Marina,www.aktual24.ro,0,0,1,1,0.0,0.0
Teodorescu Mihai,www.aktual24.ro,0,0,1,1,0.0,0.0
io,www.aktual24.ro,0,0,1,1,0.0,0.0
…,www.aktual24.ro,0,0,1,1,0.0,0.0
Dan Marian,a1.ro,0,0,1,1,0.0,0.0
Alexandru,pressone.ro,0,0,1,1,0.0,0.0
Alexandru Steriu,pressone.ro,0,0,1,1,0.0,0.0
Corneliu Dobrițoiu,pressone.ro,0,1,0,1,-1.0,1.0
Florescu,pressone.ro,0,0,1,1,0.0,0.0
Ilie Sârbu,pressone.ro,0,1,0,1,-1.0,1.0
Ioan Steriu,pressone.ro,0,0,2,2,0.0,0.0
Marin Anton,pressone.ro,0,1,0,1,-1.0,1.0
Mihail Florescu,pressone.ro,0,0,1,1,0.0,0.0
Mitrache,pressone.ro,0,0,1,1,0.0,0.0
Nil Girad,pressone.ro,0,0,1,1,0.0,0.0
Simona,pressone.ro,0,0,1,1,0.0,0.0
Simona Steriu,pressone.ro,0,0,1,1,0.0,0.0
Steriu,pressone.ro,0,1,1,2,-0.5,0.5
Steriu Ioan,pressone.ro,0,0,1,1,0.0,0.0
Steriu Rodica,pressone.ro,0,0,1,1,0.0,0.0
Valeriu,pressone.ro,0,0,1,1,0.0,0.0
Valeriu Steriu,pressone.ro,0,0,1,1,0.0,0.0
Oktavian Weiser,pressone.ro,0,0,1,1,0.0,0.0
cadru militar,pressone.ro,0,0,1,1,0.0,0.0
familia Steriu,pressone.ro,0,1,0,1,-1.0,1.0
ministru consilier,pressone.ro,0,0,1,1,0.0,0.0
secretar general adjunct,pressone.ro,0,0,1,1,0.0,0.0
sublocotenent,pressone.ro,0,0,1,1,0.0,0.0
Ștefan Mitrache,pressone.ro,0,0,1,1,0.0,0.0
Cîrstoiu,www.romaniatv.net,0,0,1,1,0.0,0.0
George Tuță,www.romaniatv.net,0,0,1,1,0.0,0.0
Cârstoiu,www.romaniatv.net,0,0,1,1,0.0,0.0
Cătălin Cârstoiu,www.romaniatv.net,0,0,2,2,0.0,0.0
Monica Cîrstoiu,www.romaniatv.net,0,0,1,1,0.0,0.0
Ion Mihalache,primanews.ro,0,0,1,1,0.0,0.0
Iuliu Maniu,primanews.ro,1,0,0,1,1.0,1.0
Sighetul Marmației,primanews.ro,0,0,1,1,0.0,0.0
promotor,primanews.ro,1,0,0,1,1.0,1.0
Albuquerque,www.digi24.ro,0,0,1,1,0.0,0.0
Andris Sprūds,www.digi24.ro,0,0,1,1,0.0,0.0
Apostolos Tzitzikostas,www.digi24.ro,0,0,1,1,0.0,0.0
Atena,www.digi24.ro,0,0,1,1,0.0,0.0
Breton,www.digi24.ro,0,0,1,1,0.0,0.0
Budapestei,www.digi24.ro,0,1,0,1,-1.0,1.0
Carlos Moedas,www.digi24.ro,0,0,1,1,0.0,0.0
Cecilia Malmström,www.digi24.ro,0,0,1,1,0.0,0.0
Christophe Hansen,www.digi24.ro,0,0,1,1,0.0,0.0
Cipru,www.digi24.ro,0,0,1,1,0.0,0.0
Costas Kadis,www.digi24.ro,0,0,2,2,0.0,0.0
Dan Jørgensen,www.digi24.ro,0,0,1,1,0.0,0.0
Danemarca,www.digi24.ro,0,0,1,1,0.0,0.0
Dombrovskis,www.digi24.ro,0,0,1,1,0.0,0.0
Donald Tusk,www.digi24.ro,0,0,1,1,0.0,0.0
Ekaterina Zaharieva,www.digi24.ro,0,0,1,1,0.0,0.0
Finlanda,www.digi24.ro,0,0,1,1,0.0,0.0
Frans Timmermans,www.digi24.ro,0,0,1,1,0.0,0.0
Giorgia Meloni,www.digi24.ro,0,0,1,1,0.0,0.0
Hansen,www.digi24.ro,0,0,1,1,0.0,0.0
Henna Virkkunen,www.digi24.ro,0,0,1,1,0.0,0.0
Hennei Virkkunen,www.digi24.ro,1,0,0,1,1.0,1.0
Hoekstra,www.digi24.ro,0,0,1,1,0.0,0.0
Irlanda,www.digi24.ro,0,0,1,1,0.0,0.0
Janusz Wojciechowski,www.digi24.ro,0,1,0,1,-1.0,1.0
Jessika Roswall,www.digi24.ro,0,0,1,1,0.0,0.0
Jozef Síkela,www.digi24.ro,0,0,1,1,0.0,0.0
Julian Popov,www.digi24.ro,0,0,1,1,0.0,0.0
Kadis,www.digi24.ro,0,0,1,1,0.0,0.0
Kyriakos Mitsotakis,www.digi24.ro,0,0,1,1,0.0,0.0
Macedonia,www.digi24.ro,0,0,1,1,0.0,0.0
Magnus Brunner,www.digi24.ro,0,0,1,1,0.0,0.0
Maria Luís Albuquerque,www.digi24.ro,0,0,1,1,0.0,0.0
Martine Hansen,www.digi24.ro,0,0,1,1,0.0,0.0
Michael McGrath,www.digi24.ro,0,0,1,1,0.0,0.0
Olivér Várhelyi,www.digi24.ro,0,1,0,1,-1.0,1.0
Phil Hogan,www.digi24.ro,0,1,0,1,-1.0,1.0
Piotr Serafin,www.digi24.ro,0,0,1,1,0.0,0.0
Popov,www.digi24.ro,0,1,0,1,-1.0,1.0
Portugalia,www.digi24.ro,0,0,1,1,0.0,0.0
Radosław Sikorski,www.digi24.ro,0,0,1,1,0.0,0.0
Raffaele Fitto,www.digi24.ro,0,0,1,1,0.0,0.0
Republica Cehă,www.digi24.ro,0,0,1,1,0.0,0.0
Roswall,www.digi24.ro,0,0,1,1,0.0,0.0
Roxana Mînzatu,www.digi24.ro,0,0,2,2,0.0,0.0
Sikela,www.digi24.ro,1,0,0,1,1.0,1.0
Stockholm,www.digi24.ro,0,0,2,2,0.0,0.0
Suedia,www.digi24.ro,0,0,1,1,0.0,0.0
Teresa Ribera,www.digi24.ro,1,0,0,1,1.0,1.0
Thierry Breton,www.digi24.ro,0,0,1,1,0.0,0.0
Tomaž Vesel,www.digi24.ro,0,0,1,1,0.0,0.0
Valdis Dombrovskis,www.digi24.ro,0,0,2,2,0.0,0.0
Vesel,www.digi24.ro,0,0,1,1,0.0,0.0
Virkkunen,www.digi24.ro,1,0,0,1,1.0,1.0
Von der Leyen,www.digi24.ro,0,0,1,1,0.0,0.0
Várhelyi,www.digi24.ro,0,1,0,1,-1.0,1.0
Wopke Hoekstra,www.digi24.ro,0,0,1,1,0.0,0.0
atacant,www.digi24.ro,0,1,0,1,-1.0,1.0
der Leyen,www.digi24.ro,0,0,1,1,0.0,0.0
verișoară,www.digi24.ro,0,0,1,1,0.0,0.0
von der Leyen,www.digi24.ro,0,0,1,1,0.0,0.0
Țările de Jos,www.digi24.ro,0,0,1,1,0.0,0.0
ales,agerpres.ro,0,1,0,1,-1.0,1.0
Hunor,www.cotidianul.ro,0,0,1,1,0.0,0.0
Theodor Paleologu,www.cotidianul.ro,0,0,1,1,0.0,0.0
Diana Morar,www.g4media.ro,0,0,1,1,0.0,0.0
Doina Macarie,www.g4media.ro,0,0,1,1,0.0,0.0
Gheorghe Scuturici,www.g4media.ro,0,0,1,1,0.0,0.0
Ioan Turc,www.g4media.ro,0,0,1,1,0.0,0.0
Năsăud,www.g4media.ro,0,0,1,1,0.0,0.0
Scuturici,www.g4media.ro,0,0,1,1,0.0,0.0
Turc,www.g4media.ro,0,0,1,1,0.0,0.0
Călin Gergescu,www.aktual24.ro,0,0,1,1,0.0,0.0
bodiguarz,www.aktual24.ro,0,1,0,1,-1.0,1.0
Ceușescu,www.gandul.ro,0,1,0,1,-1.0,1.0
erou,www.gandul.ro,1,0,0,1,1.0,1.0
Doamna Udrea,adevarul.ro,0,0,1,1,0.0,0.0
Dvs,adevarul.ro,0,0,1,1,0.0,0.0
Iisus,adevarul.ro,0,1,0,1,-1.0,1.0
Iohanis,adevarul.ro,0,1,0,1,-1.0,1.0
Baconschi,adevarul.ro,0,1,0,1,-1.0,1.0
majoritate,adevarul.ro,0,1,0,1,-1.0,1.0
prezidentabil,adevarul.ro,0,0,1,1,0.0,0.0
Stelian Ion,www.g4media.ro,0,1,1,2,-0.5,0.5
Alun,snoop.ro,0,0,1,1,0.0,0.0
bătrână,snoop.ro,0,1,0,1,-1.0,1.0
Bătrâna Altfel,snoop.ro,0,1,0,1,-1.0,1.0
Bătrânei,snoop.ro,0,1,0,1,-1.0,1.0
Cornel Moldovan,snoop.ro,0,0,1,1,0.0,0.0
Drăgan Muntean,snoop.ro,1,0,0,1,1.0,1.0
Fața Roșie,snoop.ro,0,0,1,1,0.0,0.0
Piatra,snoop.ro,0,0,1,1,0.0,0.0
Poienița Voinii,snoop.ro,1,0,0,1,1.0,1.0
Roșcani,snoop.ro,0,0,1,1,0.0,0.0
Răchițaua,snoop.ro,0,0,1,1,0.0,0.0
tineret,snoop.ro,1,0,0,1,1.0,1.0
pădurar,snoop.ro,0,0,1,1,0.0,0.0
aniversare,www.gandul.ro,0,0,1,1,0.0,0.0
sărbătoare,www.gandul.ro,0,0,1,1,0.0,0.0
Marina Filimon,www.b1tv.ro,0,0,1,1,0.0,0.0
dans,www.euronews.ro,0,0,1,1,0.0,0.0
Mihai Moșteanu,www.euronews.ro,0,0,1,1,0.0,0.0
olimpic,www.euronews.ro,0,0,1,1,0.0,0.0
protector,www.euronews.ro,0,1,0,1,-1.0,1.0
Adrian Mititelu,adevarul.ro,0,0,1,1,0.0,0.0
nou,adevarul.ro,0,0,1,1,0.0,0.0
Olguța Vasilescu,adevarul.ro,0,1,0,1,-1.0,1.0
Radu Marinescu,adevarul.ro,0,0,1,1,0.0,0.0
redactor,adevarul.ro,0,0,1,1,0.0,0.0
Chiril Gaburici,www.digi24.ro,0,0,1,1,0.0,0.0
Leancă,www.digi24.ro,0,1,0,1,-1.0,1.0
Petro Poroșenko,www.digi24.ro,0,0,1,1,0.0,0.0
personal medical,www.digi24.ro,0,0,1,1,0.0,0.0
colecționar,recorder.ro,0,2,0,2,-1.0,1.0
Mark Rutte,recorder.ro,0,0,1,1,0.0,0.0
Slănic Prahova,recorder.ro,0,1,0,1,-1.0,1.0
sovietic,recorder.ro,0,1,0,1,-1.0,1.0
Ioana Ene Dogioiu,recorder.ro,0,0,1,1,0.0,0.0
Hârlău,www.romaniatv.net,0,0,1,1,0.0,0.0
Marius Budăi,www.romaniatv.net,0,0,1,1,0.0,0.0
naiv,recorder.ro,0,1,0,1,-1.0,1.0
Zgonea,recorder.ro,0,1,0,1,-1.0,1.0
slugă,recorder.ro,0,1,0,1,-1.0,1.0
descreierat,www.mediafax.ro,0,1,0,1,-1.0,1.0
guvernant,www.mediafax.ro,0,1,0,1,-1.0,1.0
gardă,www.news.ro,0,0,1,1,0.0,0.0
Andrei Caramitru,www.realitatea.net,0,2,0,2,-1.0,1.0
Caramitru,www.realitatea.net,0,1,0,1,-1.0,1.0
economist,www.realitatea.net,0,1,1,2,-0.5,0.5
contestatar,www.realitatea.net,0,1,0,1,-1.0,1.0
gladiator,www.realitatea.net,0,0,1,1,0.0,0.0
muncitor,www.realitatea.net,0,1,0,1,-1.0,1.0
Valeriu Stoica,www.romaniatv.net,0,0,1,1,0.0,0.0
dumnealor,www.romaniatv.net,0,1,0,1,-1.0,1.0
Bogdan Rodeanu,www.news.ro,0,1,0,1,-1.0,1.0
Diana Buzoianu,www.news.ro,0,0,1,1,0.0,0.0
Tulcea,www.news.ro,0,0,1,1,0.0,0.0
izolaționist,www.news.ro,0,1,0,1,-1.0,1.0
responsabil,www.news.ro,0,1,0,1,-1.0,1.0
Negrescu,www.mediafax.ro,0,0,1,1,0.0,0.0
Victor Negrescu,www.mediafax.ro,0,0,1,1,0.0,0.0
patruped,www.euronews.ro,0,0,1,1,0.0,0.0
cățel,www.euronews.ro,1,0,0,1,1.0,1.0
bărbat,www.b1tv.ro,1,0,0,1,1.0,1.0
Costache,www.b1tv.ro,0,0,1,1,0.0,0.0
turnător,www.b1tv.ro,0,1,0,1,-1.0,1.0
Ștefan Costache,www.b1tv.ro,0,0,1,1,0.0,0.0
Emiratele Arabe Unite,recorder.ro,0,0,1,1,0.0,0.0
Immanuel Kant,recorder.ro,0,0,1,1,0.0,0.0
Scholz,recorder.ro,0,0,1,1,0.0,0.0
Seul,recorder.ro,0,0,1,1,0.0,0.0
Cătălin Hideg,www.romaniatv.net,0,0,1,1,0.0,0.0
Finii,www.romaniatv.net,0,1,0,1,-1.0,1.0
Ilinca,www.romaniatv.net,0,0,2,2,0.0,0.0
Ilinca Simion,www.romaniatv.net,0,0,1,1,0.0,0.0
Ilinica,www.romaniatv.net,0,0,1,1,0.0,0.0
Ioan Korpoș,www.romaniatv.net,0,0,1,1,0.0,0.0
Radu,www.romaniatv.net,0,0,1,1,0.0,0.0
Răducu,www.romaniatv.net,0,0,2,2,0.0,0.0
agent,www.romaniatv.net,0,1,1,2,-0.5,0.5
băiețel,www.romaniatv.net,0,0,1,1,0.0,0.0
familia Simion,www.romaniatv.net,1,0,0,1,1.0,1.0
gazdă,www.romaniatv.net,0,1,0,1,-1.0,1.0
musafir,www.romaniatv.net,1,0,0,1,1.0,1.0
protagonist,www.romaniatv.net,0,0,1,1,0.0,0.0
Reporterul Ioan Korpos,www.romaniatv.net,0,0,1,1,0.0,0.0
telespectator,www.romaniatv.net,0,0,1,1,0.0,0.0
Imperiul țarist,www.news.ro,0,1,0,1,-1.0,1.0
Uniunea Sovietică,www.news.ro,0,1,0,1,-1.0,1.0
dumnealui,www.news.ro,0,0,1,1,0.0,0.0
Alexandru Popa,pressone.ro,0,1,0,1,-1.0,1.0
Biro Attila,pressone.ro,0,0,1,1,0.0,0.0
Cireș,pressone.ro,0,0,1,1,0.0,0.0
Crușoveanu,pressone.ro,0,1,0,1,-1.0,1.0
Crâmpoia,pressone.ro,0,1,0,1,-1.0,1.0
Diana Morar,pressone.ro,0,0,1,1,0.0,0.0
Diana Mora,pressone.ro,0,1,0,1,-1.0,1.0
Dragoș Alexandru,pressone.ro,0,0,1,1,0.0,0.0
Dragoș,pressone.ro,0,0,1,1,0.0,0.0
Pauliuc,pressone.ro,0,0,2,2,0.0,0.0
Floarea Salcâmului,pressone.ro,0,0,1,1,0.0,0.0
Făure,pressone.ro,0,0,1,1,0.0,0.0
George Scarlat,pressone.ro,0,0,1,1,0.0,0.0
Gornești,pressone.ro,0,0,1,1,0.0,0.0
Huși,pressone.ro,0,1,0,1,-1.0,1.0
Ion,pressone.ro,0,1,0,1,-1.0,1.0
Ionel Mirea,pressone.ro,0,1,0,1,-1.0,1.0
Karoly Kolcsar,pressone.ro,0,1,0,1,-1.0,1.0
Kolcsar,pressone.ro,0,1,0,1,-1.0,1.0
Liești,pressone.ro,0,0,1,1,0.0,0.0
Marian Crușoveanu,pressone.ro,0,1,0,1,-1.0,1.0
Maricel,pressone.ro,0,0,1,1,0.0,0.0
Maricel Scarlat,pressone.ro,0,1,0,1,-1.0,1.0
Nordis Crușoveanu,pressone.ro,0,0,1,1,0.0,0.0
Romică Lorenț,pressone.ro,0,1,0,1,-1.0,1.0
Scarlat,pressone.ro,0,1,0,1,-1.0,1.0
Soții Mirea,pressone.ro,0,0,1,1,0.0,0.0
Soții Pauliuc,pressone.ro,0,1,0,1,-1.0,1.0
Tulucești,pressone.ro,0,0,1,1,0.0,0.0
Viorel Pauliuc,pressone.ro,0,0,1,1,0.0,0.0
familia Iordache,pressone.ro,0,1,0,1,-1.0,1.0
Mirea,pressone.ro,0,0,1,1,0.0,0.0
preșcolar,pressone.ro,0,0,1,1,0.0,0.0
vicelider,pressone.ro,0,0,1,1,0.0,0.0
Ștefan Doru Șandru,pressone.ro,0,1,0,1,-1.0,1.0
Burduja,www.realitatea.net,0,0,1,1,0.0,0.0
Claudiu Năsui,www.cotidianul.ro,0,0,1,1,0.0,0.0
Friedrich Merz,www.cotidianul.ro,0,0,1,1,0.0,0.0
George Siomion,www.cotidianul.ro,0,0,1,1,0.0,0.0
Giorgia Meloni,www.cotidianul.ro,0,0,1,1,0.0,0.0
Giorgio Meloni,www.cotidianul.ro,0,1,0,1,-1.0,1.0
Mario Monti,www.cotidianul.ro,0,0,1,1,0.0,0.0
Meloni,www.cotidianul.ro,0,1,1,2,-0.5,0.5
Oana Lungescu,www.cotidianul.ro,0,1,0,1,-1.0,1.0
Premierul Meloni,www.cotidianul.ro,0,1,0,1,-1.0,1.0
Renk,www.cotidianul.ro,0,0,1,1,0.0,0.0
Roma,www.cotidianul.ro,0,0,1,1,0.0,0.0
saint,www.cotidianul.ro,0,0,1,1,0.0,0.0
Tismăneanu,www.cotidianul.ro,0,0,1,1,0.0,0.0
Transilvania,www.cotidianul.ro,0,1,0,1,-1.0,1.0
Vladimir Tismăneanu,www.cotidianul.ro,0,0,1,1,0.0,0.0
Olaf Scholz,www.cotidianul.ro,0,0,1,1,0.0,0.0
cancelar,www.cotidianul.ro,0,0,1,1,0.0,0.0
Thierry Breton,www.cotidianul.ro,0,1,0,1,-1.0,1.0
purtătoare de cuvânt,www.cotidianul.ro,0,1,0,1,-1.0,1.0
Barcelona,primanews.ro,1,0,0,1,1.0,1.0
Lamine Yamal,primanews.ro,0,0,1,1,0.0,0.0
Renate Weber,www.euronews.ro,0,0,1,1,0.0,0.0
avocatul Poporului,www.euronews.ro,0,0,1,1,0.0,0.0
cabinet,www.euronews.ro,0,1,0,1,-1.0,1.0
Berlusconi,adevarul.ro,0,1,0,1,-1.0,1.0
Doamne,adevarul.ro,1,0,0,1,1.0,1.0
Gigii Becali,adevarul.ro,1,0,0,1,1.0,1.0
Iordanescu,adevarul.ro,0,0,1,1,0.0,0.0
Silvio Berlusconi,adevarul.ro,0,1,0,1,-1.0,1.0
io,adevarul.ro,1,0,0,1,1.0,1.0
cântăreț,www.b1tv.ro,0,0,1,1,0.0,0.0
independent,www.b1tv.ro,0,0,1,1,0.0,0.0
penal,www.b1tv.ro,0,1,0,1,-1.0,1.0
traseiști,www.b1tv.ro,0,1,0,1,-1.0,1.0
Elena,www.news.ro,0,1,0,1,-1.0,1.0
dâns,www.news.ro,0,1,0,1,-1.0,1.0
Abrudean,www.gandul.ro,0,0,1,1,0.0,0.0
Mircea Abrudean,www.gandul.ro,0,0,1,1,0.0,0.0
Nicolae Ciuca,www.aktual24.ro,1,0,0,1,1.0,1.0
Caramitru,snoop.ro,0,0,1,1,0.0,0.0
Florian Neagu,snoop.ro,0,0,1,1,0.0,0.0
Gheorghe,snoop.ro,0,0,1,1,0.0,0.0
Gheorghe Gabriel Gheorghe,snoop.ro,0,0,2,2,0.0,0.0
Stelian Caramitru,snoop.ro,0,0,2,2,0.0,0.0
colectiv,snoop.ro,0,1,0,1,-1.0,1.0
cunoștință,snoop.ro,0,1,0,1,-1.0,1.0
juriști,snoop.ro,0,0,1,1,0.0,0.0
parior,snoop.ro,0,2,1,3,-0.6666666666666666,0.6666666666666666
respectiv,snoop.ro,0,0,1,1,0.0,0.0
Coldea,www.romaniatv.net,0,1,0,1,-1.0,1.0
necunoscut,www.romaniatv.net,0,1,0,1,-1.0,1.0
Ceaușescu,www.mediafax.ro,0,1,0,1,-1.0,1.0
doctor,www.mediafax.ro,0,0,1,1,0.0,0.0
Geneva,www.mediafax.ro,0,0,1,1,0.0,0.0
Jilava,www.mediafax.ro,0,1,0,1,-1.0,1.0
Stoenești,www.mediafax.ro,0,0,1,1,0.0,0.0
Antonucci,www.aktual24.ro,0,1,0,1,-1.0,1.0
California,www.aktual24.ro,0,0,1,1,0.0,0.0
Carlos Guevara,www.aktual24.ro,0,0,1,1,0.0,0.0
Carolina de Sud,www.aktual24.ro,0,0,1,1,0.0,0.0
Melnyk,www.aktual24.ro,0,1,1,2,-0.5,0.5
Florida,www.aktual24.ro,0,0,1,1,0.0,0.0
Gabriel Antonucci,www.aktual24.ro,0,0,1,1,0.0,0.0
Guevara,www.aktual24.ro,0,0,1,1,0.0,0.0
Henderson,www.aktual24.ro,0,0,1,1,0.0,0.0
Matthew Spencer,www.aktual24.ro,0,0,1,1,0.0,0.0
Minnesota,www.aktual24.ro,0,0,1,1,0.0,0.0
Rahsaan Henderson,www.aktual24.ro,0,0,1,1,0.0,0.0
Stephanie Melnyk,www.aktual24.ro,0,0,1,1,0.0,0.0
Tanner Bergstrom,www.aktual24.ro,0,0,1,1,0.0,0.0
Tennessee,www.aktual24.ro,0,0,1,1,0.0,0.0
Texas,www.aktual24.ro,0,0,1,1,0.0,0.0
pensionar,www.gandul.ro,1,0,0,1,1.0,1.0
Eduard Hellvig,www.gandul.ro,0,0,1,1,0.0,0.0
Florin Cițu,www.gandul.ro,0,0,1,1,0.0,0.0
Costoiu,www.g4media.ro,0,0,1,1,0.0,0.0
Craiovei,www.g4media.ro,0,0,1,1,0.0,0.0
Biden,www.romaniatv.net,0,1,0,1,-1.0,1.0
Joe Biden,www.romaniatv.net,0,1,0,1,-1.0,1.0
Turciei,www.romaniatv.net,0,0,1,1,0.0,0.0
Varanu,www.romaniatv.net,0,1,0,1,-1.0,1.0
bolnav,www.romaniatv.net,0,1,0,1,-1.0,1.0
Despescu,www.romaniatv.net,0,1,0,1,-1.0,1.0
interlocutor,www.romaniatv.net,0,0,1,1,0.0,0.0
Georgian Pop,www.digi24.ro,0,0,1,1,0.0,0.0
Anamaria,a1.ro,0,0,1,1,0.0,0.0
Anamaria Prodan,a1.ro,0,0,1,1,0.0,0.0
Ionela Prodan,a1.ro,0,0,1,1,0.0,0.0
Laurențiu Reghecampf,a1.ro,0,1,0,1,-1.0,1.0
Reghecampf,a1.ro,0,1,0,1,-1.0,1.0
Toni Antohi,a1.ro,0,0,1,1,0.0,0.0
impresară,a1.ro,0,1,0,1,-1.0,1.0
Cătălin Georgescu,www.aktual24.ro,0,0,1,1,0.0,0.0
Clotilde Armand,www.aktual24.ro,0,2,0,2,-1.0,1.0
Elena,www.aktual24.ro,0,1,0,1,-1.0,1.0
Elene,www.aktual24.ro,0,0,1,1,0.0,0.0
Secretar General,www.aktual24.ro,0,1,0,1,-1.0,1.0
Vlad Voiculescu,www.aktual24.ro,0,1,0,1,-1.0,1.0
Ioana Mihaila,www.aktual24.ro,0,1,0,1,-1.0,1.0
terorist,www.aktual24.ro,0,2,0,2,-1.0,1.0
Didrik de Schaetzen,www.mediafax.ro,0,0,1,1,0.0,0.0
Elveția,www.mediafax.ro,0,0,1,1,0.0,0.0
Guy Verhofstadt,www.mediafax.ro,0,1,0,1,-1.0,1.0
Hans van Baalen,www.mediafax.ro,0,0,1,1,0.0,0.0
Madrid,www.mediafax.ro,0,0,1,1,0.0,0.0
Manfred Weber,www.mediafax.ro,0,1,0,1,-1.0,1.0
Eugen Tomac,www.antena3.ro,0,0,1,1,0.0,0.0
Liviu Petrina,www.antena3.ro,1,0,0,1,1.0,1.0
Mihalache,www.antena3.ro,1,0,0,1,1.0,1.0
Doamne,observatornews.ro,1,0,0,1,1.0,1.0
Bittman,adevarul.ro,0,0,1,1,0.0,0.0
Dan Bittman,adevarul.ro,0,0,1,1,0.0,0.0
solist,adevarul.ro,0,0,1,1,0.0,0.0
Gigel Știrbu,observatornews.ro,0,0,1,1,0.0,0.0
Larisa Bernaschi,observatornews.ro,0,0,1,1,0.0,0.0
Monica Anisie,observatornews.ro,0,0,1,1,0.0,0.0
Oana Popescu,www.gandul.ro,0,0,1,1,0.0,0.0
Valeriu Nicolae,www.gandul.ro,0,0,2,2,0.0,0.0
Dl. Georgescu,www.digi24.ro,0,0,1,1,0.0,0.0
Gavrilă,www.digi24.ro,0,1,0,1,-1.0,1.0
POT,www.digi24.ro,0,1,0,1,-1.0,1.0
campion,www.digi24.ro,1,0,0,1,1.0,1.0
Gelu Duminică,observatornews.ro,0,0,2,2,0.0,0.0
sociolog,observatornews.ro,0,0,1,1,0.0,0.0
Adrian Dobre,recorder.ro,0,0,1,1,0.0,0.0
Adrian Rîndunică,recorder.ro,0,1,0,1,-1.0,1.0
Clejani,recorder.ro,0,0,1,1,0.0,0.0
Dvs,recorder.ro,0,0,1,1,0.0,0.0
Florin Nidelea,recorder.ro,0,0,1,1,0.0,0.0
Ioan Munteanu,recorder.ro,0,0,1,1,0.0,0.0
Ion Cîmpeanu,recorder.ro,0,0,2,2,0.0,0.0
Ionuț,recorder.ro,0,0,1,1,0.0,0.0
Lucian Ioniță,recorder.ro,0,1,1,2,-0.5,0.5
Remus Munteanu,recorder.ro,0,1,0,1,-1.0,1.0
secretari,recorder.ro,0,1,0,1,-1.0,1.0
Tudor Buzatu,recorder.ro,0,1,0,1,-1.0,1.0
apolitic,recorder.ro,0,1,0,1,-1.0,1.0
socru,recorder.ro,0,0,1,1,0.0,0.0
subsecretar,recorder.ro,0,3,0,3,-1.0,1.0
Șerban Valeca,recorder.ro,0,1,0,1,-1.0,1.0
Attila Varga,www.activenews.ro,0,0,1,1,0.0,0.0
Bogdan Licu,www.activenews.ro,0,0,1,1,0.0,0.0
Cristian Deliorga,www.activenews.ro,0,0,1,1,0.0,0.0
Gheorghe Stan,www.activenews.ro,0,0,1,1,0.0,0.0
Karoly Benke,www.activenews.ro,0,1,0,1,-1.0,1.0
Președintele,www.activenews.ro,0,0,1,1,0.0,0.0
Remus Pricopie,www.activenews.ro,0,1,0,1,-1.0,1.0
Tehreș,www.activenews.ro,0,0,1,1,0.0,0.0
Viorica Dăncilă,www.activenews.ro,0,1,0,1,-1.0,1.0
prim magistrat asistent,www.activenews.ro,0,1,0,1,-1.0,1.0
Abraham Lincoln,a1.ro,0,0,1,1,0.0,0.0
Andrew Jackson,a1.ro,0,0,1,1,0.0,0.0
George Washington,a1.ro,0,0,1,1,0.0,0.0
Georgia,a1.ro,0,0,1,1,0.0,0.0
James Polk,a1.ro,0,0,1,1,0.0,0.0
republican,a1.ro,0,1,1,2,-0.5,0.5
străin,a1.ro,0,1,0,1,-1.0,1.0
Pete Hegseth,primanews.ro,0,0,1,1,0.0,0.0
pieton,www.romaniatv.net,0,0,1,1,0.0,0.0
Cristian Roman,recorder.ro,0,0,1,1,0.0,0.0
Dan Constantin Șlincu,recorder.ro,0,0,1,1,0.0,0.0
Dan Oloeriu,recorder.ro,0,0,1,1,0.0,0.0
Eugen Lovinescu,recorder.ro,0,0,1,1,0.0,0.0
George Lazăr,recorder.ro,0,0,1,1,0.0,0.0
Gheorghe Asachi,recorder.ro,0,0,1,1,0.0,0.0
Joseph Heller,recorder.ro,0,0,1,1,0.0,0.0
Lucian Trufin,recorder.ro,0,0,2,2,0.0,0.0
Mihaela Huncă,recorder.ro,0,0,1,1,0.0,0.0
Monica Lovinescu,recorder.ro,0,0,1,1,0.0,0.0
Nicolae Iorga,recorder.ro,0,0,1,1,0.0,0.0
Ovidiu Sincai,recorder.ro,0,0,1,1,0.0,0.0
sigur,recorder.ro,0,0,1,1,0.0,0.0
Târgu Frumos,recorder.ro,0,0,1,1,0.0,0.0
Vlăsinești,recorder.ro,1,0,0,1,1.0,1.0
Yanis Varoufakis,recorder.ro,1,0,0,1,1.0,1.0
Ștefănești,recorder.ro,0,0,1,1,0.0,0.0
Țara de Sus,recorder.ro,1,0,0,1,1.0,1.0
țoți,recorder.ro,0,1,0,1,-1.0,1.0
Administrația Trump,www.g4media.ro,0,1,0,1,-1.0,1.0
Europa Unită,www.g4media.ro,1,0,0,1,1.0,1.0
concetățean,www.g4media.ro,0,1,0,1,-1.0,1.0
Anne Applebaum,www.g4media.ro,0,0,1,1,0.0,0.0
militar,www.g4media.ro,0,0,1,1,0.0,0.0
vasal,www.g4media.ro,0,1,0,1,-1.0,1.0
Barna,www.aktual24.ro,0,1,0,1,-1.0,1.0
Marie,www.aktual24.ro,0,1,0,1,-1.0,1.0
Niculina Stelea,www.cotidianul.ro,0,2,0,2,-1.0,1.0
Valeriu Zgonea,www.cotidianul.ro,0,1,0,1,-1.0,1.0
senatoare,www.cotidianul.ro,0,1,0,1,-1.0,1.0
Cristian Alin Moș,www.news.ro,0,0,1,1,0.0,0.0
Moș,www.news.ro,0,0,1,1,0.0,0.0
Nicolae Robu,www.news.ro,0,0,1,1,0.0,0.0
Robu,www.news.ro,0,0,1,1,0.0,0.0
timișorean,www.news.ro,0,0,1,1,0.0,0.0
analist politic,www.realitatea.net,0,1,0,1,-1.0,1.0
Votanțiu,www.realitatea.net,0,1,0,1,-1.0,1.0
Corneliu Ceica,a1.ro,0,0,1,1,0.0,0.0
Dumitru Daniel Botanoiu,a1.ro,0,0,1,1,0.0,0.0
Florin Tunaru,a1.ro,0,0,1,1,0.0,0.0
Georgeta Bratu,a1.ro,0,0,1,1,0.0,0.0
Gheorghe Albu,a1.ro,0,0,1,1,0.0,0.0
Marian Pintur,a1.ro,0,0,1,1,0.0,0.0
Mihail Constantin,a1.ro,0,0,1,1,0.0,0.0
Vladimir Alexandru Manastireanu,a1.ro,0,0,1,1,0.0,0.0
medic primar,a1.ro,0,0,1,1,0.0,0.0
Beniamin Netanyahu,www.romaniatv.net,0,1,0,1,-1.0,1.0
Alex Rovența,www.cotidianul.ro,0,0,1,1,0.0,0.0
Budapesta,www.cotidianul.ro,0,1,0,1,-1.0,1.0
Gabor Kereskenyi,www.cotidianul.ro,0,0,1,1,0.0,0.0
Kereskenyi,www.cotidianul.ro,0,3,0,3,-1.0,1.0
Kerezsi Miklos,www.cotidianul.ro,0,1,0,1,-1.0,1.0
Lazuri,www.cotidianul.ro,0,0,1,1,0.0,0.0
Livada,www.cotidianul.ro,0,1,0,1,-1.0,1.0
Negrești,www.cotidianul.ro,0,0,1,1,0.0,0.0
Noemi Eva Kereskenyi,www.cotidianul.ro,0,1,1,2,-0.5,0.5
Petin,www.cotidianul.ro,0,0,1,1,0.0,0.0
Sânpaul,www.cotidianul.ro,0,0,1,1,0.0,0.0
Sătmar,www.cotidianul.ro,0,1,0,1,-1.0,1.0
Tamas Leisztinger,www.cotidianul.ro,0,1,0,1,-1.0,1.0
Tarr Const,www.cotidianul.ro,0,1,0,1,-1.0,1.0
Vasile Pop,www.cotidianul.ro,0,0,1,1,0.0,0.0
Viena,www.cotidianul.ro,0,0,1,1,0.0,0.0
acționar,www.cotidianul.ro,0,0,1,1,0.0,0.0
episcop,www.cotidianul.ro,0,1,0,1,-1.0,1.0
milionar,www.cotidianul.ro,0,1,0,1,-1.0,1.0
oligarh,www.cotidianul.ro,0,1,0,1,-1.0,1.0
sătmăren,www.cotidianul.ro,0,1,0,1,-1.0,1.0
sătmăreni,www.cotidianul.ro,0,1,0,1,-1.0,1.0
traficant,www.cotidianul.ro,0,1,0,1,-1.0,1.0
Petre Roman,pressone.ro,0,0,1,1,0.0,0.0
Radu Câmpeanu,pressone.ro,0,0,1,1,0.0,0.0
personalitățile,pressone.ro,0,0,1,1,0.0,0.0
Douglas,www.romaniatv.net,0,0,1,1,0.0,0.0
escroc,www.romaniatv.net,0,1,0,1,-1.0,1.0
Michelle Haywood,www.romaniatv.net,0,0,1,1,0.0,0.0
Peter Kyle,www.romaniatv.net,0,0,1,1,0.0,0.0
William Fletcher,www.romaniatv.net,0,0,1,1,0.0,0.0
Chinei,www.cotidianul.ro,0,0,1,1,0.0,0.0
EAU,www.cotidianul.ro,0,0,1,1,0.0,0.0
Emiratele Arabe Unite,www.cotidianul.ro,0,0,1,1,0.0,0.0
Ștefănești,www.euronews.ro,0,0,1,1,0.0,0.0
Roxana Mînzatu,www.g4media.ro,1,0,0,1,1.0,1.0
baron,www.g4media.ro,0,1,0,1,-1.0,1.0
inamic,www.g4media.ro,0,1,0,1,-1.0,1.0
Crina Muntean,www.g4media.ro,0,1,0,1,-1.0,1.0
Cătălin Voicu,www.g4media.ro,0,0,2,2,0.0,0.0
Daniela Panioglu,www.g4media.ro,0,1,0,1,-1.0,1.0
Lia Savonea,www.g4media.ro,0,1,2,3,-0.3333333333333333,0.3333333333333333
Lelia Savonea,www.g4media.ro,0,0,1,1,0.0,0.0
Marian Vanghelie,www.g4media.ro,0,0,1,1,0.0,0.0
Mario Iorgulescu,www.g4media.ro,0,0,1,1,0.0,0.0
Savonea,www.g4media.ro,0,1,0,1,-1.0,1.0
Voicu,www.g4media.ro,0,0,1,1,0.0,0.0
afacerist,www.g4media.ro,0,1,0,1,-1.0,1.0
apărător,www.g4media.ro,0,0,1,1,0.0,0.0
Cezar Bivolaru,www.g4media.ro,0,0,1,1,0.0,0.0
Mihai Savonea,www.g4media.ro,0,0,1,1,0.0,0.0
Corina Corbu,www.g4media.ro,0,0,1,1,0.0,0.0
judecătoare,www.g4media.ro,0,0,1,1,0.0,0.0
finalist,www.g4media.ro,1,0,0,1,1.0,1.0
bufon,www.news.ro,0,1,0,1,-1.0,1.0
